type,id,status,description,amount,account,balance,direction,class,institution,postDate
transaction,5e6dfe07-a185-4667-b37a-f02bcca7f686,posted,TRANSFER TO JOANNA SMITH CAMPING,-4946.38,aa300f01-5510-4630-aa64-6929950d4991,3519.43,debit,cash-withdrawal,AU00000,2024-04-26T03:03:05Z
transaction,f0e7bf4b-9315-4a91-a1db-1b61e46d521d,posted,Mobile Phone Bill Payment,-4971.42,1ffe8997-55c9-4c3d-8819-f0e9cdbd2035,-1451.99,debit,bank-fee,AU00000,2023-12-15T19:57:00Z
transaction,18a01ec8-9f58-4eb8-9f90-5a6e7a5283a5,posted,Online Gaming Purchase,-599.84,6828123a-0f0e-454a-beb2-ed4ceb84db10,-2051.83,debit,payment,AU00000,2024-03-12T08:40:03Z
transaction,8b363d18-d55e-4808-ad93-6ffb73dd5fc4,posted,Bookstore Purchase,-2763.54,252484a4-9203-445d-a864-05936fba42ee,-4815.37,debit,payment,AU00000,2023-06-10T14:01:46Z
transaction,c0f11edc-a337-48a3-857d-dd0fe9d8d6b0,posted,Uber Ride,-3736.73,8ecc76a2-501c-4603-8199-78814bce9eb9,-8552.1,debit,payment,AU00000,2024-05-08T22:19:49Z
transaction,10b8313d-a93b-4e53-bae5-9bca9d4cc296,posted,Travel Agency Booking,-1396.17,0982a0fc-a80b-44ea-8fa6-c3f227085f16,-9948.27,debit,cash-withdrawal,AU00000,2023-07-07T10:41:17Z
transaction,9a51b5f3-4531-429e-9158-95dae9d8b6bc,posted,Non Hooli ATM Withdrawal Fee,-1363.51,fec324af-6925-4331-884d-a4527737c440,-11311.78,debit,bank-fee,AU00000,2023-08-17T02:41:52Z
transaction,a01db0a0-df97-4893-b856-de85cb545bf4,posted,TFR Acc14000 TO 12389,-4815.8,02f3930e-ced1-49eb-9cc5-f49a4c7e44de,-16127.58,debit,payment,AU00000,2024-02-01T04:10:28Z
transaction,dbe05c55-87f5-43bf-b560-6211d186125d,posted,Non Hooli ATM Withdrawal Fee,-88.42,317d162d-faa3-42fd-9cd7-5eb4e397b27b,-16216.0,debit,cash-withdrawal,AU00000,2023-05-28T20:47:56Z
transaction,9630a823-f729-432c-9fd1-9c30e1e5b884,posted,Online Gaming Purchase,-232.84,5fad628a-8882-47b7-8971-fd9f243cea6c,-16448.84,debit,payment,AU00000,2023-06-10T06:41:11Z
transaction,693ca3bc-53ec-4166-8230-8da539b559a3,posted,Car Maintenance Expense,-2452.58,fd9b491d-a695-48b9-9b93-a6b764e673c1,4396.94,debit,payment,AU00000,2024-01-27T18:38:34Z
transaction,83c9313d-bfcf-4d50-8c8c-03b24861c804,posted,Music Streaming Subscription,-2194.35,a646bb43-baef-479a-8266-e63f2da0a249,2202.59,debit,payment,AU00000,2023-08-05T17:34:56Z
transaction,4b4bbab8-5a52-405e-a8df-a44ae75993e4,posted,Bookstore Purchase,-650.47,2e49596a-db50-4cb0-b0c2-2f3bc31d039e,1552.12,debit,payment,AU00000,2024-02-17T05:04:21Z
transaction,428c7fff-5097-4706-96b4-7ed9cde682de,posted,CTRLINK CARERS Ref: 998R6789201610974V,-2700.75,1136b74f-2e7f-4e2e-b835-4b60787ee589,-1148.63,debit,bank-fee,AU00000,2023-11-25T04:26:38Z
transaction,6b5bef63-8c41-43de-90e3-9204237bf0cc,posted,Mobile Phone Bill Payment,-4312.48,fa12b2cd-726c-4af3-acea-b6a5b8c38d76,-5461.11,debit,cash-withdrawal,AU00000,2023-08-08T13:38:06Z
transaction,dd7c46b7-74f9-4654-b651-2b3a11d10857,posted,Wdl ATM WESTPAC IGA BALGOWLAH BALGOWL AU,-4761.74,134e5f06-9095-4960-bbf0-096db5eaacd4,-10222.85,debit,cash-withdrawal,AU00000,2023-06-02T23:15:44Z
transaction,e0d7c578-c73e-4bb0-8210-4f4665865f40,posted,Pharmacy Purchase,-2523.26,f3494c89-4474-44ee-9ce2-c9ca5d62dbec,-12746.11,debit,bank-fee,AU00000,2023-09-10T18:36:03Z
transaction,46c01dfa-a3c3-472a-9d2f-760d2f91959c,posted,Bookstore Purchase,-1127.41,1e0f1fd2-26f7-4365-92bc-cba44b260bf4,-13873.52,debit,bank-fee,AU00000,2023-06-02T20:16:35Z
transaction,c501e1f6-a43b-4aec-b879-b90c2d7a4f2a,posted,CTRLINK CARERS Ref: 998R6789201610974V,-178.18,fe9ecc6c-974f-4595-ab0e-5c4cf5e6e868,-14051.7,debit,cash-withdrawal,AU00000,2023-09-18T08:13:41Z
transaction,f498906b-1082-42db-8d68-2fc999efb1ec,posted,Music Streaming Subscription,-1255.13,31c8ee23-3b97-4c88-9850-c4bead6a24f9,-15306.83,debit,bank-fee,AU00000,2023-11-09T15:20:15Z
transaction,e7a44654-11de-43a0-a832-14375f7311fe,posted,Bookstore Purchase,-2238.14,cd915595-32d5-44ff-bd93-e906ddf3fe70,16224.86,debit,bank-fee,AU00000,2024-01-09T00:30:12Z
transaction,454d6725-0561-4a41-b06a-463fae8a84dd,posted,Netflix Subscription,-574.48,3b937fc9-0208-4acb-bebf-2639a93a1b1b,15650.38,debit,payment,AU00000,2023-06-27T18:49:30Z
transaction,e1407647-745d-46f5-8831-e6b2e09319c0,posted,Public Transport Fare,-2313.95,7313fe56-818b-406e-aee9-f1926754ccaa,13336.43,debit,bank-fee,AU00000,2024-02-17T13:47:14Z
transaction,a384aecd-7c04-452a-97ca-02c5f012aed0,posted,Payroll WFRMS 15439393,10240.06,c37a473e-d74d-4043-9545-a66c2ba3fb07,23576.49,credit,transfer,AU00000,2023-11-01T02:00:19Z
transaction,36e3f49a-837b-40c3-a93a-03bb54ee5be7,posted,Gym Membership Fee,-4701.76,9d5a3380-2a19-4371-a08e-7cc0d81880b8,18874.73,debit,payment,AU00000,2023-09-27T05:26:38Z
transaction,c0f99202-3d29-465a-8241-b82b6a317799,posted,Online Gaming Purchase,-2941.79,f59f9170-f867-4221-9f53-b21eff2bdad7,15932.94,debit,payment,AU00000,2023-11-27T04:02:45Z
transaction,56cdb458-9d77-409f-8865-8a538c9f574a,posted,AGL RETAIL ENERGY LTD (GAS),-2108.93,ffda0dd6-c066-48bb-9250-42bd826cb95e,13824.01,debit,cash-withdrawal,AU00000,2024-02-01T17:50:37Z
transaction,4e47d385-0c2e-4bdf-aa13-eebe4f706fd5,posted,AGL RETAIL ENERGY LTD (GAS),-867.29,b35c4fd8-2a49-4ba2-b4e9-3260166fc412,12956.72,debit,payment,AU00000,2023-10-12T05:07:33Z
transaction,e55b1048-1afb-47d1-8d1f-659a02674388,posted,Movie Ticket Purchase,-1641.15,9b9c2d02-3cb9-4149-8ff4-10407c60b032,11315.57,debit,payment,AU00000,2024-01-15T13:05:21Z
transaction,a1e092d3-4d81-413b-8f37-ce4eac108022,posted,Car Maintenance Expense,-376.33,48d0fab2-e27e-43e2-9517-76ebd33debed,10939.24,debit,bank-fee,AU00000,2024-03-12T04:31:13Z
transaction,81452fbc-2d7c-4cff-b1f0-bd35f55ded74,posted,Public Transport Fare,-838.01,72d05b64-f4eb-4adb-bb29-2a7eda967fe9,10083.88,debit,bank-fee,AU00000,2023-12-01T03:36:49Z
transaction,4f1d192c-1dd1-49c4-a282-3ad34789fe1d,posted,Transfer Platnm Homeloan 346454,-875.48,f0b00429-2be1-40e2-9d93-ab941a867658,9208.4,debit,payment,AU00000,2024-05-01T05:17:35Z
transaction,884fe541-57e8-4778-a059-2b1330b94755,posted,CTRLINK CARERS Ref: 998R6789201610974V,-2521.58,626a6047-2ef1-4bac-9ed2-6064a44cd441,6686.82,debit,payment,AU00000,2024-04-08T14:59:15Z
transaction,0433ba18-90c6-4468-9b4d-2c8bdb6b5799,posted,Payroll WFRMS 15439393,11989.6,d854398d-854c-41d6-b853-3037ff40c8fc,18676.42,credit,transfer,AU00000,2023-05-27T18:41:45Z
transaction,a01332dd-8854-464a-b02b-241b45584d49,posted,Bookstore Purchase,-4702.6,ce49f3be-4468-4597-ade9-8ce533f8c530,13973.82,debit,bank-fee,AU00000,2023-12-08T14:55:11Z
transaction,6867e158-118f-481b-915e-4e391744b890,posted,Home Improvement Store Purchase,-1325.57,bf0ae754-4181-42bb-80e8-99c4bee988eb,12648.25,debit,bank-fee,AU00000,2023-10-13T03:58:19Z
transaction,cfdb9b0a-c53d-43b4-b007-003ec8a5cd47,posted,CTRLINK CARERS Ref: 998R6789201610974V,-1511.25,3e621be2-347a-4503-a6d5-2976234405b8,11137.0,debit,payment,AU00000,2024-04-05T00:13:53Z
transaction,0e25c8ef-0ae8-4ac7-b43d-fec1a1df4647,posted,Payroll WFRMS 15439393,10663.97,0e14bb9d-9304-4b29-b7ab-a53a8f5040f6,21800.97,credit,transfer,AU00000,2023-10-17T02:49:37Z
transaction,083f59c3-402e-46e9-8c31-d3d03201aceb,posted,Amazon Online Shopping,-4037.22,207e71bb-3892-4aba-8aa5-b66765e070e3,17763.75,debit,payment,AU00000,2024-04-16T21:11:53Z
transaction,247b8162-939b-4d16-a850-38f3015bdae8,posted,Travel Agency Booking,-3859.7,3a9e80e4-18b7-4c50-9c1f-704401d6693e,13904.05,debit,bank-fee,AU00000,2024-03-26T13:45:30Z
transaction,73dcfa77-5c80-45f2-881e-c58fba376f2a,posted,Uber Ride,-3452.91,972638e9-b987-4549-9f51-1cc62e4818d7,2289.29,debit,cash-withdrawal,AU00000,2023-10-01T14:00:18Z
transaction,2a15f423-a630-4b4e-9934-141c5ba2d6a4,posted,Clothing Store Purchase,-3802.93,7277381f-c601-487d-8e4a-adf765cde980,-1513.64,debit,cash-withdrawal,AU00000,2023-12-24T02:02:38Z
transaction,9e9680c5-3d10-48a6-aab7-e10f37d78b7b,posted,Movie Ticket Purchase,-3408.26,b76909b2-0ddf-433c-b2c5-dd5a4558cabd,-4921.9,debit,cash-withdrawal,AU00000,2023-09-22T10:29:04Z
transaction,d6c14c2f-f9c3-4e37-8aa2-8ce5d1dd3a0a,posted,Bookstore Purchase,-2280.99,c03688e5-0930-4cc7-b1a6-1eefdf353989,-7202.89,debit,bank-fee,AU00000,2023-08-30T22:19:29Z
transaction,d20cfcf9-397a-4ca9-82d9-c95b7728cf8f,posted,Gasoline Purchase,-4596.9,1b4e0f5c-a914-4a25-88ce-c4406f4eda25,-11799.79,debit,bank-fee,AU00000,2023-07-28T03:49:52Z
transaction,f50a9f09-59fc-4f81-8cf6-d3f1c512b8ac,posted,Transfer Platnm Homeloan 346454,-155.76,4d8fb5ef-33f0-41e1-a079-28b51dad8f79,-11955.55,debit,bank-fee,AU00000,2023-06-01T14:48:57Z
transaction,42fb9626-3f40-4baf-9f6d-ab973357a2c3,posted,Mobile Phone Bill Payment,-1250.62,a3adc476-1f54-459b-91d1-01decbaed128,-13206.17,debit,payment,AU00000,2023-08-23T18:45:42Z
transaction,23e7fc9a-95e7-46a7-9b8f-3a7044bf5d72,posted,TFR Acc14000 TO 12389,-3785.24,e78be00f-0ef8-4be7-898e-e6387f45855f,-16991.41,debit,payment,AU00000,2023-08-31T09:06:19Z
transaction,3aa62a49-6fda-4467-8006-3419cf1514aa,posted,Non Hooli ATM Withdrawal Fee,-2744.2,8ceb969c-834b-498e-b5a7-a3c994449eba,-19735.61,debit,payment,AU00000,2023-05-12T06:41:30Z
transaction,912c21a0-4cb5-42ca-bb65-912772d6ef3c,posted,Mobile Phone Bill Payment,-1575.24,9c01aa2c-d4f3-4303-be09-359939af487e,-21310.85,debit,cash-withdrawal,AU00000,2023-12-11T18:50:25Z
transaction,134ee5cb-c8ff-4421-a09a-d9caff741b89,posted,Uber Ride,-1463.5,ba1d1de3-28aa-4573-b482-f77cc7729069,14090.04,debit,bank-fee,AU00000,2023-08-22T09:35:44Z
transaction,44dfc76c-3eae-44c7-84c4-f800840c992b,posted,Restaurant Dinner,-2841.99,0144d6eb-e763-4488-bb30-18bec68cf3a5,11248.05,debit,bank-fee,AU00000,2023-11-04T01:01:51Z
transaction,a30f637c-dc76-4f06-8511-ff6289187520,posted,Uber Ride,-2601.72,453b65f7-870f-4058-892a-ded87de8b691,8646.33,debit,bank-fee,AU00000,2024-02-03T06:18:09Z
transaction,5c03c857-20ee-48f8-b0b8-40bd4f9f75e6,posted,Electricity Bill Payment,-4504.71,748be773-e40f-4df5-b896-4d0c6a0de0d8,4141.62,debit,payment,AU00000,2023-05-12T22:20:52Z
transaction,1b16d1d1-978d-4d10-bd38-8f740edef15f,posted,Electricity Bill Payment,-2273.58,0512068f-bb37-44ad-bb9c-8ada588ff5d5,1868.04,debit,cash-withdrawal,AU00000,2024-02-20T15:00:06Z
transaction,f9798970-c249-4954-8790-bfe23bef1c8d,posted,Non Hooli ATM Withdrawal Fee,-1886.91,15de9633-be29-44b6-8871-e9d21fa0aaa9,-18.87,debit,payment,AU00000,2023-12-02T01:52:31Z
transaction,359c7a7a-3f64-455e-931c-13ee4bdd85af,posted,Restaurant Dinner,-3514.78,8b7617ab-e275-4bba-8da9-3f5e59206205,-3533.65,debit,cash-withdrawal,AU00000,2023-11-30T06:25:22Z
transaction,20893d75-3313-4494-8dfc-c311422f6aab,posted,Manly Maths Tutor Wages,-4228.35,cfc84abd-2157-4bc2-82dc-3cc7d732027c,-7762.0,debit,bank-fee,AU00000,2023-06-05T14:16:56Z
transaction,62ed1c35-8015-4cde-9a22-fab0a9b9986c,posted,Clothing Store Purchase,-2831.07,c6b6bfea-b675-4bf7-a619-33176e5ad157,-10593.07,debit,cash-withdrawal,AU00000,2023-09-22T20:39:31Z
transaction,d935f358-6217-43eb-b430-6f4bec9c99c8,posted,Car Maintenance Expense,-3382.96,c6dad870-33f7-413b-9c4e-a05d8aeccfc5,-13976.03,debit,payment,AU00000,2023-12-29T23:40:56Z
transaction,32b1ec10-a42c-46fe-8cf9-b2c9e10626fe,posted,Electricity Bill Payment,-2375.05,aec82c26-1d93-4a04-b35b-1225aaf8c89d,13559.04,debit,cash-withdrawal,AU00000,2023-05-28T04:09:47Z
transaction,d7ec0d44-3d9d-47b8-bb2c-f4f4d1637f8c,posted,Home Improvement Store Purchase,-69.66,f9bc1ba8-cb08-4e30-bbc5-bc177e801a8c,13489.38,debit,bank-fee,AU00000,2023-05-21T04:13:12Z
transaction,81e63235-61ce-48d7-a4bd-2c628c4aef14,posted,Restaurant Dinner,-3377.14,2ca892f9-d312-4039-a769-0e793e606dbc,10112.24,debit,payment,AU00000,2024-02-13T02:44:51Z
transaction,0503dfde-eee9-4e64-a8ff-1ee1a17532ea,posted,Netflix Subscription,-2188.35,b59c92fa-5028-4da8-84e3-f6dbf933c46a,7923.89,debit,payment,AU00000,2023-06-20T20:23:33Z
transaction,0e7218fd-57b4-41b1-9932-9f2e7d9a3c06,posted,Electricity Bill Payment,-1499.12,1d43ebed-f489-4c0e-b1ae-2f1032362e4b,6424.77,debit,bank-fee,AU00000,2023-09-25T07:15:27Z
transaction,a806fc47-02d9-471f-854e-50590a4e74bf,posted,TFR Acc14000 TO 12389,-2016.75,24579ce2-0f6a-48e4-b92e-02114162bbfe,4408.02,debit,bank-fee,AU00000,2023-07-13T23:35:55Z
transaction,0c381643-a648-4ef2-adc0-0a520d55c3ff,posted,Movie Ticket Purchase,-877.14,07c6a5c3-af53-4b2f-922d-92b64bb634ad,3530.88,debit,cash-withdrawal,AU00000,2023-08-14T03:07:43Z
transaction,a823052f-bfab-4e37-9298-d36c075199d5,posted,Bookstore Purchase,-3187.29,a41cc31c-6998-4f18-877e-2c5ede6ad0f6,343.59,debit,bank-fee,AU00000,2024-03-06T13:54:52Z
transaction,0f073da3-e241-43d1-ab4f-3ff7a2533a6a,posted,Pharmacy Purchase,-4807.97,c03b8d09-b366-4a22-8710-727f6ac5aafd,-4464.38,debit,payment,AU00000,2024-01-05T21:19:31Z
transaction,6ea7e85d-d106-4e47-aa51-e405bb2b2587,posted,Netflix Subscription,-969.96,a27c6577-6481-4a83-adf5-b48c3296ac54,-5434.34,debit,cash-withdrawal,AU00000,2023-07-08T06:06:46Z
transaction,14e86cc2-4b8a-4a99-8921-234b4162088a,posted,Bookstore Purchase,-2323.17,95791ce9-6432-4354-be42-a19d83382e1d,16379.53,debit,bank-fee,AU00000,2023-05-18T08:33:08Z
transaction,2d9d4631-e8f7-48e6-b1c2-d067ddbf0ea9,posted,Gasoline Purchase,-571.69,a6992c65-f6de-474d-8324-a6f886c1490a,15807.84,debit,cash-withdrawal,AU00000,2024-01-27T08:20:55Z
transaction,2e803fa8-ce27-4215-8fc0-f5f05c078729,posted,Travel Agency Booking,-4808.02,a46d4eba-0393-4fa2-a845-b9941b6aab85,10999.82,debit,payment,AU00000,2023-07-08T16:37:39Z
transaction,b03d6869-917a-4508-9f0c-7099d39ecae1,posted,TRANSFER TO JOANNA SMITH CAMPING,-1220.6,70382a8c-44e2-4abd-a589-2a29606d078c,9779.22,debit,cash-withdrawal,AU00000,2024-03-21T11:58:36Z
transaction,458cfb9d-4ee7-4f1e-9302-5be4533c465e,posted,Payroll WFRMS 15439393,10576.69,af744244-9348-4de8-8252-06755b7b380f,20355.91,credit,transfer,AU00000,2023-10-26T18:03:56Z
transaction,b9975ab8-6879-4e2a-bf49-50fe50fb38fd,posted,Bookstore Purchase,-2356.82,819fcfe2-a8aa-4e4c-a7f2-68ad54798974,17999.09,debit,bank-fee,AU00000,2024-02-16T21:38:31Z
transaction,b6e157db-f98e-42cc-9b20-64358ae00703,posted,CTRLINK CARERS Ref: 998R6789201610974V,-4092.64,9249fe02-a722-471c-9667-7c02b1cb8c23,13906.45,debit,payment,AU00000,2023-08-19T14:08:10Z
transaction,7002f7ce-c87b-40d0-8b1d-0a4ea60e6f23,posted,Coffee Shop Purchase,-1478.19,832d8b60-10cb-422b-88c1-baf4efe1f9a0,12428.26,debit,payment,AU00000,2023-06-17T13:10:59Z
transaction,44347a12-0445-4aea-b1b7-814eaa723ee9,posted,Gasoline Purchase,-3604.31,ca56b12f-aaa2-4a00-83b4-86cd33047740,8823.95,debit,cash-withdrawal,AU00000,2023-09-19T08:21:46Z
transaction,e648e8b1-f966-484f-86c3-fd968518c385,posted,Uber Ride,-1920.02,fab817ef-21e6-47d0-81c3-13d2f379ce8e,6903.93,debit,payment,AU00000,2023-10-30T20:48:15Z
transaction,c71e3792-eb8d-471f-a57f-1cdebb2760f2,posted,Payroll WFRMS 15439393,10814.17,d2173d65-e5a9-4876-8010-00364f067139,27217.56,credit,transfer,AU00000,2023-06-16T08:39:47Z
transaction,1cff10e4-450f-4cf0-b88e-846e631d0953,posted,Hair Salon Appointment,-3884.27,5a77a327-fa90-4b1a-836e-e8c409a9f3d2,23333.29,debit,payment,AU00000,2024-03-03T00:05:49Z
transaction,dcdd1e44-470f-45ca-bf0e-75c0b0abd57e,posted,Amazon Online Shopping,-2750.01,917c4eb4-59c0-4784-ab29-e437ec28385e,20583.28,debit,payment,AU00000,2023-11-11T21:17:06Z
transaction,9f98e231-a1c4-4ca4-bdc9-9a12a2a61971,posted,Gasoline Purchase,-1274.38,74112027-6a69-4eb4-9b7e-6441e6533579,19308.9,debit,bank-fee,AU00000,2023-09-19T15:38:23Z
transaction,3b61fdb6-567b-4973-8da5-55b09057351d,posted,Gasoline Purchase,-634.06,3c94db75-2a55-43cd-8e5e-95dc6e7a9866,18674.84,debit,payment,AU00000,2023-07-07T03:29:03Z
transaction,fac9a9fb-6972-4edc-b054-8d868bc2c53d,posted,TFR Acc14000 TO 12389,-3214.26,1db4d43c-4f04-4dd2-9186-fea6a4e53b36,15460.58,debit,payment,AU00000,2024-03-24T15:26:03Z
transaction,0cec6575-b04c-4a67-bb51-619618db3962,posted,AGL RETAIL ENERGY LTD (GAS),-4356.52,3e00dd6d-0481-4535-a296-03b378380d97,11104.06,debit,cash-withdrawal,AU00000,2023-12-14T08:43:48Z
transaction,b566c9c1-d38e-48b1-a5ef-aa115dda34e5,posted,Transfer Platnm Homeloan 346454,-1832.38,1a21eda6-ee7f-4c21-b3d0-ba679413a488,9271.68,debit,payment,AU00000,2023-07-04T05:10:06Z
transaction,79450bfb-2dd9-492f-b5ae-1587cea5557a,posted,Bookstore Purchase,-4730.16,7d11ac3d-832a-4319-8ddb-44112e53b35c,4541.52,debit,cash-withdrawal,AU00000,2023-08-14T00:05:57Z
transaction,12640351-cb7c-4da9-b0c9-07b5e9b7d11d,posted,Online Gaming Purchase,-4729.96,fc7cdbfe-5508-474f-8ab4-367f5e50c0f2,-188.44,debit,cash-withdrawal,AU00000,2023-07-13T00:11:54Z
transaction,82cb57fb-7bb3-4643-bd5b-65c0d3c94967,posted,AGL RETAIL ENERGY LTD (GAS),-544.09,1f1d77c7-92a0-460f-bc0d-cc7baa097c8b,17711.46,debit,payment,AU00000,2023-07-25T18:59:28Z
transaction,aa8aa672-aa1e-44a8-ba97-ca0f1d23f7e0,posted,Amazon Online Shopping,-2313.87,542b4764-d0d1-450f-b0a3-de54e89ca496,15397.59,debit,cash-withdrawal,AU00000,2023-08-19T09:19:08Z
transaction,f86d47e9-24a1-4f98-815d-379c10f1332a,posted,Amazon Online Shopping,-391.98,3f012802-09d7-4a8d-8ba9-738b098cd5db,15005.61,debit,payment,AU00000,2023-08-28T14:01:41Z
transaction,1f7dcab9-8258-4f4e-b5f1-d0c6a39160b1,posted,Gym Membership Fee,-321.46,4246ceb7-f5b9-4b3a-bd2f-ec09480eadea,14684.15,debit,payment,AU00000,2023-11-21T10:29:59Z
transaction,883dcd4d-d234-4682-b0d4-430c10d17658,posted,Travel Agency Booking,-4539.35,6f85f83e-5276-4fd3-ab18-84e092383947,10144.8,debit,bank-fee,AU00000,2024-04-22T01:58:01Z
transaction,d98320da-93fd-431d-926c-86127c2abe40,posted,AGL RETAIL ENERGY LTD (GAS),-1844.71,c308ae7c-245c-4415-a81c-6a094c4c920e,8300.09,debit,bank-fee,AU00000,2023-09-28T04:45:41Z
transaction,7774af0e-c8e1-4fec-ae4d-c1e95e3ee1c1,posted,Bookstore Purchase,-631.54,cb773dac-76d3-422f-ad1e-32bcbf1bce06,7668.55,debit,bank-fee,AU00000,2023-08-26T08:18:52Z
transaction,789c87a0-d2fe-42e9-843c-5964370e4a83,posted,TRANSFER TO JOANNA SMITH CAMPING,-2718.78,bca6358e-393c-4168-b78c-1bf07846bc14,4949.77,debit,bank-fee,AU00000,2024-04-05T15:54:15Z
transaction,ade8c519-6161-452d-a470-f7690ba6d114,posted,Amazon Online Shopping,-761.29,968ec29c-16c0-43af-b8ee-aa054557a4bd,4188.48,debit,cash-withdrawal,AU00000,2023-08-18T00:43:02Z
transaction,5bcc8d99-1aa4-4c38-88b0-5535a958aabe,posted,Amazon Online Shopping,-4447.81,6cc0138b-8962-4190-8f23-4a563f6b6b8f,-259.33,debit,cash-withdrawal,AU00000,2024-01-17T10:23:15Z
transaction,a497fdc3-ad3f-4a82-8eae-7848123a6b07,posted,Coffee Shop Purchase,-1136.85,fd2bdd91-7093-4c87-ad51-082b1aed4c14,18547.96,debit,payment,AU00000,2023-07-28T03:10:51Z
transaction,5c3a1d2d-d580-4d4e-85eb-d9f782765e74,posted,Electricity Bill Payment,-4885.89,248031dd-5301-4c64-a638-15ac9103312e,13662.07,debit,payment,AU00000,2023-12-23T11:51:27Z
transaction,1c848541-705e-4efe-b079-78ea3f3992e7,posted,Travel Agency Booking,-3260.87,8f412ceb-06f1-4512-9aa6-1a149f46f094,10401.2,debit,bank-fee,AU00000,2023-10-10T21:52:20Z
transaction,b8f71c97-95ee-4b60-98ea-08e47bfd42a3,posted,Pharmacy Purchase,-2508.4,d52500a4-77e5-44e2-b715-bd382b20674d,7892.8,debit,bank-fee,AU00000,2023-11-12T05:58:09Z
transaction,761d180a-d8ec-4069-bc9d-8b9a2e5b1ec8,posted,AGL RETAIL ENERGY LTD (GAS),-603.54,0ecf15c2-41f3-437e-bf49-82f0674f99f0,7289.26,debit,cash-withdrawal,AU00000,2024-01-17T03:27:33Z
transaction,3acadd46-1fe9-4d45-8a5a-40f43431580c,posted,Netflix Subscription,-256.97,25910504-30b3-43ca-a0f7-e645c9153149,7032.29,debit,payment,AU00000,2024-02-15T13:37:56Z
transaction,44b6d408-b59c-4b54-b879-8ab8e971d95b,posted,Mobile Phone Bill Payment,-4005.79,60152e44-b1f9-42c4-9059-7ecfe7578c28,3026.5,debit,bank-fee,AU00000,2023-07-28T10:03:16Z
transaction,63f677fb-45c6-4dad-9345-9b5f1240c7d7,posted,Electricity Bill Payment,-282.97,fb7959bc-1cc8-4569-ad60-95211e63aca3,2743.53,debit,bank-fee,AU00000,2024-04-01T18:11:58Z
transaction,3ea9ffc4-dd3f-4086-b700-8c8de502e2c6,posted,TRANSFER TO JOANNA SMITH CAMPING,-736.32,467dd5e5-49e4-4547-97ac-0a9cdcee4781,2007.21,debit,cash-withdrawal,AU00000,2023-06-23T22:34:12Z
transaction,1b505ed7-bd37-42c9-8286-df7f9450e796,posted,Coffee Shop Purchase,-3977.1,e7ed5724-e34e-4f26-b845-7852851ec89e,-1969.89,debit,payment,AU00000,2023-08-01T00:48:23Z
transaction,5464b042-088e-4c81-b068-ef3902410297,posted,Movie Ticket Purchase,-3958.44,ac0a2173-5422-4602-a33b-b3f173809a71,5487.64,debit,bank-fee,AU00000,2023-11-14T12:56:12Z
transaction,a309d08c-875d-473e-a808-e2fa38ecacd5,posted,Mobile Phone Bill Payment,-1566.08,6fac5b3b-5745-4848-ba69-cd1aef89cd2e,3921.56,debit,cash-withdrawal,AU00000,2024-01-03T14:40:46Z
transaction,8246bb38-a69c-4793-bc71-b36061e771b9,posted,CTRLINK CARERS Ref: 998R6789201610974V,-2980.05,1f5d8be4-a5d9-486e-b470-b22627457338,941.51,debit,payment,AU00000,2023-12-29T06:05:28Z
transaction,ff20f788-dbcd-43a7-971e-7821580b88af,posted,Restaurant Dinner,-1592.56,65b0e2a8-1bda-4d67-a1e0-1defcbc6dfc6,-651.05,debit,cash-withdrawal,AU00000,2023-06-15T00:55:49Z
transaction,5b1b2703-4d04-40ad-835f-c94e448c5086,posted,Bookstore Purchase,-2652.18,d922d91f-ef20-4e1c-b4ce-f166b9739677,-3303.23,debit,payment,AU00000,2024-03-09T04:20:10Z
transaction,6b37a12a-ca11-413a-aef1-074b5431c630,posted,Mobile Phone Bill Payment,-2177.0,fe036686-19ba-4758-a30c-0b95d53004b5,-5480.23,debit,bank-fee,AU00000,2023-09-13T20:50:56Z
transaction,d0a0f243-f5a8-431a-8c09-c1ad87064085,posted,TFR Acc14000 TO 12389,-1628.99,faa1bb51-3c0a-4e3c-88fb-4d38d519d80a,-7109.22,debit,payment,AU00000,2023-07-21T17:15:49Z
transaction,1f134207-acc4-4e20-8cd7-fe8f38c4a166,posted,Amazon Online Shopping,-3636.76,d0d9dede-c1bb-4a05-84f1-01caed4dc23e,-10745.98,debit,cash-withdrawal,AU00000,2024-04-26T23:07:01Z
transaction,f64aaf06-3d7d-4be2-87e6-288dc7e98b6c,posted,Non Hooli ATM Withdrawal Fee,-3689.48,b332cff6-a8da-4c79-a603-d58854d68c53,-14435.46,debit,cash-withdrawal,AU00000,2023-10-23T05:41:57Z
transaction,2d52eff1-ea83-4aa4-8ede-645dee82949a,posted,Pharmacy Purchase,-4518.9,2fb169cc-61a5-4576-9c16-2405fdb9efb2,-18954.36,debit,payment,AU00000,2024-03-10T04:21:53Z
transaction,38aaecbc-dfa8-4cdd-8db6-40a0d27d3ae6,posted,Transfer Platnm Homeloan 346454,-1367.62,bfb7233c-7675-4ad7-8755-a5da46391fbe,11366.5,debit,cash-withdrawal,AU00000,2023-09-30T04:20:41Z
transaction,ae61ea1f-ac4f-4d9c-9301-cbaa0faeabff,posted,Uber Ride,-357.48,2fa5f3b1-59f3-4990-bb30-73af133112ed,11009.02,debit,bank-fee,AU00000,2023-11-27T19:46:32Z
transaction,61d1d8e3-97a2-4531-8dd2-e226b763d740,posted,Transfer Platnm Homeloan 346454,-4980.35,75e1b5c0-7700-4972-a959-89ae66c7a704,6028.67,debit,bank-fee,AU00000,2024-02-03T22:15:02Z
transaction,1688e2b2-e476-45e6-9b51-f903329d9a96,posted,Mobile Phone Bill Payment,-2736.54,85a4065b-bd09-464c-8971-ad7fb270edd0,3292.13,debit,payment,AU00000,2023-06-20T18:14:07Z
transaction,dd724f52-96bb-4427-9544-fca27089a88e,posted,Public Transport Fare,-992.73,23b49ea3-d89c-4dc1-97b8-b76993b2a226,2299.4,debit,bank-fee,AU00000,2024-01-23T23:18:59Z
transaction,8a0edef6-dc78-475e-a336-deabcd94977e,posted,Mobile Phone Bill Payment,-322.18,6a499f6e-a4ae-4093-be19-12c4dc440a88,1977.22,debit,cash-withdrawal,AU00000,2023-10-23T15:52:09Z
transaction,9f1e16d6-a7f4-44d6-966b-40b79547888f,posted,Clothing Store Purchase,-536.56,cbe20ea3-8050-4737-a5ef-4e086b4e5984,1440.66,debit,payment,AU00000,2024-02-25T22:15:35Z
transaction,a62df323-d6a6-465e-a57a-186cdce346ed,posted,Music Streaming Subscription,-1496.57,7ee5aad6-9483-4377-aa02-e7d7e239595c,-55.91,debit,bank-fee,AU00000,2024-03-07T10:08:34Z
transaction,84a2fa9f-d76c-4aa8-9042-64095c77706c,posted,Travel Agency Booking,-4463.91,f2b4df2d-186d-44a9-8d4d-ac1d27d4cf81,-4519.82,debit,payment,AU00000,2023-07-04T04:04:41Z
transaction,6a39360f-f207-42e2-bbf8-04886c7062bf,posted,Bookstore Purchase,-1248.26,ea1a083c-9b98-4ef1-82d4-b5d2fe737757,-5768.08,debit,bank-fee,AU00000,2023-10-09T17:31:09Z
transaction,2378ae83-1068-452d-9344-0bc944e68a26,posted,Non Hooli ATM Withdrawal Fee,-4650.07,963ec09e-2998-494f-ba0a-a8a607565805,7546.34,debit,payment,AU00000,2024-01-07T22:50:45Z
transaction,b4dd868e-f52b-45c1-a145-ecf1322d9b9a,posted,Netflix Subscription,-2149.16,745125b6-3ba3-4cd8-90f6-5cd012ec72ca,5397.18,debit,bank-fee,AU00000,2023-09-24T00:32:06Z
transaction,5948948a-ddea-43f3-bcc6-1c88c3122678,posted,Uber Ride,-2848.38,961e8935-3065-4e91-b577-02bbb46e3b4f,2548.8,debit,cash-withdrawal,AU00000,2023-10-18T12:37:55Z
transaction,5847ee7e-24c1-4365-9c38-1de516234f2c,posted,Home Improvement Store Purchase,-2610.75,51e58cf8-afb7-4533-a3f4-f90797baf0d3,-61.95,debit,payment,AU00000,2023-07-17T20:16:50Z
transaction,ae683348-26ff-449b-9b12-64ab912e47f1,posted,Non Hooli ATM Withdrawal Fee,-182.62,f8acd439-a928-4616-861d-f08877d38e61,-244.57,debit,bank-fee,AU00000,2023-07-23T18:10:14Z
transaction,c3d6380d-12c2-40f0-856a-5307245aeff8,posted,Uber Ride,-4580.0,f34b6d58-d577-44be-a2c7-d4492bfd86a4,-4824.57,debit,payment,AU00000,2023-06-05T16:19:24Z
transaction,bfdb75a6-b846-492a-ae57-909ce708237f,posted,Bookstore Purchase,-1063.7,17458020-ae15-4113-98b5-c9bf22f4ed54,-5888.27,debit,payment,AU00000,2023-08-13T08:45:21Z
transaction,b15e730e-c4c9-44f6-b155-fee8d4a7f985,posted,Netflix Subscription,-4185.75,a8cc817b-c2e5-4acf-ba0b-b72efe01f5e9,-10074.02,debit,payment,AU00000,2024-01-18T05:59:59Z
transaction,42e81bfd-b392-4985-b9d8-277f53810f6c,posted,Uber Ride,-3767.87,0b85bbd0-88a1-44b9-a923-dc3d0ce4f5e4,-13841.89,debit,cash-withdrawal,AU00000,2023-06-01T07:02:44Z
transaction,dcf9e35f-86e8-4494-9881-c06a022da294,posted,Hair Salon Appointment,-536.2,93f5b887-e668-4d48-8504-459affda580d,-14378.09,debit,bank-fee,AU00000,2024-02-14T11:16:29Z
transaction,488f63e9-0c5c-470c-8317-f2b20d308448,posted,Online Gaming Purchase,-1762.91,849b02ce-fea7-4865-a8eb-a3c232aea532,17804.02,debit,cash-withdrawal,AU00000,2024-01-31T10:16:59Z
transaction,7a042b4d-e193-4b5e-a2c3-751fde7d1a55,posted,TRANSFER TO JOANNA SMITH CAMPING,-4047.63,18f037c3-4c45-4d0b-abad-9354df1aad43,13756.39,debit,cash-withdrawal,AU00000,2023-06-18T10:56:20Z
transaction,d6cf73e5-ce74-4632-b427-5975e4c5da6f,posted,Gym Membership Fee,-287.65,28db938b-1083-40ba-9a1e-6352ce45f4e9,13468.74,debit,cash-withdrawal,AU00000,2024-02-07T16:17:59Z
transaction,be6db784-1483-4652-9f26-d54648c7d35e,posted,Wdl ATM WESTPAC IGA BALGOWLAH BALGOWL AU,-3924.22,05135815-7c8a-4a32-8f19-3520d899213c,9544.52,debit,cash-withdrawal,AU00000,2023-12-09T07:07:35Z
transaction,c8e26a6d-5232-488e-a8a9-1bfbe64f6f84,posted,Transfer Platnm Homeloan 346454,-925.48,360df7df-8f53-4923-a997-3ca5e86abbee,8619.04,debit,cash-withdrawal,AU00000,2023-10-21T06:50:36Z
transaction,55f78dd7-4418-42cc-935f-d7eb4f67fb32,posted,Coffee Shop Purchase,-114.5,e246c4f8-bfb4-48c2-a96f-3ceb9b174d5b,8504.54,debit,cash-withdrawal,AU00000,2023-11-16T04:41:26Z
transaction,0046e5f1-56aa-4419-8e79-09a771c209c5,posted,Transfer Platnm Homeloan 346454,-4477.68,996a54fb-e018-4825-90ab-7288bdc5c5cd,4026.86,debit,cash-withdrawal,AU00000,2023-05-25T05:59:57Z
transaction,ab352b18-fe22-4105-bd56-e2a45ad16f37,posted,Restaurant Dinner,-1170.96,84538a10-bf3c-4f1a-8d8e-6bf9cb7e1fb5,2855.9,debit,cash-withdrawal,AU00000,2023-07-01T18:36:48Z
transaction,65e0ff6f-abb3-46e9-9194-b3dd19366c4a,posted,Gasoline Purchase,-4135.3,b98cc6c0-5e04-41cc-a152-b15067e08ae1,-1279.4,debit,cash-withdrawal,AU00000,2023-10-16T03:07:28Z
transaction,14c5ef62-3daf-4585-a7b9-934b7dc0579f,posted,Pharmacy Purchase,-4679.86,31690775-ec0c-46df-8290-af95103f40aa,-5959.26,debit,payment,AU00000,2023-10-15T11:41:55Z
transaction,2c749112-df45-46fd-8b0e-2f1779393614,posted,Coffee Shop Purchase,-573.83,836d3d24-a125-48f7-8a7a-3643b0979fda,12039.27,debit,payment,AU00000,2023-06-12T14:21:52Z
transaction,3ef2a8ea-1689-4982-8f32-a14f563b9ec5,posted,TFR Acc14000 TO 12389,-1421.92,a1db4eef-f0ce-4445-9374-72b26b6549a1,10617.35,debit,bank-fee,AU00000,2024-01-15T13:40:36Z
transaction,147b3da8-3031-49bf-90dd-be3b4ce84c6d,posted,Music Streaming Subscription,-2177.79,40f7239d-5b05-4ab7-84a1-60be41aea0bb,8439.56,debit,cash-withdrawal,AU00000,2023-07-24T22:36:21Z
transaction,34e2a3c7-2525-48ad-83ae-1cb194f5094f,posted,Public Transport Fare,-4911.1,9f818722-808a-4f41-a57a-6dc95cd2e894,3528.46,debit,payment,AU00000,2024-02-06T23:51:12Z
transaction,b4fd5770-05c4-4876-902e-8eab454d9cf6,posted,Gym Membership Fee,-2210.79,91f36624-36b5-4697-a21a-1989cde8c992,1317.67,debit,bank-fee,AU00000,2024-04-11T21:18:31Z
transaction,c86b8bdc-c0e7-4121-832a-cbe38bad2dea,posted,Amazon Online Shopping,-1658.61,e3868f43-cf1c-4ee0-be72-2b381c93500c,-340.94,debit,bank-fee,AU00000,2023-07-29T18:13:23Z
transaction,f299171b-7f97-4e11-b002-d3aeca505ab9,posted,Online Gaming Purchase,-4343.49,6193fbde-c548-4b1d-b0de-edd3fbeb24ea,-4684.43,debit,bank-fee,AU00000,2024-03-25T17:18:53Z
transaction,2936c3dd-1ba9-498c-9f06-e00e9b75c5c9,posted,Transfer Platnm Homeloan 346454,-3693.48,cfc311bc-ef1c-45a7-bcdb-8161ae63f461,-8377.91,debit,bank-fee,AU00000,2023-08-18T01:19:02Z
transaction,348e0493-b39e-46f0-b9f9-693d1ca8ce7b,posted,Netflix Subscription,-2642.45,4bcdb175-1cd0-4634-b159-5906f7796f9c,-11020.36,debit,cash-withdrawal,AU00000,2023-08-23T08:48:39Z
transaction,87ed46c3-3b55-4cee-8cd5-0a8cc1b68b2d,posted,Transfer Platnm Homeloan 346454,-1825.29,472cf136-2f38-4614-ada7-f6caff7cee8b,-12845.65,debit,payment,AU00000,2023-05-29T07:30:47Z
transaction,c2af6264-b50b-4c17-b24c-63f815e03395,posted,Home Improvement Store Purchase,-4392.32,31daef61-ed2f-41b6-8076-b890c7ef606b,6771.28,debit,bank-fee,AU00000,2023-09-14T18:42:45Z
transaction,fd21c9ea-872f-4e43-9655-070db82fc143,posted,Electricity Bill Payment,-2505.03,418851c3-cfe9-4aaf-803a-e08d336369ea,4266.25,debit,payment,AU00000,2023-05-20T12:21:55Z
transaction,42308e72-8aa9-4a48-9424-9f2d8f16ecb5,posted,Amazon Online Shopping,-1363.3,2566726e-730d-416f-8a4b-6da33c1e8d9f,2902.95,debit,payment,AU00000,2023-08-07T17:01:36Z
transaction,41d3bc82-84c7-4aa7-9f55-ea325353615b,posted,Music Streaming Subscription,-2971.22,348d0c46-e099-437e-8004-b7d670d29eb7,-68.27,debit,cash-withdrawal,AU00000,2023-09-11T02:03:43Z
transaction,a7741741-d2fd-4b37-9f1a-c30d5ca59642,posted,Movie Ticket Purchase,-2261.23,12b5bc84-76e7-40e4-972c-4309072b74f7,-2329.5,debit,cash-withdrawal,AU00000,2023-05-29T07:27:53Z
transaction,fc1fbc70-3910-4681-b26f-3a130d80d69d,posted,Gasoline Purchase,-4834.6,847945c6-bd70-4d60-a25c-9780656d0903,-7164.1,debit,bank-fee,AU00000,2024-04-11T16:04:22Z
transaction,0d429687-e5f4-4aaa-a629-7c64451a32d0,posted,CTRLINK CARERS Ref: 998R6789201610974V,-3088.3,bdcd3ab9-29c8-44c2-92b9-aeaeb5139ed2,-10252.4,debit,payment,AU00000,2023-11-13T03:33:06Z
transaction,1e7b2c6b-28f7-4927-8662-3f5f554d9e38,posted,Travel Agency Booking,-3744.31,1aa23568-4bda-4fe8-8733-370fa17762ff,-13996.71,debit,payment,AU00000,2023-05-21T02:04:58Z
transaction,48b0c87b-11a2-4690-8841-1e9883085b9c,posted,Movie Ticket Purchase,-2924.21,e98ec91f-fc72-47d6-a1ad-5347bcd232e9,-16920.92,debit,bank-fee,AU00000,2023-08-23T23:59:45Z
transaction,0e225df6-44ab-4bf9-8c31-d1474f213f61,posted,Hair Salon Appointment,-3031.41,145b4e9d-627f-4adc-9712-6e55e0be1cf3,-19952.33,debit,bank-fee,AU00000,2023-07-26T18:50:13Z
transaction,864bd809-a9a6-41e0-9bb7-8265bace83ee,posted,Gym Membership Fee,-187.25,171d86d8-54a6-4cff-9e30-97bad95fef0f,5917.01,debit,cash-withdrawal,AU00000,2023-07-25T23:20:06Z
transaction,b8a60b68-9d96-4249-a03f-368edd940c5a,posted,Wdl ATM WESTPAC IGA BALGOWLAH BALGOWL AU,-2377.03,74925287-2518-498b-875a-5ae02e03bd62,3539.98,debit,cash-withdrawal,AU00000,2023-09-04T23:14:41Z
transaction,c31d2bea-a0b6-4f6f-b88b-c7896ddfb57c,posted,TFR Acc14000 TO 12389,-4129.04,8c7878f0-cec6-43f7-8a3d-e5bec7aed782,-589.06,debit,bank-fee,AU00000,2024-04-06T12:33:02Z
transaction,526d61b3-a869-460b-acbf-ce4b44aae2e8,posted,Clothing Store Purchase,-3163.89,f49897ec-7fdf-4927-bb4b-acde0ef3428f,-3752.95,debit,payment,AU00000,2023-06-17T01:50:24Z
transaction,b20455c7-324d-4263-b4f1-67774f640cd3,posted,Wdl ATM WESTPAC IGA BALGOWLAH BALGOWL AU,-1958.8,d672299a-beec-4f99-a5b7-0899297c4d75,-5711.75,debit,payment,AU00000,2023-10-03T16:09:31Z
transaction,ee902a84-6078-4b29-9207-cd75f5ea1ee9,posted,Amazon Online Shopping,-2848.61,77b8b9ba-9390-441f-a3dc-49e17b946c74,-8560.36,debit,bank-fee,AU00000,2023-06-03T10:50:22Z
transaction,13e5e900-453a-401a-8109-22ea1c937d1e,posted,Electricity Bill Payment,-4863.07,ade0b79f-ced9-418a-b4bc-d678ebbca2a2,-13423.43,debit,payment,AU00000,2023-11-13T15:50:26Z
transaction,5013a507-751a-4def-934a-fea9c3faa825,posted,Gasoline Purchase,-4184.69,4ac9198e-988b-4301-8e83-0e4dad159c51,-17608.12,debit,cash-withdrawal,AU00000,2023-09-26T23:57:00Z
transaction,c4059ff3-21e4-4967-a1b8-dfbb92792de3,posted,Coffee Shop Purchase,-1552.17,a4946eaf-0a6b-4b95-b9c4-9b30a5214902,-19160.29,debit,cash-withdrawal,AU00000,2023-08-04T21:07:23Z
transaction,38e7f91f-228c-4723-b5fd-090b72363c4a,posted,Manly Maths Tutor Wages,-3357.89,985e6846-fbde-4e55-812e-660721adaabc,-22518.18,debit,bank-fee,AU00000,2023-11-09T04:09:40Z
transaction,b1a52490-7dc9-4b70-a7bf-26bcaf897321,posted,Electricity Bill Payment,-2629.83,fa92ebd5-785e-4bbb-b1b3-d43101b30442,5434.74,debit,cash-withdrawal,AU00000,2023-10-25T12:03:05Z
transaction,748ee58e-3fd6-4ba1-abb9-f3a1f6fd5b95,posted,Hair Salon Appointment,-3244.22,c6e81a85-9434-4946-8616-200a0de074cc,2190.52,debit,payment,AU00000,2023-10-03T11:01:41Z
transaction,eff105b6-69a9-4887-bb5c-17311b23b892,posted,Payroll WFRMS 15439393,11218.81,d4bd1837-139b-435a-9e7f-38b5311890d7,13409.33,credit,transfer,AU00000,2023-06-15T14:23:39Z
transaction,880a5413-8600-41d2-b067-c305eaf0d41c,posted,Uber Ride,-1845.94,b32bef0b-c731-4410-9efb-3a7d55d55f58,11563.39,debit,payment,AU00000,2024-01-31T02:14:28Z
transaction,cde3ba91-4922-4692-8877-a90dbf560d95,posted,Pharmacy Purchase,-879.95,d5ece80e-b891-4143-bfd4-69747b54af19,10683.44,debit,bank-fee,AU00000,2024-04-14T23:19:19Z
transaction,7d229f0f-734a-409a-8e80-b3a44e4c9c3c,posted,Uber Ride,-2749.99,db9d9177-038a-42b7-9553-c6a055fdd54c,7933.45,debit,bank-fee,AU00000,2024-01-10T04:31:27Z
transaction,191e6433-0344-4230-ba01-e4f1a562aa58,posted,Travel Agency Booking,-2203.68,3a4e1376-7308-480e-a0b8-3301b5c8dd5d,5729.77,debit,bank-fee,AU00000,2023-10-26T17:06:08Z
transaction,3c21853c-c5cd-4875-a0bc-784f8acd6196,posted,Online Gaming Purchase,-1026.9,d9da00ab-ec3d-4c4a-9114-d73304cc9fe9,4702.87,debit,cash-withdrawal,AU00000,2024-03-26T08:26:22Z
transaction,9eda809b-9660-447a-bc03-60f595dcd54e,posted,Online Gaming Purchase,-3971.54,c6766b50-d5f7-424c-8d28-c89b85710654,731.33,debit,cash-withdrawal,AU00000,2023-10-31T18:01:23Z
transaction,f3be9eb4-4241-468d-9b91-08968de89789,posted,Restaurant Dinner,-3032.17,cf675377-217b-44ce-b69f-f0ab284d520b,-2300.84,debit,payment,AU00000,2024-01-15T10:52:52Z
transaction,6cc00f9a-f616-467e-b348-74fd363b09b1,posted,TRANSFER TO JOANNA SMITH CAMPING,-3624.23,e32172fa-c6a5-4c85-a8b9-c8aaf71bf5d8,7542.58,debit,cash-withdrawal,AU00000,2023-07-28T22:41:48Z
transaction,4d334116-0dbe-41ae-91f5-cead08931fa8,posted,Gasoline Purchase,-4165.06,c4b06eb0-b404-45d2-ac19-c93496980432,3377.52,debit,cash-withdrawal,AU00000,2024-01-28T18:39:12Z
transaction,5be6ffde-1abe-47b8-b940-fcc037065617,posted,Gasoline Purchase,-2380.46,51d58005-7d48-4442-bc88-4c2012266612,997.06,debit,bank-fee,AU00000,2024-01-24T10:55:21Z
transaction,54540bea-29cd-4075-80bb-331452a165c0,posted,Home Improvement Store Purchase,-272.65,cbf3e432-9e24-49a3-af6a-b686cedfc6a1,724.41,debit,payment,AU00000,2024-02-06T07:34:54Z
transaction,c8928311-2072-4d8e-8496-f15f0687d252,posted,Hair Salon Appointment,-3763.21,d82d81bb-2798-4f90-aebd-08f690b35442,-3038.8,debit,bank-fee,AU00000,2023-12-30T12:20:57Z
transaction,9baf0cbf-26a3-419f-9711-72f408f96873,posted,Hair Salon Appointment,-2303.26,5f668af8-af34-4dbe-998b-ce73c8490508,-5342.06,debit,payment,AU00000,2024-02-03T20:41:32Z
transaction,5442497c-a615-4fca-b063-012310e8e005,posted,Movie Ticket Purchase,-1970.52,0b97716b-b2f8-4cb2-88b5-65a6fc7b13af,-7312.58,debit,payment,AU00000,2024-01-28T14:14:24Z
transaction,d2d51a78-d734-4651-b882-6b603f3978aa,posted,Gasoline Purchase,-1273.59,93317769-c79a-4983-994e-b9cb1938f761,-8586.17,debit,cash-withdrawal,AU00000,2023-12-30T09:58:00Z
transaction,01d23826-8158-4fd6-8d47-d00542a79862,posted,Mobile Phone Bill Payment,-2321.72,037ebc6b-dfaa-4f41-ba37-ae59b6b179b6,-10907.89,debit,payment,AU00000,2024-02-02T22:02:27Z
transaction,ab90a861-965c-4589-aa83-459cf5b89727,posted,Movie Ticket Purchase,-670.05,75f3f1d4-6fab-4aa1-8624-02a6d4358dfb,-11577.94,debit,payment,AU00000,2023-05-24T00:45:37Z
transaction,019298b9-8a30-4e8d-ae41-99eb3489a067,posted,Coffee Shop Purchase,-3111.02,8e7e2e9a-fee9-4506-ad5c-6604d9732706,3215.77,debit,bank-fee,AU00000,2023-09-29T21:04:09Z
transaction,cd73723d-ccb7-4a55-b606-2157b9b19295,posted,Hair Salon Appointment,-503.73,32412317-d3f2-48df-ac90-edf950c88979,2712.04,debit,cash-withdrawal,AU00000,2023-12-17T11:14:05Z
transaction,24e27b16-17b7-430b-8857-babff40d7d9a,posted,Gym Membership Fee,-100.82,f32809d9-7e04-448a-a0a5-194c2c6b6409,2611.22,debit,bank-fee,AU00000,2023-10-09T05:46:18Z
transaction,e66d4c8b-9cc0-4145-830f-79f6c90a67e4,posted,Manly Maths Tutor Wages,-2259.61,36b49111-c8a5-43d1-a661-554b4c97348b,351.61,debit,bank-fee,AU00000,2023-10-30T19:48:55Z
transaction,4e974324-7041-499d-b473-6780f3ccb858,posted,Car Maintenance Expense,-1587.9,2ca1d417-569c-4626-8d62-e67a6616ee16,-1236.29,debit,bank-fee,AU00000,2023-05-16T07:20:21Z
transaction,0dbfe89b-759c-4885-b9bf-aed98d5b47db,posted,Movie Ticket Purchase,-2899.15,d9411063-b37d-4be9-b940-5c89fa20ed5a,-4135.44,debit,payment,AU00000,2023-11-20T11:18:42Z
transaction,cc30052e-4869-43bb-adf3-2cc280d7edaa,posted,Uber Ride,-4373.42,6d13262a-d151-4027-a372-5380ba756a71,-8508.86,debit,cash-withdrawal,AU00000,2024-02-19T10:00:19Z
transaction,179440b2-8a2e-4ca5-8941-5f458f53514c,posted,Netflix Subscription,-3632.64,9a2fe206-5eca-42a0-844b-9ef34f80a9c6,-12141.5,debit,bank-fee,AU00000,2023-11-26T13:41:02Z
transaction,a330d5f7-cad8-4e3b-aaa3-bd1ed1d3782e,posted,Music Streaming Subscription,-4750.59,edf449ef-15ba-40d7-8b7a-ebe71dac6383,-16892.09,debit,payment,AU00000,2024-01-08T09:05:48Z
transaction,5e391639-ae24-4a78-9314-7b672b8778a7,posted,Public Transport Fare,-4399.73,bcf198b0-7abd-4120-9bca-ecb02046fb54,-21291.82,debit,cash-withdrawal,AU00000,2023-09-13T03:27:35Z
transaction,14dc3ab5-8a6e-409f-9ea5-615ccb52676c,posted,Clothing Store Purchase,-1939.72,52c59ae4-1360-4705-bead-eb07de18a003,9331.53,debit,payment,AU00000,2023-06-09T11:39:10Z
transaction,79699430-4503-4059-9f1c-ec7717bc4449,posted,Pharmacy Purchase,-2137.74,c3a3b7b6-9f94-4556-974a-0dc0e7c2f34d,7193.79,debit,bank-fee,AU00000,2023-08-10T17:23:50Z
transaction,bf7cb1a5-1a2f-4d9c-9f71-3aeb45f4bd7d,posted,Restaurant Dinner,-236.65,0c334658-ce34-4094-a1a0-3d93afda7bab,6957.14,debit,cash-withdrawal,AU00000,2024-02-08T12:33:39Z
transaction,aeaa5184-385e-4976-b065-82a5ede43666,posted,TRANSFER TO JOANNA SMITH CAMPING,-881.16,67237c26-fe84-40d1-b3a1-9cce78edfea3,6075.98,debit,bank-fee,AU00000,2023-11-05T22:30:38Z
transaction,ecfe295d-4a01-4cea-bd5f-37f239085527,posted,Amazon Online Shopping,-2129.14,f2cb3ed2-8808-4a44-8e8b-622dba646717,3946.84,debit,cash-withdrawal,AU00000,2023-09-28T02:33:41Z
transaction,b0e8caca-9c12-428a-bf94-e994c9ee8b78,posted,Public Transport Fare,-825.01,a2ee172c-0a30-41a8-83f0-996a02c5367f,3121.83,debit,bank-fee,AU00000,2023-10-15T12:24:07Z
transaction,b8f9652e-9d70-4326-8077-39a98349b9e5,posted,TFR Acc14000 TO 12389,-4717.35,0839a285-17ee-45f2-9254-001b8b960f30,-1595.52,debit,bank-fee,AU00000,2023-07-12T12:41:59Z
transaction,ed4df978-0a3d-48e4-a8e8-f374bea7d1c4,posted,Car Maintenance Expense,-2792.93,d63203bc-ad23-45c9-860d-ac56159e3050,-4388.45,debit,bank-fee,AU00000,2023-12-07T20:21:41Z
transaction,9f483007-ce2f-44da-9e5d-b9ad9e32b6f6,posted,AGL RETAIL ENERGY LTD (GAS),-115.06,82946c5f-ac7d-412e-b2ae-5bd60db475f7,-4503.51,debit,cash-withdrawal,AU00000,2023-06-10T18:58:48Z
transaction,f6eddbae-c1f7-48df-987d-2c0e9b5e36ae,posted,Netflix Subscription,-59.46,403c1f2a-b5fa-4f4e-aa54-70b8d240bf13,-4562.97,debit,bank-fee,AU00000,2023-10-21T06:18:14Z
transaction,dd0af219-1b0a-493d-b953-d866f0594489,posted,Wdl ATM WESTPAC IGA BALGOWLAH BALGOWL AU,-1817.99,c85511ca-3e8d-48f6-b209-38bd930fac9b,7543.59,debit,cash-withdrawal,AU00000,2023-07-20T13:56:28Z
transaction,321e74df-a29e-4bcb-a223-de2bb60da8f5,posted,Home Improvement Store Purchase,-2333.31,435c74e2-8777-4093-a937-0c347721fde4,5210.28,debit,cash-withdrawal,AU00000,2024-05-07T15:04:49Z
transaction,9f1ec0d7-7ba8-43a5-b14b-8ec39f7d9317,posted,CTRLINK CARERS Ref: 998R6789201610974V,-392.71,d4579331-3db2-4144-9b28-d47e6033d01a,4817.57,debit,bank-fee,AU00000,2023-07-18T01:24:10Z
transaction,9264b359-b5ec-434d-a2fe-77247a10e4ad,posted,Manly Maths Tutor Wages,-3762.84,df6b2655-e4c3-4734-a82e-1018dc8b7c4b,1054.73,debit,bank-fee,AU00000,2023-11-08T05:29:35Z
transaction,b18f0406-765f-4df4-9bc8-610758e1fbca,posted,Bookstore Purchase,-3679.67,73fcb388-756a-42de-98b5-c52c89382535,-2624.94,debit,cash-withdrawal,AU00000,2024-02-08T14:15:39Z
transaction,26d15d19-e4f7-401d-abb9-d48964fe6ddb,posted,Wdl ATM WESTPAC IGA BALGOWLAH BALGOWL AU,-269.78,080628c0-0c94-4d9c-857e-7112946a73f3,-2894.72,debit,cash-withdrawal,AU00000,2023-07-31T00:23:43Z
transaction,ab32b767-eca3-42b5-a871-4a399133efd0,posted,Movie Ticket Purchase,-1.81,a1a64734-291f-4ad9-868c-f132fa68ddb1,-2896.53,debit,bank-fee,AU00000,2023-06-18T11:31:34Z
transaction,064c62d0-ce18-4b1c-99b4-d37d67ea401d,posted,TFR Acc14000 TO 12389,-904.92,67732292-4376-4cdc-b4d7-309b7f0e244d,-3801.45,debit,payment,AU00000,2024-03-08T10:33:12Z
transaction,665c7ac6-29b4-42e9-b9d2-0d97d671d4d4,posted,Online Gaming Purchase,-4869.34,686b3180-a27b-4a19-8bf3-65cd939de16a,-8670.79,debit,payment,AU00000,2024-03-25T06:19:06Z
transaction,f60d25d2-1189-4e45-a835-7ccb0169cc25,posted,Uber Ride,-671.44,d682885d-ba8f-451b-bdda-384b1496eb29,-9342.23,debit,bank-fee,AU00000,2023-07-02T17:08:11Z
transaction,bd92b9aa-2664-445f-9dde-1506e71345a4,posted,AGL RETAIL ENERGY LTD (GAS),-578.08,a11255bb-8395-4e3d-94ad-f484d5ccf62e,11274.33,debit,payment,AU00000,2024-04-15T21:19:39Z
transaction,52046f05-f245-4987-ac10-8cfb2c2e36e9,posted,Coffee Shop Purchase,-2734.77,d9af3a69-89cd-42ca-b57e-12bf4b6acc1c,8539.56,debit,cash-withdrawal,AU00000,2024-03-09T21:50:09Z
transaction,3fffac04-b226-464e-8508-400ea6859071,posted,Manly Maths Tutor Wages,-881.74,26d88e51-168b-4425-9c7e-64becff25e3a,7657.82,debit,payment,AU00000,2024-02-03T02:06:10Z
transaction,cca533ab-d3b8-4e06-986c-ac77abe28260,posted,Music Streaming Subscription,-1901.79,d3a338be-69a9-4cba-99ed-5d4cf63b923e,5756.03,debit,cash-withdrawal,AU00000,2023-07-03T02:38:05Z
transaction,d53df746-6d27-40d0-949b-eb9188c3152c,posted,AGL RETAIL ENERGY LTD (GAS),-35.65,3c06a702-8ce8-4154-9f62-4f5eae2e0042,5720.38,debit,cash-withdrawal,AU00000,2024-05-05T01:47:54Z
transaction,a2df1ffd-fb32-49ff-ba96-e1a5869a8b40,posted,Netflix Subscription,-3882.84,31aa23b8-b18d-475e-8388-644c20be43c9,1837.54,debit,payment,AU00000,2024-03-16T17:39:38Z
transaction,d3068cb3-d255-4a02-9cf1-6959e270fe95,posted,Non Hooli ATM Withdrawal Fee,-4826.25,d484e7ed-b6c7-4d5e-9b47-d64c6c2e9336,-2988.71,debit,cash-withdrawal,AU00000,2023-07-17T16:31:42Z
transaction,62cd138b-9ea2-48aa-8d1d-55572c50ed7a,posted,Gym Membership Fee,-2912.94,6c2cdfd9-4dd9-477d-bfa6-c64c32f7e10a,-5901.65,debit,bank-fee,AU00000,2023-07-18T04:40:10Z
transaction,1555fa76-f818-45ff-9959-4f09b9644e86,posted,Restaurant Dinner,-2597.61,45753589-d3a2-4718-80d3-22a803d85cc3,-8499.26,debit,bank-fee,AU00000,2024-01-22T12:40:47Z
transaction,62da07a9-b46a-4ade-8f75-e5a874e08362,posted,Clothing Store Purchase,-2461.17,97387314-64b9-4b73-af78-a2f08c177b3e,-10960.43,debit,bank-fee,AU00000,2023-08-05T07:58:58Z
transaction,d755b17f-7ed0-45e7-9854-f69ea2d302cf,posted,Non Hooli ATM Withdrawal Fee,-3090.23,a1fc6ccf-9a26-4022-b955-a1cecda71baf,7343.65,debit,bank-fee,AU00000,2023-09-20T04:11:18Z
transaction,603fd2a3-40f0-4dac-8029-4b521c27eb4b,posted,TRANSFER TO JOANNA SMITH CAMPING,-1416.5,77c79e92-e448-4773-9624-45b88b8ef25e,5927.15,debit,payment,AU00000,2023-07-12T01:48:25Z
transaction,547d1520-b6f1-4ddd-8946-4fc5c402bb57,posted,Manly Maths Tutor Wages,-4265.96,246ebfee-f8e4-44b5-84f6-7edf0db753d8,1661.19,debit,payment,AU00000,2023-12-09T01:27:09Z
transaction,dc99a2ff-e865-45ea-9148-99f81fba2148,posted,Electricity Bill Payment,-2907.83,08843bac-7c45-4651-8ad3-2ba19b74060c,-1246.64,debit,cash-withdrawal,AU00000,2023-10-17T19:48:24Z
transaction,5978c9e7-12d2-47c4-87fc-ec61728064d2,posted,Home Improvement Store Purchase,-1561.63,1b728b9c-fa62-436d-b995-5c09917c2eff,-2808.27,debit,payment,AU00000,2023-12-04T13:17:49Z
transaction,8f969e15-1aab-4ce5-ad6b-09fd6d1ada17,posted,Gasoline Purchase,-2090.29,b7be4d1d-fa37-4ff2-b0aa-2c3d9c616a5a,-4898.56,debit,bank-fee,AU00000,2023-06-19T10:17:55Z
transaction,787b38fd-92b3-47d5-9a2f-994089545b28,posted,AGL RETAIL ENERGY LTD (GAS),-583.43,17385c69-2e49-4854-919e-6289aaa95d62,-5481.99,debit,cash-withdrawal,AU00000,2023-08-30T17:52:33Z
transaction,baff3877-8b3c-4481-b075-635b35e02ff1,posted,Hair Salon Appointment,-3837.49,5c268ac6-30a5-4cac-819b-610bd1ff7725,-9319.48,debit,cash-withdrawal,AU00000,2023-12-26T23:46:32Z
transaction,f44a17a6-89a4-407b-b288-4b97fcba45e8,posted,Restaurant Dinner,-2959.48,f15d65f6-173a-4b0d-82b3-24d2373ca183,-12278.96,debit,cash-withdrawal,AU00000,2023-12-23T04:45:25Z
transaction,87272802-b2ba-417e-9e17-54d56171aa66,posted,Wdl ATM WESTPAC IGA BALGOWLAH BALGOWL AU,-3857.26,b69ade0d-767f-4198-8ea0-234275b0000f,-16136.22,debit,bank-fee,AU00000,2023-07-27T12:44:30Z
transaction,72ab4037-b97d-4ee7-ad46-3b3c4d74924d,posted,Mobile Phone Bill Payment,-1982.04,1d7f5dfc-22cf-4ea8-8948-c3ac278f6f35,3537.99,debit,cash-withdrawal,AU00000,2023-06-24T08:59:49Z
transaction,903efe6d-00bb-4a54-9c25-ed59dffed388,posted,Restaurant Dinner,-3936.65,8daf715f-bcb0-48db-8df0-b481d24c43ab,-398.66,debit,bank-fee,AU00000,2023-10-30T10:45:48Z
transaction,4dbf1ec2-950f-4139-b475-71d6de982a45,posted,Car Maintenance Expense,-2985.66,8bc0bd47-33be-4c82-8197-6d0e3b3c462f,-3384.32,debit,cash-withdrawal,AU00000,2023-07-24T17:31:12Z
transaction,f51a92ad-6b90-4017-80f2-b772a1f7aaf3,posted,Uber Ride,-2850.78,ea2ae86f-86ef-4cfa-8f4b-fcd1ccc86d91,-6235.1,debit,bank-fee,AU00000,2023-08-31T21:27:56Z
transaction,e182a24b-aff0-483a-9afa-ed7c3165557a,posted,Public Transport Fare,-2413.7,5501e517-693f-4f3d-ab70-de27f6792d73,-8648.8,debit,bank-fee,AU00000,2023-12-02T04:04:19Z
transaction,be3c7588-9ee2-4887-bc7e-645fb1609f89,posted,Mobile Phone Bill Payment,-1619.65,b9fb5382-75f6-4aac-ac36-4c3a536258b0,-10268.45,debit,cash-withdrawal,AU00000,2024-03-30T13:00:58Z
transaction,7605942d-e481-4759-9575-1fe1adb2337f,posted,Gym Membership Fee,-3602.52,2d41491f-6dd8-459c-b2d9-5fd7df4759e5,-13870.97,debit,payment,AU00000,2024-02-08T03:54:56Z
transaction,9c5a6602-8a11-4747-a045-3be3071a0411,posted,Home Improvement Store Purchase,-4004.08,2c194693-acd0-41c7-9841-55e4a0299fee,-17875.05,debit,payment,AU00000,2023-10-10T03:25:23Z
transaction,e1b7b6b0-0d71-4708-be73-9de3849c120c,posted,Online Gaming Purchase,-4223.44,4047ab2d-84b4-4854-9062-65f12d79787d,-22098.49,debit,payment,AU00000,2023-10-17T06:47:31Z
transaction,5d5b4bec-a10f-4bbe-9ecf-052e35cc4dd9,posted,Electricity Bill Payment,-2413.42,b600391a-58c9-4fe0-9a71-85dfc005dd37,-24511.91,debit,bank-fee,AU00000,2024-04-15T14:53:19Z
transaction,52e9fc14-35f3-4b74-8b32-77a11d071931,posted,Gym Membership Fee,-893.1,f67d9dee-6ad0-4672-aa89-140cd5ae66ec,5082.17,debit,bank-fee,AU00000,2023-12-22T03:41:13Z
transaction,9b5e67d9-4fe1-43b1-8d05-4ecd61629af5,posted,Payroll WFRMS 15439393,11508.4,40a8d45e-19e4-4775-9ac4-d6466173d11b,16590.57,credit,transfer,AU00000,2023-08-11T15:46:56Z
transaction,de64179b-a95d-42bc-8602-6ed151a53b45,posted,TRANSFER TO JOANNA SMITH CAMPING,-192.26,ec619bff-1e22-4e44-8ff2-7fa552fae8aa,16398.31,debit,cash-withdrawal,AU00000,2024-01-21T11:50:32Z
transaction,a2af79e6-198e-4e88-b16c-83afd81a5e8b,posted,Coffee Shop Purchase,-2408.44,85933f13-c341-456a-bcd2-4976ff509def,13989.87,debit,cash-withdrawal,AU00000,2024-05-04T11:31:07Z
transaction,9b22e57f-1e69-4e88-8f3a-edac3d3842d0,posted,Movie Ticket Purchase,-1199.37,74130ecc-a202-4798-b7bb-fb720747e155,12790.5,debit,bank-fee,AU00000,2023-06-01T09:27:39Z
transaction,5ef5a20a-c893-4174-ae04-e51599f6ff51,posted,Wdl ATM WESTPAC IGA BALGOWLAH BALGOWL AU,-541.23,de0f02b4-a35a-41ae-8b16-89b56c92af11,12249.27,debit,cash-withdrawal,AU00000,2023-09-21T10:27:56Z
transaction,7e4d531d-1ee3-44c8-871a-31ecbcaebb0e,posted,TFR Acc14000 TO 12389,-165.71,b746bc7e-3272-4b68-a493-51a325f32dcd,12083.56,debit,bank-fee,AU00000,2023-10-18T00:43:08Z
transaction,818d4269-2f54-42e7-8358-7cd602a20ee4,posted,Gasoline Purchase,-4604.03,f6af66c1-3de5-403c-a7b4-c143efb71829,7479.53,debit,bank-fee,AU00000,2023-11-13T13:43:55Z
transaction,ed9098ec-05e9-4143-8ce9-f77a99f9bd73,posted,Online Gaming Purchase,-1794.27,0966c8d5-e9bf-4f7a-a804-89666df2330f,5685.26,debit,cash-withdrawal,AU00000,2024-01-10T06:08:44Z
transaction,0a28b314-eff6-4b75-86a7-9c406aeccdf5,posted,Travel Agency Booking,-995.64,216ba646-fb5e-4f21-93f5-5b85fbf335e2,4689.62,debit,bank-fee,AU00000,2024-04-16T05:22:03Z
transaction,1612fbb8-41b8-4ec1-8125-b35a3d8b4e4d,posted,Netflix Subscription,-267.39,1b99980f-9054-4dfa-8f7c-c2713cdb3874,16275.29,debit,payment,AU00000,2023-11-03T07:41:30Z
transaction,7de7055a-fecf-4991-80e9-df44c516eeb1,posted,Electricity Bill Payment,-1140.41,c6977736-d66c-4f0c-bdb6-23f35f67559e,15134.88,debit,cash-withdrawal,AU00000,2024-02-05T08:43:30Z
transaction,a855bab4-f286-470f-bcbf-8b3e6cd9ddd9,posted,AGL RETAIL ENERGY LTD (GAS),-4443.92,0b18d093-f89f-4b86-9599-93ffcee775bb,10690.96,debit,payment,AU00000,2023-08-23T22:07:04Z
transaction,d814876c-0337-4645-8cbf-d69d77083a07,posted,Gym Membership Fee,-4877.49,0ad66c02-991c-42de-81a7-0d835533d231,5813.47,debit,cash-withdrawal,AU00000,2023-12-06T01:51:59Z
transaction,f244dc2b-6b4d-41eb-9dc8-5bdd86786807,posted,Wdl ATM WESTPAC IGA BALGOWLAH BALGOWL AU,-3487.73,5c3b0707-e854-4937-b450-f9b330d374c1,2325.74,debit,cash-withdrawal,AU00000,2023-07-04T09:37:15Z
transaction,6b8de7d5-9967-4573-9a27-2948390903c9,posted,Restaurant Dinner,-4667.92,88e6ccc5-8793-4c62-90d9-dc622d75682f,-2342.18,debit,payment,AU00000,2023-12-22T20:47:15Z
transaction,bde48262-3c59-4ef4-bd47-ad6675c30d2d,posted,Travel Agency Booking,-318.8,f6142adf-598f-4d25-85a3-1868d91e6c45,-2660.98,debit,cash-withdrawal,AU00000,2023-07-26T10:03:58Z
transaction,bd45b67a-9398-4ba7-b274-469a21cb2f01,posted,Coffee Shop Purchase,-1523.68,5446bfad-8d10-43a3-bb70-5bc15270a2f1,-4184.66,debit,payment,AU00000,2023-07-15T05:21:27Z
transaction,4e6a8793-c76b-4ab3-9edc-f6f26cd4b722,posted,Uber Ride,-2211.14,7dd7abb9-5740-476a-a0d9-1782edbf3c47,-6395.8,debit,cash-withdrawal,AU00000,2023-07-19T10:17:05Z
transaction,b5e9bb0a-aa45-4ee7-ab8e-879162c687c7,posted,Gym Membership Fee,-2577.73,510f4482-17fc-4c4a-b5dc-c0e9601a8056,-8973.53,debit,bank-fee,AU00000,2023-10-20T08:32:39Z
transaction,1921e41b-27b9-40bb-9632-c3e1c8833fb8,posted,Manly Maths Tutor Wages,-3764.34,1a7e6eb0-9a1d-4a05-b96c-6faf68afa3ad,14161.8,debit,cash-withdrawal,AU00000,2023-06-09T04:45:36Z
transaction,4659f3aa-cb20-4ad4-94f3-7ddc5afa6a04,posted,Car Maintenance Expense,-897.7,60f321ac-9a39-455e-8308-3755b686d8a0,13264.1,debit,cash-withdrawal,AU00000,2023-07-01T05:15:28Z
transaction,e23acc15-4009-49d6-a2b4-cbb2bbd3acb7,posted,AGL RETAIL ENERGY LTD (GAS),-3979.94,925c9149-bd99-4c6f-b3e4-83a29a240b50,9284.16,debit,payment,AU00000,2024-01-09T04:45:22Z
transaction,20e3b96a-8524-45e7-8054-b1d3f8a97193,posted,Gasoline Purchase,-3522.73,5e47a591-f0c7-4d68-91d2-7ce429ed3644,5761.43,debit,payment,AU00000,2023-11-13T20:27:02Z
transaction,fc16916b-f79f-4cee-8230-00b4c3d5b086,posted,Restaurant Dinner,-4087.55,a8e29e61-71da-4c5e-86ac-e7fe098663c2,1673.88,debit,cash-withdrawal,AU00000,2024-01-15T16:30:12Z
transaction,ce671f4b-1228-4be4-9af2-e2f8773b2209,posted,Amazon Online Shopping,-3949.0,fcbf73f0-ac23-43e1-b532-25fd170e72ab,-2275.12,debit,payment,AU00000,2023-11-02T13:56:42Z
transaction,e64eaba0-0e17-4c98-b941-597ed407a411,posted,Transfer Platnm Homeloan 346454,-135.61,cf419d43-90ec-49d5-9523-f9df05e3ac71,-2410.73,debit,bank-fee,AU00000,2024-01-28T00:19:27Z
transaction,c484f6aa-bee9-4835-b672-5b42184d35df,posted,Travel Agency Booking,-3357.39,db28d4fb-27ae-4047-a2ea-83c709b97303,-5768.12,debit,bank-fee,AU00000,2024-01-28T14:10:08Z
transaction,b5d237eb-6347-4fa7-8689-173fef4ef616,posted,Mobile Phone Bill Payment,-1.32,873814ad-d451-475c-adc9-ec0277cdf6d3,-5769.44,debit,cash-withdrawal,AU00000,2023-06-27T11:34:35Z
transaction,12edef97-12c3-4dd4-a11a-73f5105afede,posted,Mobile Phone Bill Payment,-3084.87,d93f01d2-8063-4aee-908d-4daab8eaa88b,-8854.31,debit,payment,AU00000,2024-02-07T19:03:37Z
transaction,d9e0b873-f636-4039-9b7b-8fcb7ebe908d,posted,Car Maintenance Expense,-1370.84,018dfbb1-f00d-4961-9e19-54a0f0118860,6188.77,debit,cash-withdrawal,AU00000,2023-12-14T07:01:06Z
transaction,1c132aaf-bbda-4d5e-9fd5-c926dfc656ef,posted,Transfer Platnm Homeloan 346454,-2935.42,2702f64a-6b46-4169-9adf-9cb45cc8e1ce,3253.35,debit,payment,AU00000,2024-02-24T08:04:49Z
transaction,cb6094dd-0e1d-4341-9f52-f033b74cc58c,posted,Netflix Subscription,-4319.07,92d314f0-1412-4c0a-8d91-c44cdc76886c,-1065.72,debit,bank-fee,AU00000,2023-08-17T07:23:54Z
transaction,e0158a68-5dd1-4006-8940-296686e050b9,posted,Home Improvement Store Purchase,-2986.96,ffe442ed-eb95-4eb9-befc-46153880d8fd,-4052.68,debit,bank-fee,AU00000,2023-11-17T10:43:00Z
transaction,0966316d-e685-44e8-b481-e119e747a3c4,posted,Hair Salon Appointment,-2405.44,b114182a-3466-4cce-9788-65411865758c,-6458.12,debit,payment,AU00000,2023-11-05T19:50:44Z
transaction,576f6e1f-cafe-4a4f-ab30-9e23a3339798,posted,Restaurant Dinner,-936.03,c52dc193-5278-4066-a595-5f256c843c6f,-7394.15,debit,payment,AU00000,2024-01-23T05:20:12Z
transaction,6d0b67c2-c9de-4eb2-bdd1-678b6fa28ed0,posted,CTRLINK CARERS Ref: 998R6789201610974V,-4569.04,ae4d91a3-e479-4cd1-ad53-64c89025df5f,-11963.19,debit,payment,AU00000,2023-06-02T01:29:31Z
transaction,40e2aa7d-39c7-4f57-b233-ee250323b739,posted,Payroll WFRMS 15439393,11161.09,19d7a177-56cd-429b-a7ba-12414e4133c8,-802.1,credit,transfer,AU00000,2024-02-26T13:38:57Z
transaction,cbcc6d48-3032-4d87-b871-53dfcd651b5e,posted,Restaurant Dinner,-295.44,04f831da-8e4d-4b72-b89e-8f48003a493b,-1097.54,debit,cash-withdrawal,AU00000,2024-01-08T17:19:30Z
transaction,98a46618-bb8d-4ee2-9d30-5a8031271923,posted,Transfer Platnm Homeloan 346454,-2770.99,adf13bc5-ed76-4084-ba22-b34cbefa9a72,-3868.53,debit,payment,AU00000,2023-07-22T18:45:56Z
transaction,36f4c744-8b9a-4754-b9b6-405587d75251,posted,Hair Salon Appointment,-2272.85,a844d398-b2eb-4dd5-a105-5cb2a553826d,5130.18,debit,bank-fee,AU00000,2023-11-27T06:10:14Z
transaction,9ef505b9-43ed-49b2-a86f-a871b03226fb,posted,Travel Agency Booking,-3395.26,531e24d6-33c4-4331-8bfc-e9be14e57e2e,1734.92,debit,bank-fee,AU00000,2024-01-23T08:58:04Z
transaction,9e618f3f-2342-4236-b2a0-71a20cde42bc,posted,Manly Maths Tutor Wages,-2164.49,d48ffc0c-9675-4628-bb1d-3b8e87b4b457,-429.57,debit,payment,AU00000,2023-10-04T13:54:00Z
transaction,96959987-1af7-44f9-9dd8-6be2425f7875,posted,Online Gaming Purchase,-3987.28,27635ca7-53d3-4b1e-9882-423aea8a1185,-4416.85,debit,bank-fee,AU00000,2024-01-15T13:46:45Z
transaction,be14d3f6-8c9e-49ec-a3a6-0ccfdb59fffb,posted,Non Hooli ATM Withdrawal Fee,-747.74,e25dcd81-c6c6-409d-a97c-7a6e4b06766b,-5164.59,debit,payment,AU00000,2024-05-10T04:16:40Z
transaction,5043ae15-c30d-4d31-9488-b8b8ffacc699,posted,Movie Ticket Purchase,-4253.94,02bc8a02-49dc-416d-ab32-d2ad4980465f,-9418.53,debit,bank-fee,AU00000,2024-03-11T02:41:19Z
transaction,b5183ffb-d019-4a4d-9b47-94c69f07e858,posted,Car Maintenance Expense,-3776.65,ae58b4b1-4c0f-41c9-9f9d-764577ab500b,-13195.18,debit,cash-withdrawal,AU00000,2023-11-18T23:21:57Z
transaction,2321dd34-0d16-4b5c-993c-9cd840f422bd,posted,Uber Ride,-105.37,c380e6da-0d39-4f43-9b28-7d005d87203d,-13300.55,debit,payment,AU00000,2024-03-24T21:47:27Z
transaction,b9aef1a6-aa22-42d2-813e-24454aa8255d,posted,AGL RETAIL ENERGY LTD (GAS),-236.38,13c20db2-604c-41bf-8756-933246d57a31,-13536.93,debit,bank-fee,AU00000,2024-04-28T00:56:47Z
transaction,e645cffa-f481-4172-af9a-37eb6d95d8ec,posted,Coffee Shop Purchase,-2319.89,edb3f296-68ad-4b3b-848b-bc97766ea7d0,-15856.82,debit,bank-fee,AU00000,2023-12-26T11:01:25Z
transaction,f59ee1a7-a9b7-47e0-be45-f97bb352026e,posted,Home Improvement Store Purchase,-1645.36,32103ebd-ac4d-4a51-a983-d9bc1b489978,12597.46,debit,payment,AU00000,2023-08-25T09:27:07Z
transaction,3daeec01-c6dd-4e14-9081-4fe248101841,posted,Amazon Online Shopping,-1111.98,70ed71c8-a1af-499a-bdc3-5a29de7f2a58,11485.48,debit,payment,AU00000,2023-06-22T08:29:38Z
transaction,4a12f6e7-c38b-4ea3-9a61-169a9707058b,posted,Home Improvement Store Purchase,-4513.85,0b5b179f-ccd6-44da-8a0b-15bf223254b2,6971.63,debit,payment,AU00000,2024-04-25T01:54:11Z
transaction,96b6a13d-1981-4ddf-9b16-adc9a6d8feda,posted,Payroll WFRMS 15439393,10806.97,462fffae-4846-4eff-9c41-abf5099fc6ab,17778.6,credit,transfer,AU00000,2023-11-08T18:49:21Z
transaction,9e1a8701-ca7d-4c0c-aa52-e4c7b5e4568a,posted,Bookstore Purchase,-2935.47,a7c16629-e3de-46c7-a823-2d1a90a69a0e,14843.13,debit,payment,AU00000,2023-07-10T11:45:12Z
transaction,2e3e96df-c7d8-4731-aac9-f58fbff3c38d,posted,Restaurant Dinner,-2727.05,2686ffef-face-4de0-9af1-77e31fb8e3ce,12116.08,debit,cash-withdrawal,AU00000,2024-02-08T10:32:49Z
transaction,095e9261-20a4-4d16-86c5-b9ff5e61e02a,posted,Payroll WFRMS 15439393,11362.16,36576bb3-4756-49a4-a749-5783d9d8f007,23478.24,credit,transfer,AU00000,2024-01-18T07:12:51Z
transaction,ac47275f-de01-418b-8b88-fb42d847706e,posted,Restaurant Dinner,-2964.58,df1cd91e-30f5-4e11-859a-670dc0f79fbd,20513.66,debit,payment,AU00000,2023-05-18T09:52:05Z
transaction,09f61e32-e7d9-4623-aefb-1541ec11796c,posted,Gasoline Purchase,-696.43,680a07aa-34b6-4056-9651-ae805a1fbee7,19817.23,debit,cash-withdrawal,AU00000,2023-05-30T04:37:45Z
transaction,97e178ee-726e-4e54-9c99-c0da66b0fe9f,posted,Uber Ride,-3565.91,1286b790-6afb-4e0b-8c30-c85a8d2256c8,16251.32,debit,payment,AU00000,2023-11-12T16:34:40Z
transaction,64f1573b-5edf-4220-84c1-309bdb0c1a55,posted,Music Streaming Subscription,-4404.22,22ae4e04-ace2-48ef-a2c8-8a0fa77fe0d7,6143.33,debit,bank-fee,AU00000,2023-06-07T05:57:32Z
transaction,bc6858c2-e82a-4ffe-bfca-638b38c9bd49,posted,Coffee Shop Purchase,-4068.0,1dc85781-3872-4475-bcde-946bed5cf6e5,2075.33,debit,bank-fee,AU00000,2024-02-04T05:26:56Z
transaction,e99c5d88-76a2-4acd-ab5c-f78ff3230bfe,posted,AGL RETAIL ENERGY LTD (GAS),-183.91,925a6c41-9dfb-489a-966e-bb38b206e0a1,1891.42,debit,cash-withdrawal,AU00000,2023-11-16T21:05:38Z
transaction,09cefcee-4cbb-4f62-b6e4-6e89d33a31b6,posted,CTRLINK CARERS Ref: 998R6789201610974V,-201.26,d1ec9f6e-4ec1-4805-97f8-c598f573715b,1690.16,debit,payment,AU00000,2023-05-16T19:51:20Z
transaction,363079a2-d396-4ed8-99b1-2068b167b479,posted,Restaurant Dinner,-4534.66,186f1ad6-3724-412d-9887-ce8385a87b77,-2844.5,debit,cash-withdrawal,AU00000,2023-08-05T21:41:07Z
transaction,3938c7f3-59a1-4a8f-8f3f-04497416a4ac,posted,Music Streaming Subscription,-0.47,d2fffdc3-4b47-4673-afff-c57d9bb2d307,-2844.97,debit,bank-fee,AU00000,2023-08-21T18:23:01Z
transaction,b8598e8a-527f-44d6-bbb2-0aabfad65b3c,posted,Mobile Phone Bill Payment,-3242.36,7d15e279-7f8d-4cfe-9269-8bd1cbefa4e7,-6087.33,debit,cash-withdrawal,AU00000,2023-11-07T23:42:57Z
transaction,0758a33a-5666-4f84-8230-e2a1d31e1d75,posted,TFR Acc14000 TO 12389,-2706.02,6d8fbf34-4809-4413-b80e-941b004dce83,-8793.35,debit,payment,AU00000,2023-08-18T17:45:32Z
transaction,ffe51fc1-2fa8-4eb4-8810-f89301a7a9c4,posted,Online Gaming Purchase,-3888.38,cff94fc3-171e-4224-9974-132f0875943d,-12681.73,debit,cash-withdrawal,AU00000,2023-10-17T05:36:58Z
transaction,6f94b6a8-869d-438b-9b77-2259ea19aaee,posted,Amazon Online Shopping,-4602.12,55b39329-3567-4517-834c-455de3ec4704,-17283.85,debit,cash-withdrawal,AU00000,2023-06-15T17:27:28Z
transaction,b25dc479-b02a-48f5-8025-26e5797e4d44,posted,Electricity Bill Payment,-2461.68,2020b9c3-5f47-439d-8429-5c9bd9bdbfb3,16784.6,debit,bank-fee,AU00000,2023-08-01T22:19:34Z
transaction,f7f9dc8e-6d0f-4cc3-b583-f6dcd57fac12,posted,CTRLINK CARERS Ref: 998R6789201610974V,-2604.98,44c770c7-0bb9-4423-9203-49e52ecf4e10,14179.62,debit,bank-fee,AU00000,2023-07-01T12:10:06Z
transaction,815899d4-7d30-4c7c-b9b4-e9e28a4d2b36,posted,Amazon Online Shopping,-4685.68,ba1e19c2-d6d6-4937-8259-568e74458836,9493.94,debit,payment,AU00000,2023-06-22T06:12:37Z
transaction,1c8c051c-d7e5-44bd-b884-d4a8c5ce9d94,posted,AGL RETAIL ENERGY LTD (GAS),-2668.05,d43efa94-4cd6-4e58-83b3-9b3b9a74f3c0,6825.89,debit,payment,AU00000,2024-04-12T20:02:23Z
transaction,c7433fe8-b0e4-4f64-a41b-de5a0ae718bf,posted,Car Maintenance Expense,-2907.57,01820ab6-8c65-401f-a47c-862b45324838,3918.32,debit,payment,AU00000,2023-12-30T12:51:20Z
transaction,3b85d4e8-dfc5-493f-a68d-a7e11449f58b,posted,TRANSFER TO JOANNA SMITH CAMPING,-98.76,c1406050-182a-47b1-a817-7fe9bdc86832,3819.56,debit,payment,AU00000,2024-03-11T19:23:06Z
transaction,b82b68c9-5dc4-475b-870f-5f172a0dce63,posted,Netflix Subscription,-1046.49,06387fe5-e247-4f42-a2e7-927bf44eadec,2773.07,debit,bank-fee,AU00000,2024-03-30T23:28:02Z
transaction,25d8b4ec-d783-49de-9581-a41f74a3c1f9,posted,AGL RETAIL ENERGY LTD (GAS),-4675.98,bed172c5-328b-4f7f-bf08-081c3a0a46b8,-1902.91,debit,payment,AU00000,2023-10-01T14:05:31Z
transaction,1204de77-a2c4-4eac-b42c-40baa6265d04,posted,Music Streaming Subscription,-3294.9,1a3d4484-b852-4751-8fb9-dc77d307b74c,-5197.81,debit,bank-fee,AU00000,2023-12-22T17:57:47Z
transaction,620c335b-6418-435c-97c3-136447fb8fc5,posted,Mobile Phone Bill Payment,-3217.7,ca41f7c7-f55b-451d-8146-7f62b7672ea4,-8415.51,debit,bank-fee,AU00000,2024-03-22T01:55:35Z
transaction,84af6f7d-b508-46be-b375-8a965d003698,posted,Music Streaming Subscription,-1443.4,143fbdda-ecf2-494b-8cb4-380dd39e5559,11254.0,debit,cash-withdrawal,AU00000,2023-07-28T08:09:16Z
transaction,3e3eaa59-9902-4793-aece-635f8a67a1eb,posted,Clothing Store Purchase,-61.96,98ac2b93-3d39-4b51-8442-c88bea8703e0,11192.04,debit,payment,AU00000,2024-02-02T05:21:14Z
transaction,19c02e4e-2eb9-4404-8981-ba1c360d4a56,posted,Movie Ticket Purchase,-1256.14,b3dd18a7-7759-4502-a62e-98750e5cfad3,9935.9,debit,bank-fee,AU00000,2023-05-13T00:11:24Z
transaction,aee8af4b-a98e-404f-9e3c-bd30e5b6a577,posted,Uber Ride,-405.0,14a8541b-682a-4110-8d38-8c964599006b,9530.9,debit,payment,AU00000,2023-07-15T10:04:46Z
transaction,8acfdcb7-82ee-4705-9e06-68be584cfc78,posted,Music Streaming Subscription,-1451.33,d903c915-0acc-4352-ab14-8008545b7329,8079.57,debit,payment,AU00000,2023-07-31T23:58:24Z
transaction,afee1728-9114-401f-95cd-a85695af80d5,posted,Coffee Shop Purchase,-4911.71,8fc1e861-9f47-4921-af0c-13b23261f7b7,3167.86,debit,cash-withdrawal,AU00000,2023-10-13T16:14:50Z
transaction,862e3a2d-3546-4613-8ce9-da1b505d4516,posted,Electricity Bill Payment,-3670.93,d96b80e8-f4aa-4dfc-8c40-e803faa7fd19,-503.07,debit,cash-withdrawal,AU00000,2024-02-26T18:00:50Z
transaction,9e359df0-451e-436b-8d0a-440bc5affd8c,posted,Non Hooli ATM Withdrawal Fee,-462.02,48a19b65-f837-4e0b-88a7-38e51a089ac7,-965.09,debit,payment,AU00000,2024-02-17T15:12:19Z
transaction,d392f912-f1ba-4dfb-9614-ba80aaa3c268,posted,Movie Ticket Purchase,-3536.82,6608bf94-d33e-4573-a81a-6b434f6a3944,-4501.91,debit,cash-withdrawal,AU00000,2023-07-26T11:29:11Z
transaction,9d96326c-8637-4b96-abf4-21797b8fb395,posted,TFR Acc14000 TO 12389,-4059.76,e9842e79-f114-46ad-9e51-70debd249497,-8561.67,debit,cash-withdrawal,AU00000,2024-01-27T12:21:02Z
transaction,6c4191cc-736a-446a-adfa-0e13e5dffd48,posted,Non Hooli ATM Withdrawal Fee,-510.32,10a52464-96d0-4ff7-afce-99e89e755810,15376.55,debit,payment,AU00000,2023-05-18T01:50:32Z
transaction,0006728a-74fb-435d-9d50-452f23bd8462,posted,Pharmacy Purchase,-3438.58,3e7cfd43-bcae-4e58-a317-1b7571b59812,11937.97,debit,payment,AU00000,2024-05-07T03:20:40Z
transaction,e366158a-de16-48fe-8739-a3bb3ec08d5a,posted,Car Maintenance Expense,-1173.33,31a44509-db69-44bf-8a79-20cc1722d4df,10764.64,debit,payment,AU00000,2023-12-17T09:01:52Z
transaction,b9086c61-f4c4-4f39-8f71-ac463d7c2ded,posted,Uber Ride,-3474.27,c9339979-0a2d-49ba-b335-61cee272c9cd,7290.37,debit,payment,AU00000,2023-09-28T17:21:31Z
transaction,e6ab95ae-e9cd-4186-8ebe-bf81917139c6,posted,Wdl ATM WESTPAC IGA BALGOWLAH BALGOWL AU,-3081.38,634f2acd-bb14-46fd-b054-857438ffa22d,4208.99,debit,payment,AU00000,2023-06-18T23:00:03Z
transaction,18276807-201e-42be-b9d8-ef388fcc7b0e,posted,Payroll WFRMS 15439393,10548.04,b38ecaeb-43e4-4f47-8b55-6a8bb99a5454,14757.03,credit,transfer,AU00000,2023-08-28T23:54:17Z
transaction,5e621472-7c55-4cdc-b3ce-e19e6e94ad9c,posted,Online Gaming Purchase,-2405.97,4a5356be-0340-4c1b-8f77-c5ad3ff7d048,12351.06,debit,bank-fee,AU00000,2023-11-21T04:59:54Z
transaction,13d7892b-629e-4020-ba13-d08daba6b494,posted,TRANSFER TO JOANNA SMITH CAMPING,-1446.16,46c2cb50-03e8-486b-8444-323a73458ef0,10904.9,debit,payment,AU00000,2024-03-22T15:09:28Z
transaction,3b811cfc-cae1-4030-9f06-5f23b133c7ec,posted,Payroll WFRMS 15439393,11060.07,e7624022-689d-401e-924b-156eabb6c2d2,21964.97,credit,transfer,AU00000,2023-09-14T07:02:22Z
transaction,1725fc30-80b2-4d79-aefe-45874d03905c,posted,Movie Ticket Purchase,-1375.27,43610490-6bba-4a40-9558-0a2cb37d98b5,20589.7,debit,cash-withdrawal,AU00000,2023-11-25T05:50:28Z
transaction,684855f2-fd73-4485-a827-754f916c638e,posted,Online Gaming Purchase,-2249.37,8abdd97e-a40b-4884-9a08-26e360ec0b41,8118.76,debit,bank-fee,AU00000,2024-05-07T07:07:12Z
transaction,2d94bed6-479e-48d6-8894-ad8fe7239f2b,posted,TRANSFER TO JOANNA SMITH CAMPING,-3611.17,05a66dcb-3e25-4edd-8e9a-ebb29b4687fd,4507.59,debit,bank-fee,AU00000,2023-10-29T16:50:32Z
transaction,24ae4df3-4718-40e9-8879-9bcd6841ce15,posted,Car Maintenance Expense,-1395.75,aea172ef-4f28-45ff-836b-eaa1b854390b,3111.84,debit,cash-withdrawal,AU00000,2024-01-06T21:24:54Z
transaction,95608b02-7742-49c1-912f-5c90efec3908,posted,Home Improvement Store Purchase,-4983.47,c8a574b7-3ae2-422b-a69f-75cb1b8e8c29,-1871.63,debit,bank-fee,AU00000,2023-09-01T09:25:51Z
transaction,9fd874a4-86f0-4438-87d6-e37e83dfe35b,posted,Travel Agency Booking,-4229.86,dd83dcda-a274-4c97-8144-0aa6ff0b39d1,-6101.49,debit,cash-withdrawal,AU00000,2024-01-28T02:44:13Z
transaction,0567a450-cd0b-47a0-bf17-887cce29f899,posted,Pharmacy Purchase,-1657.51,9dedf3a3-a2af-4cd9-97cd-80d6353208b1,-7759.0,debit,cash-withdrawal,AU00000,2023-12-26T11:00:11Z
transaction,33ae8eb3-c9f3-4799-a5d4-953dfaca5716,posted,Amazon Online Shopping,-4425.73,24c417f9-f0f6-4027-9286-058a820a81db,-12184.73,debit,payment,AU00000,2023-05-19T02:35:42Z
transaction,d16168a4-a6e1-42b2-84fe-2046e17c2b14,posted,Restaurant Dinner,-64.58,20f09c10-3edd-4773-b9f6-e45f11290dff,-12249.31,debit,bank-fee,AU00000,2023-09-30T11:56:27Z
transaction,0206d4b0-e661-4841-b99f-e27630e6ad20,posted,Mobile Phone Bill Payment,-251.15,70162250-e6cb-4cd9-954a-4d0623920042,-12500.46,debit,bank-fee,AU00000,2024-04-23T15:04:57Z
transaction,88dc9d8a-bbdb-4245-af65-1b3cece2396f,posted,CTRLINK CARERS Ref: 998R6789201610974V,-1956.62,6836a21d-39cc-439a-bd3b-eb6973a7fb06,-14457.08,debit,bank-fee,AU00000,2024-02-07T15:52:00Z
transaction,15b9047d-9c3e-407b-a25d-e4e767048357,posted,TFR Acc14000 TO 12389,-3371.57,8d522b00-e463-4182-a721-57516f809222,9527.86,debit,bank-fee,AU00000,2024-01-10T09:02:53Z
transaction,40e75945-f48c-4cdd-bfcf-99df1307b7da,posted,Uber Ride,-1541.66,4ad7efd2-e953-4dfe-8d1e-4459279ab9e0,7986.2,debit,cash-withdrawal,AU00000,2023-11-06T23:34:16Z
transaction,bc3248a7-4b82-4884-a562-b376b9df0d08,posted,Uber Ride,-4683.34,3ab227d9-5c8f-4714-a2a8-9b5a3a158d32,3302.86,debit,payment,AU00000,2024-03-03T12:30:33Z
transaction,7847b8a9-e2f9-4b83-817d-de7c3c9541a5,posted,Coffee Shop Purchase,-1379.41,80b5d43a-be00-4749-b605-5d255cfdc42a,1923.45,debit,payment,AU00000,2024-02-01T13:26:44Z
transaction,096f56fe-f5c2-47fd-9ba4-a3ba734f73bb,posted,Home Improvement Store Purchase,-4640.41,719f0999-11eb-4cd8-b7a9-3a98d0d85bc7,-2716.96,debit,cash-withdrawal,AU00000,2024-05-05T14:13:11Z
transaction,90be09be-64b3-45fc-bf0e-53440912639f,posted,TRANSFER TO JOANNA SMITH CAMPING,-3832.41,1f2297a0-bed4-46b8-88f9-ee67309d0ebf,-6549.37,debit,cash-withdrawal,AU00000,2023-07-06T04:03:24Z
transaction,b5556791-ba1d-46de-b445-8ab72be8890c,posted,Gym Membership Fee,-3639.73,0aa88f0e-9a69-4418-93bb-8441bd0f8e98,-10189.1,debit,bank-fee,AU00000,2023-08-09T01:07:40Z
transaction,4966a274-069e-4d96-9f26-d0394d01adcf,posted,Uber Ride,-1148.38,71bba110-0540-45bf-8783-01a1126e630c,-11337.48,debit,cash-withdrawal,AU00000,2024-03-12T09:12:25Z
transaction,b2adf2d0-db53-4752-af83-3ccaaa984485,posted,Wdl ATM WESTPAC IGA BALGOWLAH BALGOWL AU,-1022.86,96560c5f-fe5c-408f-a11c-6f3d4e1a4bcb,-12360.34,debit,cash-withdrawal,AU00000,2024-03-02T18:12:41Z
transaction,ddb4a7bf-67cc-41cb-9b8e-3731a380f774,posted,Movie Ticket Purchase,-3220.7,b33eb0dd-b67e-4f50-9a17-a1f9218ce8dd,-15581.04,debit,payment,AU00000,2023-05-19T06:24:41Z
transaction,1a54d272-cc00-4b90-ac95-2ad48ffbe2f9,posted,Clothing Store Purchase,-4743.3,4c68e971-2d1f-4574-8891-10367ce50323,5242.81,debit,payment,AU00000,2023-07-13T02:22:15Z
transaction,abdeb19b-5b5f-4ca1-8880-8cba2cc1b38a,posted,TRANSFER TO JOANNA SMITH CAMPING,-604.42,4bd6fec6-fdb9-46a0-b910-4fdb4e09a11e,4638.39,debit,cash-withdrawal,AU00000,2023-05-14T02:06:35Z
transaction,a62fcc84-f5e1-4349-bab3-8d4e3c8b1579,posted,Hair Salon Appointment,-1395.53,bd8c6db3-345a-4249-8df6-c113968a7ef1,3242.86,debit,payment,AU00000,2023-07-05T19:37:23Z
transaction,0fb0f624-d448-4286-8e15-fa76a19433fc,posted,Home Improvement Store Purchase,-623.13,c8b8168f-2ade-4e15-b108-7f54a8f70115,2619.73,debit,payment,AU00000,2024-04-25T07:14:39Z
transaction,63f4b5bc-ed84-40bc-b9ce-3ce3337aa478,posted,Electricity Bill Payment,-4581.53,a95327ab-2b05-48dc-9de5-0d923d2a9ade,-1961.8,debit,payment,AU00000,2023-12-01T13:30:59Z
transaction,9229baec-d744-4f8e-9f0c-6b70d3749fa7,posted,TRANSFER TO JOANNA SMITH CAMPING,-1074.46,85115b6b-b85d-4487-964b-4958f3de58ce,-3036.26,debit,cash-withdrawal,AU00000,2023-12-19T20:07:36Z
transaction,2596a447-0f93-4b46-a17f-cdf74b5c4f7d,posted,Online Gaming Purchase,-2802.97,938186b4-662f-48cd-a8b5-ff0536dcb791,-5839.23,debit,bank-fee,AU00000,2023-08-29T11:55:06Z
transaction,8731701c-3c87-4bcf-abdd-dbe68067e603,posted,TRANSFER TO JOANNA SMITH CAMPING,-4213.08,4de2dbf8-fd42-41b5-8f29-d3d191b10c6d,-10052.31,debit,payment,AU00000,2023-12-17T15:48:44Z
transaction,e08d6d64-b39e-495b-88da-27283d0495c8,posted,Netflix Subscription,-886.74,b7537e63-e8dc-4526-954c-3c006634b544,-10939.05,debit,payment,AU00000,2023-06-11T19:13:53Z
transaction,4f02e66e-cc5b-4949-be76-f0027fc454f1,posted,Coffee Shop Purchase,-980.96,9b7992a8-a9a6-4234-99ab-d730fc6fd57d,-11920.01,debit,cash-withdrawal,AU00000,2024-02-26T17:56:04Z
transaction,944c8812-5ec3-49f5-9295-8dded4641950,posted,CTRLINK CARERS Ref: 998R6789201610974V,-57.17,8d3321c5-de0d-434f-be65-65a8e23af3cd,16321.41,debit,payment,AU00000,2023-10-25T23:52:51Z
transaction,516da189-d230-4b55-9ab0-417677dd1836,posted,Manly Maths Tutor Wages,-4406.11,d84e77e7-6bb2-4f91-a28d-b183ba2500e7,11915.3,debit,payment,AU00000,2024-04-03T20:00:12Z
transaction,3c058984-84df-4ee4-936c-12dc3edeebd8,posted,Non Hooli ATM Withdrawal Fee,-3320.88,6fdf2200-db25-4710-9d03-a16126b116bf,8594.42,debit,cash-withdrawal,AU00000,2024-01-06T11:32:17Z
transaction,fadf73a5-6419-4011-9313-d36b6bb75b40,posted,Transfer Platnm Homeloan 346454,-511.81,8a9347bc-c7b5-466a-b15f-afe0a2dbe53a,8082.61,debit,bank-fee,AU00000,2023-05-31T08:48:07Z
transaction,d9de1372-86b2-4d45-aa7b-e26702ee98ca,posted,TFR Acc14000 TO 12389,-814.9,686f9f21-d009-4bb6-98ec-6b2f17a46ca1,7267.71,debit,payment,AU00000,2024-04-14T09:35:23Z
transaction,c9948486-f58b-4655-ac3e-b49af118b03f,posted,Payroll WFRMS 15439393,11302.56,7130a20a-f9e7-49d3-a03e-37cb4e8f843f,18570.27,credit,transfer,AU00000,2023-11-22T02:13:51Z
transaction,b6a3a15c-8fa0-444d-af8f-28c3667f9770,posted,Netflix Subscription,-4002.93,6348ea63-4464-4659-81e1-545ecff5d569,14567.34,debit,payment,AU00000,2023-11-03T08:46:28Z
transaction,f298706b-9c7d-489e-99fb-7d883a8e8fc4,posted,Car Maintenance Expense,-4308.23,482ea566-778f-42fd-89bc-f1fcd62a648b,10259.11,debit,payment,AU00000,2023-09-19T23:39:49Z
transaction,76435757-525b-4e11-95eb-128d6475cba1,posted,Online Gaming Purchase,-227.21,04dd9774-a7e9-40f4-9263-853731f17a2e,10031.9,debit,bank-fee,AU00000,2023-08-22T02:46:30Z
transaction,b075c6b0-684a-446c-bce0-d86955121115,posted,Electricity Bill Payment,-3835.4,e8c80110-d5cd-4674-96b8-7a8228d93470,6196.5,debit,payment,AU00000,2023-07-10T20:44:29Z
transaction,2fa5bc1e-9751-4c23-b6e2-5003e5de99e9,posted,Transfer Platnm Homeloan 346454,-166.83,fb27570c-e755-44f5-b487-2437cb95af11,14858.25,debit,cash-withdrawal,AU00000,2023-10-24T20:03:31Z
transaction,393097cc-8a3a-4614-96f0-5c9052f08a66,posted,Amazon Online Shopping,-4868.56,a7e34c08-eafe-4bb1-ae94-a0436fa8a116,9989.69,debit,payment,AU00000,2023-10-22T03:53:03Z
transaction,a233af38-502e-4d01-878b-a202e721323e,posted,Hair Salon Appointment,-4142.21,2b8daf13-129d-4c39-bdc8-a9703042dc16,5847.48,debit,bank-fee,AU00000,2024-04-22T00:00:23Z
transaction,94e24895-df33-4ee4-ba00-c5b3a1f8b5c5,posted,Travel Agency Booking,-2383.32,1d92e61a-31fc-451a-bc72-abc6eca7f2da,3464.16,debit,bank-fee,AU00000,2024-04-17T14:16:47Z
transaction,c041aa77-a277-4d43-8040-faa53dc63475,posted,Pharmacy Purchase,-3563.46,450ba335-614d-468b-b293-aaec3c58fb27,-99.3,debit,cash-withdrawal,AU00000,2024-04-27T07:25:14Z
transaction,9d8ea8f7-837a-4724-b8bb-21f4c78cb3ea,posted,Restaurant Dinner,-345.52,0f08b3fa-e356-4c3a-9a1b-90c446bc8ae3,-444.82,debit,bank-fee,AU00000,2024-03-29T11:49:54Z
transaction,cd6dc80c-e897-492e-b832-5618923c0559,posted,Music Streaming Subscription,-4124.29,60023f4f-1e70-4872-98a9-9dce1048ae1c,-4569.11,debit,bank-fee,AU00000,2023-08-18T23:51:57Z
transaction,b780431b-0fe2-47fc-b630-f5bdcae6d683,posted,Clothing Store Purchase,-339.28,1e7589aa-808e-4e64-9fdc-ca8bfdc3ec40,-4908.39,debit,bank-fee,AU00000,2023-06-01T00:17:15Z
transaction,21af9825-444d-4565-8914-8d7a68accf8f,posted,Home Improvement Store Purchase,-1074.72,074243cb-0ba1-4e7f-a08d-0de9149e428a,-5983.11,debit,payment,AU00000,2023-10-23T19:01:36Z
transaction,17e19364-6be0-429d-a271-dc91bf91a4d6,posted,AGL RETAIL ENERGY LTD (GAS),-3348.36,6b4a7f69-f7c1-4af3-94d7-3049e642195e,-9331.47,debit,bank-fee,AU00000,2023-09-10T04:25:09Z
transaction,886f52c0-8cfa-4e6e-9319-eb2a3ae611fb,posted,Bookstore Purchase,-3741.25,043b5ad3-f239-4069-92b6-2bc723d42b47,11890.01,debit,payment,AU00000,2023-11-09T01:47:09Z
transaction,38d97b4f-160a-4325-a1e4-471aa98909e3,posted,Pharmacy Purchase,-1351.18,545251d5-9acb-4e76-a961-137656c0fb70,10538.83,debit,cash-withdrawal,AU00000,2023-08-19T08:44:34Z
transaction,e430a01f-db2b-4170-ba5c-711bb58466de,posted,Music Streaming Subscription,-1180.71,ad5f1741-7549-48bf-9d93-44851694f951,9358.12,debit,bank-fee,AU00000,2023-07-29T17:59:43Z
transaction,34675158-5349-439e-a95f-578a689329cf,posted,Amazon Online Shopping,-2119.94,c0b658d2-96c1-48f5-9d0e-a1be87eb1105,7238.18,debit,cash-withdrawal,AU00000,2023-11-18T02:08:38Z
transaction,09c94c77-57b2-454d-8037-d8384f2ed4a4,posted,Bookstore Purchase,-4389.39,74a4381f-a519-4772-8ed6-a20540324d14,2848.79,debit,payment,AU00000,2024-01-04T09:47:15Z
transaction,ac3eb3e9-c3b6-4228-a6a2-d79485b332b0,posted,CTRLINK CARERS Ref: 998R6789201610974V,-4031.08,74e033e3-ce34-4073-a35b-e86e5e4e6c69,-1182.29,debit,payment,AU00000,2023-11-30T22:03:24Z
transaction,1c320a7d-f353-41ef-ba0b-5880eadd0e0f,posted,Coffee Shop Purchase,-2537.77,ca156658-b818-4d58-8c8c-8204114f7aeb,-3720.06,debit,cash-withdrawal,AU00000,2023-06-09T06:46:41Z
transaction,04ee9e56-f784-4374-b822-f4879ce880fc,posted,Movie Ticket Purchase,-4921.59,d9381086-c85f-476c-ab50-2bcbc67391a8,-8641.65,debit,cash-withdrawal,AU00000,2023-08-26T17:00:39Z
transaction,de5f630f-d848-442f-8b22-2362214a8b0c,posted,Wdl ATM WESTPAC IGA BALGOWLAH BALGOWL AU,-1066.17,c37af369-9e10-4b04-8fe3-3066e709ca74,-9707.82,debit,cash-withdrawal,AU00000,2023-11-03T23:29:10Z
transaction,be908b46-5265-455a-a15a-4c677c235880,posted,Payroll WFRMS 15439393,10088.41,1404f39b-88ae-4980-97e4-a16a88f478ff,380.59,credit,transfer,AU00000,2023-12-05T14:34:31Z
transaction,214dd727-9311-4083-9fc5-51667e5e2a98,posted,AGL RETAIL ENERGY LTD (GAS),-172.64,c258b34e-7d94-4135-bc80-3ad465c707f2,11578.28,debit,bank-fee,AU00000,2024-03-09T04:23:27Z
transaction,569d27b4-6a9a-4e15-9492-3afa136a049d,posted,Wdl ATM WESTPAC IGA BALGOWLAH BALGOWL AU,-4514.99,0cd56ac0-0498-4d95-99d8-c8694671a0c5,7063.29,debit,payment,AU00000,2024-02-15T17:03:43Z
transaction,ec3c2b67-6e68-44db-8270-0de86305f0cf,posted,Restaurant Dinner,-1701.43,031aa24a-a450-4d6b-ab09-db7a8704144a,5361.86,debit,bank-fee,AU00000,2023-06-21T06:37:45Z
transaction,4e32c1f8-3caa-49a6-9326-fb6a1e994996,posted,Gasoline Purchase,-3781.5,28ab97da-7d05-4f9c-99b9-cfabdc79c43c,1580.36,debit,payment,AU00000,2023-05-13T06:51:43Z
transaction,d2d77131-0829-470a-80b9-765d2c86acdf,posted,Car Maintenance Expense,-554.69,e619fd40-02b4-4cbf-902d-d0fab73fa980,1025.67,debit,bank-fee,AU00000,2023-10-10T10:16:18Z
transaction,41910d0b-f067-4ee5-9ce1-51b57a7069a9,posted,Pharmacy Purchase,-4092.38,17621350-f099-48e0-938f-3c3075ca427a,-3066.71,debit,bank-fee,AU00000,2024-01-01T07:44:40Z
transaction,23158f9e-87d9-412e-abb2-f225a078d7a0,posted,Public Transport Fare,-1050.59,d1ba83a9-77e6-4921-96d6-8b1ebaea151e,-4117.3,debit,cash-withdrawal,AU00000,2023-12-11T18:02:59Z
transaction,9986c2c1-f087-4fb5-a5b5-fc487ce05159,posted,Hair Salon Appointment,-4563.37,dd7d209b-b29f-44fb-b00e-6713684f236b,-8680.67,debit,payment,AU00000,2023-12-18T14:09:52Z
transaction,21ee3896-dc10-4ce6-b654-7bfa7d5379ad,posted,Home Improvement Store Purchase,-68.49,1368a916-2294-4098-af00-9512946866ba,-8749.16,debit,cash-withdrawal,AU00000,2023-05-16T22:16:14Z
transaction,4bad8fa1-3408-45a9-b83d-44881e78e2d7,posted,Restaurant Dinner,-4962.53,5ed2eea7-918e-4c98-b218-96f5d6ab5ab1,-13711.69,debit,payment,AU00000,2023-08-03T18:33:27Z
transaction,a7f23f1f-a0ab-4aee-bec6-bd9b47083d13,posted,Coffee Shop Purchase,-2647.59,c48e82c4-c88f-4620-93b5-c8afccedd261,3561.75,debit,cash-withdrawal,AU00000,2024-02-19T19:11:55Z
transaction,40e29461-2d4a-48e6-9a9c-cb96ab6bf4c0,posted,Mobile Phone Bill Payment,-119.18,723902e3-20ba-4b73-8b41-3d36f122a416,3442.57,debit,payment,AU00000,2023-06-06T15:15:29Z
transaction,cabb589e-7990-4231-b8da-c7fa83883b56,posted,Electricity Bill Payment,-1665.13,fd5f1f9d-a27e-4d7d-b946-203385e84116,1777.44,debit,payment,AU00000,2024-05-02T09:00:54Z
transaction,b8aa5750-2793-4ac0-a483-5322957b44f7,posted,Netflix Subscription,-2675.34,7ec90bb2-75be-4ee7-abe9-005e7d942aff,-897.9,debit,cash-withdrawal,AU00000,2023-10-08T21:35:01Z
transaction,e1193a6f-d345-4144-a608-37720999f059,posted,Online Gaming Purchase,-2407.59,02619e59-89aa-4d65-b8f4-5a0a7b523601,-3305.49,debit,bank-fee,AU00000,2023-12-04T16:44:31Z
transaction,a1d8e54c-0f2f-4427-b110-f0c5805424a6,posted,TRANSFER TO JOANNA SMITH CAMPING,-4375.71,4b7b58ca-ebb7-427d-9c23-1c264ba19771,-7681.2,debit,bank-fee,AU00000,2023-12-04T05:22:18Z
transaction,ae4cd24a-fb3c-443a-ae52-b5d35654cc9e,posted,TRANSFER TO JOANNA SMITH CAMPING,-4894.66,eaddd857-6a9a-447f-94da-c70a04157738,-12575.86,debit,payment,AU00000,2023-05-29T00:22:40Z
transaction,12fb567c-ecda-4c7a-b94b-2d7e5a0adcf8,posted,Travel Agency Booking,-4403.47,fc81a058-7099-4fe6-9fdc-8b7a7506f263,-16979.33,debit,payment,AU00000,2023-08-03T17:05:25Z
transaction,a7b0a98d-1541-4ce5-9a86-466c43725d4c,posted,Pharmacy Purchase,-1046.97,54224597-84c7-44db-b12d-4f664aa598df,-18026.3,debit,payment,AU00000,2023-12-13T23:30:14Z
transaction,e862c2e4-e931-42fa-a495-af5286183f23,posted,AGL RETAIL ENERGY LTD (GAS),-952.15,e641a5c7-b0e5-4b0a-befc-5bb5ad030841,-18978.45,debit,cash-withdrawal,AU00000,2023-09-22T09:06:27Z
transaction,67cccb32-2a35-47b6-91d7-d4a290f31f8b,posted,Restaurant Dinner,-3269.25,6451d46c-31e2-46bd-9a08-ed0631179935,11363.41,debit,cash-withdrawal,AU00000,2023-08-02T06:39:44Z
transaction,f3600e3d-0e21-4adc-b88a-7e2946fa2cc7,posted,CTRLINK CARERS Ref: 998R6789201610974V,-1255.23,5c6f0b95-9860-46da-9f9c-ae3901b90849,10108.18,debit,payment,AU00000,2023-12-25T18:12:06Z
transaction,fbbdf9f6-409e-494e-a81a-419f73c935ae,posted,CTRLINK CARERS Ref: 998R6789201610974V,-4487.7,aca891e2-a59a-44f6-b69d-99be27e36837,5620.48,debit,payment,AU00000,2023-12-21T18:07:23Z
transaction,1fbd93bd-4843-44c9-86ea-347b7dd875f1,posted,Music Streaming Subscription,-332.85,9bfc58db-4c43-4a99-8fd3-1049fefad63c,5287.63,debit,cash-withdrawal,AU00000,2024-01-18T01:55:06Z
transaction,98074188-7b1f-4cb0-81d0-3bc9ffdc89b9,posted,TRANSFER TO JOANNA SMITH CAMPING,-2716.69,9694a6ce-4de3-4af8-b4f7-507cdc16115a,2570.94,debit,payment,AU00000,2023-10-23T13:25:57Z
transaction,7a6d3aa4-4566-41ce-8fb3-8ab24c0f81d0,posted,Wdl ATM WESTPAC IGA BALGOWLAH BALGOWL AU,-3004.04,7fa2e112-3a64-4559-9e39-a4fd4d0a35cf,-433.1,debit,cash-withdrawal,AU00000,2023-11-28T01:31:52Z
transaction,9cfd8106-ba02-4649-977b-b3a1ac79a4ac,posted,Transfer Platnm Homeloan 346454,-4018.34,33712240-a26f-4643-8ed1-00abd20efe72,-4451.44,debit,payment,AU00000,2023-05-23T06:22:56Z
transaction,b66715e3-cf3c-4057-8f51-abc11c3425ac,posted,Bookstore Purchase,-268.78,10745504-51b5-46f9-8d8f-9533882f02e1,-4720.22,debit,bank-fee,AU00000,2023-07-18T19:47:00Z
transaction,c4e2693d-e26e-4ac4-bbcf-bc93dc144f49,posted,Manly Maths Tutor Wages,-1673.62,2c57b0d2-aa12-433f-9020-c1a52146a4aa,-6393.84,debit,bank-fee,AU00000,2023-07-21T06:25:03Z
transaction,b31e7801-2d9d-4b36-863f-a6768b74ebf3,posted,Clothing Store Purchase,-2549.46,8b883cdd-b035-41f0-9885-f06939c60207,-8943.3,debit,bank-fee,AU00000,2024-02-27T13:45:27Z
transaction,eb768650-fd6c-4b93-83b9-c7e6372bb534,posted,Netflix Subscription,-2473.68,1fa4089d-3081-49a5-8004-257fea8d6b18,2660.0,debit,cash-withdrawal,AU00000,2023-08-09T09:23:43Z
transaction,0a7c7861-7a21-4e7f-8bef-0115c6085c31,posted,Car Maintenance Expense,-943.16,5a27ad07-a938-46b8-8338-c95b654d3ad4,1716.84,debit,bank-fee,AU00000,2023-06-30T00:51:28Z
transaction,e49178ea-e2c5-421c-8c3f-33a37bbfc32d,posted,TFR Acc14000 TO 12389,-2732.23,e5a5bd40-7521-4868-a9a1-da19f3613a7a,-1015.39,debit,bank-fee,AU00000,2024-04-06T07:16:05Z
transaction,24133447-0b87-4e2f-9faf-7e3c942f19e5,posted,Non Hooli ATM Withdrawal Fee,-535.0,50a7f4b3-df0c-42db-a400-11772201e4e6,-1550.39,debit,bank-fee,AU00000,2023-07-27T12:37:56Z
transaction,9b9e95c5-4804-473f-9585-a54bdba33f41,posted,Electricity Bill Payment,-2231.32,cb1e0fcc-bfa8-42f1-bc2f-e695fa429afc,-3781.71,debit,payment,AU00000,2024-01-21T19:11:51Z
transaction,72218f42-11c8-45a6-bad2-de39d2cbc95f,posted,CTRLINK CARERS Ref: 998R6789201610974V,-4782.51,07975bef-6c7c-40a1-a5d5-aa1b8daf3ee5,-8564.22,debit,payment,AU00000,2024-02-04T18:23:36Z
transaction,da706dc0-2502-4d7d-9f6f-7c960c9aa8cf,posted,Non Hooli ATM Withdrawal Fee,-879.45,82664f9c-1499-48da-8543-cd1cf4713894,-9443.67,debit,payment,AU00000,2023-06-05T08:06:21Z
transaction,f11d90c3-131d-4d2c-9bd3-50cdd38747a9,posted,Car Maintenance Expense,-3420.9,ff172cff-5b9e-4fd7-8db3-928129bb330c,-12864.57,debit,payment,AU00000,2024-05-07T01:32:06Z
transaction,14526053-a662-4784-82ce-150f941089c7,posted,Movie Ticket Purchase,-4247.7,a22d3393-7aeb-4bb5-a5ca-89beb2fc2edc,-17112.27,debit,payment,AU00000,2023-10-18T03:48:03Z
transaction,6c53c787-e41a-42c8-8a96-7ef7472be36d,posted,Uber Ride,-1789.94,25b01456-e814-4f66-b1f3-02c0eb22279f,-18902.21,debit,cash-withdrawal,AU00000,2024-01-18T15:44:33Z
transaction,5c9adcea-1d11-48c5-b5d2-03c8a2c46f98,posted,Netflix Subscription,-2325.44,8cc15e53-0f78-4df7-8b21-6de3d7865b35,6649.94,debit,cash-withdrawal,AU00000,2024-01-20T19:53:23Z
transaction,7fe7983e-dc37-431d-9ea5-2d051b3e443c,posted,Bookstore Purchase,-362.56,6a0d2e8b-6b48-45f9-8275-dae460b6da23,6287.38,debit,cash-withdrawal,AU00000,2023-10-07T18:05:24Z
transaction,7969d8c3-2281-4429-86ca-72ab661c36df,posted,Uber Ride,-1242.82,500865b7-9c11-4f80-91f6-07446f3e937e,5044.56,debit,cash-withdrawal,AU00000,2023-08-13T03:46:49Z
transaction,5dde9404-830b-4fea-8fdb-cea48776f9ce,posted,Mobile Phone Bill Payment,-1066.07,ebd92c2f-778a-429f-8bff-c3871c585fbc,3978.49,debit,bank-fee,AU00000,2024-05-08T22:29:24Z
transaction,00cd97ad-98f6-4e59-a4c3-0a1e0281e4f8,posted,Bookstore Purchase,-1788.68,db341546-7d13-4365-b25f-4c763be638a4,2189.81,debit,bank-fee,AU00000,2023-10-09T13:03:59Z
transaction,95e92036-6439-4d30-aabe-3fd9cad0fee4,posted,Netflix Subscription,-4961.61,bc46aba8-b7fa-41fe-be86-7dc17d1c6ddb,-2771.8,debit,bank-fee,AU00000,2023-06-04T01:03:00Z
transaction,455c2011-ebc7-4501-8643-802f5ff93ac6,posted,AGL RETAIL ENERGY LTD (GAS),-3264.67,884a3f03-82f7-431d-862a-ab103db969f6,-6036.47,debit,bank-fee,AU00000,2024-01-03T20:36:03Z
transaction,ac4dc306-2468-4a49-90c9-604acdaa4bc5,posted,Restaurant Dinner,-4512.46,585d9039-ab78-4168-942c-39395b42f6a2,-10548.93,debit,cash-withdrawal,AU00000,2023-10-13T22:32:15Z
transaction,09230e67-c1d6-4b09-9e7e-bd27e048fc7a,posted,Amazon Online Shopping,-782.88,f0f51408-0744-4606-b7a2-deee4330bde5,-11331.81,debit,cash-withdrawal,AU00000,2024-01-31T22:38:27Z
transaction,b6d7fdab-0f7d-4c8a-b693-406db3b5a07a,posted,TRANSFER TO JOANNA SMITH CAMPING,-383.81,80c3024e-b272-4bc4-80d4-df13be6e8263,-11715.62,debit,payment,AU00000,2023-06-15T04:35:51Z
transaction,fe5b0a66-2c2e-4396-97de-a7364b9a14c9,posted,Netflix Subscription,-3173.93,7b7b93ff-fdc8-441d-8751-609cb87a1166,3296.92,debit,cash-withdrawal,AU00000,2023-12-17T22:14:52Z
transaction,c710158a-c0de-4732-ab6b-55e9433b2a38,posted,Coffee Shop Purchase,-1170.55,e1b5868b-aad7-461d-8841-d29e6278e8b1,2126.37,debit,cash-withdrawal,AU00000,2023-06-15T16:54:32Z
transaction,91581819-d811-4b86-9008-f893a8323361,posted,Movie Ticket Purchase,-4449.58,f0475524-2663-4893-b9a7-479908b25b46,-2323.21,debit,payment,AU00000,2023-10-24T05:41:31Z
transaction,e7bb8034-3f65-47c7-bd12-24e648c08afd,posted,Car Maintenance Expense,-3193.49,15c0659f-824d-4509-ac55-e3e9e5ded494,-5516.7,debit,payment,AU00000,2024-01-31T05:31:10Z
transaction,4ec84de1-6d37-4b06-bb9d-b96e545ac4a2,posted,Manly Maths Tutor Wages,-204.11,9be6ee18-5421-464a-8a5a-8e7d68df4563,-5720.81,debit,cash-withdrawal,AU00000,2024-05-02T16:30:02Z
transaction,89112e41-b4af-4295-b0bf-e6057b52ce85,posted,Wdl ATM WESTPAC IGA BALGOWLAH BALGOWL AU,-2277.67,cb44a307-7eba-45c8-bbc4-4a4b3e23046a,-7998.48,debit,bank-fee,AU00000,2024-05-04T08:33:40Z
transaction,af3622e6-18d2-4332-96b5-5d22d1a84cd2,posted,Amazon Online Shopping,-2467.62,c8473915-cb29-404c-b3f9-0ae8bd82b302,-10466.1,debit,payment,AU00000,2023-11-11T08:58:45Z
transaction,bab51f14-5a4f-4134-8e3e-2041549f8aa6,posted,Hair Salon Appointment,-1927.57,1775493e-c464-4ea0-8565-01a5dfe97f35,-12393.67,debit,bank-fee,AU00000,2023-12-27T10:30:28Z
transaction,62a28408-d097-426f-b6fa-6af354ae2fcc,posted,Online Gaming Purchase,-1924.72,f8205a68-ec1f-48e2-bee7-4784f9234411,-14318.39,debit,bank-fee,AU00000,2024-03-15T00:09:03Z
transaction,67d7039d-9346-49d0-91c3-13ccced140a5,posted,Amazon Online Shopping,-194.73,895df4c6-2a6b-4f04-a90e-dcdf643cde55,-14513.12,debit,cash-withdrawal,AU00000,2024-01-30T01:29:55Z
transaction,e3193b29-a31b-4d0a-9104-278741743c92,posted,Non Hooli ATM Withdrawal Fee,-891.18,f9c012d8-f955-4219-a522-ad18cc976e06,11671.44,debit,cash-withdrawal,AU00000,2024-04-28T14:13:00Z
transaction,3c323a0c-da41-4818-a067-a083f9a04e06,posted,Gasoline Purchase,-4776.21,19edbc89-69ad-4f6c-a148-8cd1697596b6,6895.23,debit,cash-withdrawal,AU00000,2023-12-10T11:29:44Z
transaction,59adf7e7-7e3f-4ec9-9049-2907b926ba50,posted,Transfer Platnm Homeloan 346454,-1713.79,e71f91fb-74b9-4e53-9114-65f67695caaf,5181.44,debit,cash-withdrawal,AU00000,2024-04-22T12:06:22Z
transaction,da600060-387a-463e-92a2-9153e4d5da3f,posted,AGL RETAIL ENERGY LTD (GAS),-1743.98,378040f7-9396-4db2-bc98-a34a5d268453,3437.46,debit,bank-fee,AU00000,2023-10-28T13:07:40Z
transaction,b9518230-11ae-4f4a-ace6-1f4bcc11fc9d,posted,Music Streaming Subscription,-1740.56,dcc98514-f001-4372-b5c7-2f1489704749,1696.9,debit,cash-withdrawal,AU00000,2024-01-26T06:42:36Z
transaction,7109adb6-829c-4c69-97e8-541473cb55b9,posted,Manly Maths Tutor Wages,-3988.72,7a4377e6-162c-4082-aeba-7b9698ef30cf,-2291.82,debit,payment,AU00000,2024-05-02T04:30:20Z
transaction,85b04fd0-316d-4857-af7f-3aec0f9aa245,posted,Home Improvement Store Purchase,-2400.74,8e848ced-b410-428b-aa90-ca60489d6357,-4692.56,debit,bank-fee,AU00000,2023-06-13T16:09:09Z
transaction,0e2a60bd-e53a-403c-a3dc-3ecb6970f5e0,posted,TRANSFER TO JOANNA SMITH CAMPING,-2304.39,8922565c-17d5-4aa2-a913-579808dc5fe7,-6996.95,debit,payment,AU00000,2024-04-27T06:52:54Z
transaction,28f41e3a-33f2-4391-8c79-5b2fb421798b,posted,Electricity Bill Payment,-4446.33,4705818e-9861-4d22-9e2a-52937fdf539c,-11443.28,debit,cash-withdrawal,AU00000,2023-05-27T19:08:27Z
transaction,73a6c4b2-1f98-435f-bfa9-a62d0a782b6c,posted,Car Maintenance Expense,-3876.77,06326a03-1ed9-49ee-9fbc-deb323429f03,-15320.05,debit,bank-fee,AU00000,2023-11-03T03:23:06Z
transaction,68c37cc1-5777-4927-b152-604808380eba,posted,Transfer Platnm Homeloan 346454,-4438.45,37028a0c-e477-4559-bb34-c012b1750f79,1227.77,debit,payment,AU00000,2024-01-01T13:58:15Z
transaction,cd059158-d0ac-47b8-939e-4a10ac3cd5c2,posted,Bookstore Purchase,-3541.58,b0840569-4349-468f-bd1e-368ff4902e1c,-2313.81,debit,payment,AU00000,2024-01-09T03:47:12Z
transaction,6a8953ba-bd33-4f1c-9189-3ccc60e7b2ff,posted,Clothing Store Purchase,-1289.89,0e7e6a52-2581-4833-ad68-63d2b93ea5f3,-3603.7,debit,payment,AU00000,2024-01-09T16:16:10Z
transaction,b445ed6b-a32c-4441-9351-e96e3972e95e,posted,Public Transport Fare,-2432.46,a4828801-0038-4747-9919-a13f4ebad18f,-6036.16,debit,bank-fee,AU00000,2023-06-22T09:05:50Z
transaction,fc49e38c-b950-4a81-b2e7-06e893eda39a,posted,Wdl ATM WESTPAC IGA BALGOWLAH BALGOWL AU,-4456.85,b46a3917-c808-41a2-a82d-ee94cd0e7b66,-10493.01,debit,payment,AU00000,2023-09-24T01:52:58Z
transaction,28029be6-9d10-42d4-91c9-b9075ae7d233,posted,Manly Maths Tutor Wages,-1002.01,c7d79caa-7195-4bba-b7cc-8ffc1cecf51c,-11495.02,debit,bank-fee,AU00000,2024-03-04T02:22:28Z
transaction,ccb94d5e-2858-4885-89fc-7906423a415b,posted,Non Hooli ATM Withdrawal Fee,-3006.71,b9ba0683-e888-45e1-beb8-b565496a00c1,-14501.73,debit,cash-withdrawal,AU00000,2024-02-12T07:00:46Z
transaction,6a6ff684-8f4f-4b5c-bcda-0bdf08c187f3,posted,TRANSFER TO JOANNA SMITH CAMPING,-3122.69,4dcf1b22-caad-4414-9ac1-6e95b1ef23f8,-17624.42,debit,bank-fee,AU00000,2023-11-18T10:26:27Z
transaction,e7f9684c-fff7-446d-a04f-05676f9a787d,posted,Movie Ticket Purchase,-3983.22,17c90f44-3524-40d9-9adf-69c93abb800f,-21607.64,debit,payment,AU00000,2023-06-05T08:28:26Z
transaction,806649ec-3af5-4ec9-9180-6801fb6fb564,posted,Car Maintenance Expense,-1583.78,82754335-a3db-47f7-983a-005f30de9e10,-23191.42,debit,payment,AU00000,2024-03-22T21:48:13Z
transaction,260e34a3-3aac-4a54-8dda-9c3c6f19f5ce,posted,TRANSFER TO JOANNA SMITH CAMPING,-1343.78,051b07e2-e039-49ba-9ac5-a19047f4e31f,4462.3,debit,bank-fee,AU00000,2024-01-04T10:13:13Z
transaction,6be067b8-5a1d-423a-b32e-a907c283bd2c,posted,CTRLINK CARERS Ref: 998R6789201610974V,-2940.6,8687350c-a9cb-4824-b1e1-4fb5afe99b1e,1521.7,debit,bank-fee,AU00000,2023-09-15T09:58:20Z
transaction,1d3abcc4-c6a5-4c47-bf3b-9ba85e9a99e8,posted,Home Improvement Store Purchase,-4567.03,ef55e9cf-4bb8-4d8a-aa5b-413cbeb20bc7,-3045.33,debit,cash-withdrawal,AU00000,2024-01-21T01:34:27Z
transaction,3c41147b-c68a-4c48-babf-fbc82a4dbd3f,posted,Hair Salon Appointment,-2084.13,8b1b0f11-89dd-4672-9022-fd55a21c6628,-5129.46,debit,bank-fee,AU00000,2024-01-21T15:52:25Z
transaction,b52009f3-291f-491d-bb3f-1086b01f5521,posted,Non Hooli ATM Withdrawal Fee,-3872.6,0d959dc9-0058-4cc2-9559-93b00615b267,-9002.06,debit,cash-withdrawal,AU00000,2023-05-16T23:39:10Z
transaction,cd6f1075-472e-44f3-9f89-1bd7340ac1ee,posted,Non Hooli ATM Withdrawal Fee,-3260.3,6d348d6d-dbc6-425a-9058-ef8ed236bdee,-12262.36,debit,payment,AU00000,2023-08-27T17:25:58Z
transaction,05fd7526-6933-48fe-ae2c-cddbcd22eb16,posted,Mobile Phone Bill Payment,-3217.94,292fb12d-c3d9-4189-a98f-3120863b2d7b,-15480.3,debit,payment,AU00000,2024-01-25T04:00:40Z
transaction,18e37a8c-6bb2-43de-9f99-5d1d5dff504e,posted,Restaurant Dinner,-501.77,2e944097-8c49-42f4-bdfb-ed67c3df1ec8,-15982.07,debit,bank-fee,AU00000,2023-08-21T17:36:51Z
transaction,b334a28f-bbfc-4b47-94c5-2dc71c734558,posted,Movie Ticket Purchase,-3515.09,71c912b1-5b12-4a66-92fe-bf994cf718eb,-19497.16,debit,payment,AU00000,2023-05-12T12:46:19Z
transaction,e95d4f6f-f8d4-4bda-af87-54529f21c224,posted,Restaurant Dinner,-483.09,2dcfbbe0-ebfa-47e8-91b4-29682bedf307,-19980.25,debit,bank-fee,AU00000,2023-06-29T16:12:09Z
transaction,c455ae48-0c3a-4dd7-b0de-76652235785e,posted,TRANSFER TO JOANNA SMITH CAMPING,-2317.37,c7b35338-4b2a-4ef8-bba8-183ffe77d68a,16799.22,debit,cash-withdrawal,AU00000,2023-06-18T12:02:18Z
transaction,ccece09c-41bd-4be9-96e2-90347a47d44c,posted,AGL RETAIL ENERGY LTD (GAS),-662.19,185d36fc-426b-48c1-b03f-d28196fa9334,16137.03,debit,payment,AU00000,2023-09-29T20:14:15Z
transaction,86a27269-8fc5-4340-a9d3-f13a5912afd4,posted,Payroll WFRMS 15439393,11002.11,3450e0a7-e607-4f9a-bddb-375e372b4093,27139.14,credit,transfer,AU00000,2023-06-24T11:36:53Z
transaction,bfc0a005-61fd-4ba5-a60f-e48af13f0427,posted,Manly Maths Tutor Wages,-3588.28,a514a025-c857-482f-9efb-a3e73246781d,23550.86,debit,payment,AU00000,2023-12-18T05:27:11Z
transaction,2013150d-4f51-473a-9472-c00a6bc79e17,posted,Music Streaming Subscription,-138.18,96f862c9-0718-4163-aba1-a3c24d29f32d,23412.68,debit,cash-withdrawal,AU00000,2024-03-01T10:48:03Z
transaction,bb12042c-b33e-4e18-bbb8-9b4b4d0cfce0,posted,Mobile Phone Bill Payment,-1958.98,18407696-bf43-49cd-996e-10802e36c540,21453.7,debit,payment,AU00000,2023-07-10T03:31:26Z
transaction,fcb57760-33d4-4737-b3a9-799ed0757dda,posted,Gasoline Purchase,-4522.12,5c82f360-c6bd-4a9d-a34f-2a7d504ce61b,16931.58,debit,payment,AU00000,2023-08-30T20:37:36Z
transaction,301d6194-1fa1-44d6-8ca9-272cb866a749,posted,Manly Maths Tutor Wages,-2571.18,f88c9c24-6442-4f10-a31a-cbb8a0dd31be,14360.4,debit,cash-withdrawal,AU00000,2024-04-03T02:32:19Z
transaction,9757136d-5831-4113-9e22-c66d84a4577b,posted,Public Transport Fare,-1285.49,df701c81-43d9-4ebe-bbe2-7b3377bb2d3e,13074.91,debit,cash-withdrawal,AU00000,2024-04-22T19:06:53Z
transaction,a4ee8f2c-fc89-4a45-84e5-5e5704d2debb,posted,Amazon Online Shopping,-2100.5,e6b25af8-bbcb-4269-b331-902c6e070e83,10974.41,debit,payment,AU00000,2024-02-26T09:13:43Z
transaction,9b4409e5-c203-42e7-bd56-5f6f8ccd1c90,posted,Public Transport Fare,-2305.2,25e1dedd-af2e-435d-9f3a-f3fba1867ba7,3241.26,debit,payment,AU00000,2023-07-26T20:26:04Z
transaction,228f4520-7c09-4d13-987c-55ef1ccb4ae1,posted,Netflix Subscription,-3950.09,3152a62c-8424-475b-9800-ba24809f9825,-708.83,debit,payment,AU00000,2024-04-29T01:33:55Z
transaction,a555703d-bd0f-41bc-9d82-8646f45223a9,posted,Public Transport Fare,-2031.66,ecaa78d1-b76f-422a-b162-fa225446dbf7,-2740.49,debit,payment,AU00000,2023-12-06T19:45:53Z
transaction,10235f53-bfc9-4ba0-ade2-5452e81f2c92,posted,Gasoline Purchase,-4624.0,f10339b2-4012-4d64-a332-7d72feaad593,-7364.49,debit,payment,AU00000,2023-07-05T23:49:59Z
transaction,8849071d-dc6f-4b6b-b2e3-f33c763541d5,posted,Travel Agency Booking,-386.85,96a9fbce-2509-4f56-b0f1-7399a9e64eec,-7751.34,debit,bank-fee,AU00000,2024-02-02T08:34:03Z
transaction,de1162bc-9f0d-41c5-916c-3ae53d70c7f9,posted,Non Hooli ATM Withdrawal Fee,-3189.33,fdd28c8c-46ef-4b2d-a042-5205e683aff4,-10940.67,debit,cash-withdrawal,AU00000,2024-01-12T18:36:59Z
transaction,a2fa784a-7b0c-4efe-9baa-7546e1682e73,posted,TFR Acc14000 TO 12389,-452.33,1992d866-8741-47de-af07-8994f1254080,-11393.0,debit,payment,AU00000,2023-07-26T20:30:18Z
transaction,545d2a4d-b945-46d7-b324-6c2641590f11,posted,Pharmacy Purchase,-2945.5,a93bed4c-f528-45ea-9ccf-199014bd0860,-14338.5,debit,bank-fee,AU00000,2023-11-07T02:49:49Z
transaction,d3c9f302-0dbd-40c7-b7d8-4c7911fd0e71,posted,Bookstore Purchase,-4424.98,92b1a3d2-7b7e-4f3c-b9c8-8a593847bffb,-18763.48,debit,payment,AU00000,2023-08-10T01:38:50Z
transaction,a3b50e17-22cb-4ec5-8837-3fb61dc7a9bc,posted,Clothing Store Purchase,-4401.04,b79054c4-b4b1-419a-9016-4225863d1456,-23164.52,debit,cash-withdrawal,AU00000,2023-05-21T22:57:02Z
transaction,b40543bf-633b-4706-8c6e-c1052bccf441,posted,Mobile Phone Bill Payment,-1816.44,d7050a9c-41d6-42c1-b094-7f25edda1a1b,17329.34,debit,bank-fee,AU00000,2023-06-29T00:07:53Z
transaction,22cce910-8a1c-4133-b5f1-f3747f0d2f31,posted,Coffee Shop Purchase,-1194.1,ef17fda5-2b23-4d1c-a8fb-f89d165427b6,16135.24,debit,cash-withdrawal,AU00000,2024-03-15T22:56:29Z
transaction,42faa2a8-3290-4863-91b9-46c040ab6e14,posted,Online Gaming Purchase,-7.05,3532eedf-2239-40c7-a07a-dd934cb04de4,16128.19,debit,payment,AU00000,2024-03-16T07:16:40Z
transaction,0646d77c-7be7-486b-a0d2-0cdc6126a9ef,posted,Movie Ticket Purchase,-4130.4,27a20ac9-3411-4b75-bb2e-b2cc78fc3ab8,11997.79,debit,payment,AU00000,2023-08-31T11:41:34Z
transaction,05744dd6-d257-438a-9a94-2551a0c7a255,posted,Gym Membership Fee,-4417.23,dfaf6213-862b-42fe-8921-25f9d8fafce0,7580.56,debit,cash-withdrawal,AU00000,2024-02-19T01:18:59Z
transaction,b786095d-f19a-4502-ab82-1b4b70ffdf24,posted,Clothing Store Purchase,-2188.23,9b3265ff-64d7-40a9-86f3-d1acba32d4d4,5392.33,debit,bank-fee,AU00000,2023-10-01T21:13:14Z
transaction,7e7cd7cd-c6f6-4b0f-914e-3a464a508192,posted,Hair Salon Appointment,-525.05,b2c38dd7-19ea-42d0-a71c-b478fe55d56a,4867.28,debit,payment,AU00000,2024-02-08T00:32:04Z
transaction,0d437701-27a9-446b-b88a-754ba6d3416e,posted,Movie Ticket Purchase,-2333.39,1a94fcce-18bb-4ff9-aab0-a861debe4cff,2533.89,debit,payment,AU00000,2024-04-11T07:13:01Z
transaction,dfcd5c62-a521-4746-9311-6ecc03864076,posted,Mobile Phone Bill Payment,-78.79,278b7ec6-aedb-4a44-af80-cd6efd6ec2b9,2455.1,debit,payment,AU00000,2024-04-29T04:06:54Z
transaction,c5456456-d6b6-4f18-b9fd-b04a04101ccf,posted,Music Streaming Subscription,-2547.24,17d48a09-5976-44c8-bbec-3371d35b0f43,-92.14,debit,payment,AU00000,2023-09-08T20:32:09Z
transaction,63f0e3c7-9ad9-442b-b3f6-3009a0dcaeae,posted,AGL RETAIL ENERGY LTD (GAS),-4958.9,6ec57502-6062-4246-9fe4-c9ee59c402d3,3589.45,debit,cash-withdrawal,AU00000,2023-12-26T05:11:24Z
transaction,6e3cef5b-1afd-4c88-b2d9-410337bb06d8,posted,Mobile Phone Bill Payment,-3868.9,31359ad0-4a09-482b-b785-e37baff91050,-279.45,debit,bank-fee,AU00000,2023-05-24T08:14:35Z
transaction,4c1a9951-1981-462c-9a8b-6af20490e283,posted,Pharmacy Purchase,-4225.46,b278c3f6-397b-4e68-a190-9093093a5912,-4504.91,debit,cash-withdrawal,AU00000,2024-04-14T04:48:28Z
transaction,347f3a4f-42c7-48bf-ac54-64b68fe83d41,posted,Clothing Store Purchase,-2392.72,d84339ac-efa4-43e4-962b-a29c3f64a5e1,-6897.63,debit,cash-withdrawal,AU00000,2023-09-16T22:59:29Z
transaction,9b198626-ad8a-45b7-8181-35560ccb0346,posted,Hair Salon Appointment,-1002.42,3324b9e6-7922-4118-beba-05bc9a9ab26c,-7900.05,debit,payment,AU00000,2023-12-22T22:36:09Z
transaction,b8c7a490-6675-4b18-bef2-70c02e82422f,posted,Transfer Platnm Homeloan 346454,-533.94,eea7c057-43c7-40d4-b29c-3365a9f6cfb5,-8433.99,debit,cash-withdrawal,AU00000,2024-04-08T03:41:17Z
transaction,980078b6-35cb-425a-af24-cafd6b5d6373,posted,Payroll WFRMS 15439393,11837.14,fca94a78-104a-47c0-b84e-067564b2c8f5,3403.15,credit,transfer,AU00000,2023-10-15T03:54:03Z
transaction,b35e8b07-f5ee-416c-97fd-a743441735c0,posted,Transfer Platnm Homeloan 346454,-2903.96,4249d3a2-8311-4833-b485-fa78732d24c0,499.19,debit,bank-fee,AU00000,2023-09-24T02:11:59Z
transaction,4ce94d59-2dcf-47b0-99fc-ece2a2832275,posted,Amazon Online Shopping,-2807.51,7c0190b7-57e5-4f5e-8fa8-3ddb41789a4f,-2308.32,debit,bank-fee,AU00000,2023-08-06T21:22:59Z
transaction,1b621ca5-d238-4199-8b39-17c1f8920485,posted,Mobile Phone Bill Payment,-1569.53,2472b84d-8806-4d53-aba3-6de8a978c7f2,-3877.85,debit,cash-withdrawal,AU00000,2023-10-20T08:21:39Z
transaction,9d531c25-545c-4e56-9764-29497392ce24,posted,Public Transport Fare,-2241.57,9de21b00-e767-44fa-b3fb-311c00c78f3a,15401.3,debit,payment,AU00000,2023-11-24T14:35:13Z
transaction,5422b424-8963-4ccc-995f-5357301249c4,posted,Travel Agency Booking,-3749.41,707a0606-29be-40e3-b031-41504d41d7c7,11651.89,debit,bank-fee,AU00000,2023-06-14T07:49:43Z
transaction,95f61340-1045-4389-b5fa-8d12dfc1b2f1,posted,Electricity Bill Payment,-143.27,e511f476-581b-4b34-ac17-008f0f52ab78,11508.62,debit,cash-withdrawal,AU00000,2023-05-28T23:53:56Z
transaction,495d74ff-6863-4aa4-bd28-eb4de7f9d43b,posted,CTRLINK CARERS Ref: 998R6789201610974V,-890.18,9cc25375-a2bc-4bc5-8a98-7f246e9e59d7,10618.44,debit,cash-withdrawal,AU00000,2024-05-02T19:39:23Z
transaction,a2021a36-18a9-47c0-bfd6-0bd202e0c4b8,posted,Mobile Phone Bill Payment,-1448.22,ce623e5d-a79a-4cdd-ba35-1838506681fe,9170.22,debit,payment,AU00000,2023-06-14T17:31:30Z
transaction,d52015eb-54ea-47fc-81c2-1d6ba735b9e8,posted,Hair Salon Appointment,-4799.33,7eab467a-8a34-44ae-a975-87c58ec12d4d,4370.89,debit,payment,AU00000,2023-10-01T17:09:29Z
transaction,6179f459-920e-4bcc-a4c2-6f8e01165dc9,posted,Pharmacy Purchase,-997.42,3c9838b6-6f98-444d-87af-666e09d81af5,3373.47,debit,cash-withdrawal,AU00000,2024-04-04T08:04:52Z
transaction,0aed7a27-15ea-4366-bd1f-ab8bd8c66d51,posted,Movie Ticket Purchase,-351.42,9b7a99b5-3aa6-494b-aebf-e1f11893ba3b,3022.05,debit,bank-fee,AU00000,2023-11-11T04:37:30Z
transaction,a76ca9ff-bf4f-47fa-92fb-5f1c91cd8ef0,posted,Clothing Store Purchase,-3946.05,2f324608-b553-471c-a0d9-9545a7b2a687,-924.0,debit,cash-withdrawal,AU00000,2024-01-03T11:26:07Z
transaction,31a30458-721a-41c9-a6ea-691d9ad5bb6f,posted,Home Improvement Store Purchase,-541.08,0d5801c2-addc-4f5c-b1f1-0dbd77248bdd,-1465.08,debit,cash-withdrawal,AU00000,2023-09-06T14:19:19Z
transaction,fce39515-792c-45df-b91b-ac1d069418bd,posted,Hair Salon Appointment,-3868.04,b2526425-6bf2-45b1-a7ce-e96f781d5c70,13217.27,debit,payment,AU00000,2023-10-14T15:50:19Z
transaction,b43a6176-2fe0-40e1-8885-49d474924195,posted,Gym Membership Fee,-3969.07,caaf7b74-05cd-45e8-87a3-75dd59de671b,9248.2,debit,cash-withdrawal,AU00000,2023-06-29T22:56:17Z
transaction,754f79f3-4fce-4b3f-b305-03c144e33c43,posted,Clothing Store Purchase,-2976.69,a6b61186-52fb-4e90-a3fb-e64791e3d108,6271.51,debit,cash-withdrawal,AU00000,2023-12-28T10:14:53Z
transaction,6d590ac8-a535-4ff0-ab03-0e3ae439a1e7,posted,AGL RETAIL ENERGY LTD (GAS),-2879.98,99d2166e-307c-47db-934f-4876a4f208e3,3391.53,debit,payment,AU00000,2023-11-02T22:58:26Z
transaction,917f1d11-fedc-413e-949a-07ccb1bf8a00,posted,Netflix Subscription,-1221.14,e8d52a2f-68e1-4e83-8317-2ed0e6fbade8,2170.39,debit,payment,AU00000,2024-01-29T16:46:00Z
transaction,33863336-3e74-43aa-9d2b-023d049afb19,posted,TFR Acc14000 TO 12389,-2885.34,84c5c9b4-6de8-49b6-aeaa-4f0150457884,-714.95,debit,bank-fee,AU00000,2023-11-03T02:33:55Z
transaction,b0a4e174-aa3f-46b5-884c-2ebc4f4fd07c,posted,Travel Agency Booking,-4887.45,46962564-0256-4015-a34f-230fc590fabe,-5602.4,debit,cash-withdrawal,AU00000,2023-10-23T05:30:53Z
transaction,727cd8b3-88c0-4938-9192-cbf9cc197f68,posted,Coffee Shop Purchase,-4101.14,5fbe05d0-649d-44e9-9e3c-c9df4497ada0,-9703.54,debit,payment,AU00000,2024-04-16T14:15:52Z
transaction,08a64ab8-e9a6-4582-b56c-92bf670bea25,posted,Amazon Online Shopping,-135.81,62bca8fc-f484-4d1b-91ad-9ed3ae68a696,-9839.35,debit,cash-withdrawal,AU00000,2023-10-28T12:15:45Z
transaction,54a57b1f-2022-4c11-b45e-eddb895775bd,posted,Payroll WFRMS 15439393,11011.23,3b7de535-668b-4e3f-8a58-af8e7ec01498,1171.88,credit,transfer,AU00000,2023-10-04T10:20:25Z
transaction,6305738c-1c32-49de-af4b-97bb07d253e4,posted,Music Streaming Subscription,-1071.83,3f899eef-ee2c-4e77-8139-eae0a3186a20,15856.58,debit,payment,AU00000,2023-07-19T00:56:06Z
transaction,c6bdd508-a1e4-4175-8be7-8cd16d9fc4fe,posted,Non Hooli ATM Withdrawal Fee,-3594.5,53f1c1c1-fde3-4662-9612-ce898c7da467,12262.08,debit,cash-withdrawal,AU00000,2024-02-29T05:16:24Z
transaction,a498d46c-f8b0-434a-9ed5-9c363b585fe3,posted,Car Maintenance Expense,-1539.22,6692c81e-305a-4db5-b2f5-2215b8d63642,10722.86,debit,bank-fee,AU00000,2023-12-01T06:58:47Z
transaction,381906c5-f69b-4199-81f3-608979518d91,posted,Hair Salon Appointment,-4598.64,7809a26f-d60c-4449-899e-961e5adaa177,6124.22,debit,payment,AU00000,2023-05-28T23:58:59Z
transaction,0ac04fe3-a5ff-4b08-96b9-28ac76f52bca,posted,Bookstore Purchase,-187.05,9ca49786-adce-4b59-8fbf-136c5a033486,5937.17,debit,payment,AU00000,2024-01-12T00:25:32Z
transaction,eedc258f-c853-4cc9-a353-0d1c97fca374,posted,TFR Acc14000 TO 12389,-2292.17,e39d3975-31da-4e8c-b606-34c15b42e24c,3645.0,debit,bank-fee,AU00000,2023-07-10T03:00:17Z
transaction,08b14cf7-8366-43c7-adbd-037cb558948a,posted,AGL RETAIL ENERGY LTD (GAS),-4258.88,0017e655-2df6-4252-af44-eb3be15b44ba,-613.88,debit,cash-withdrawal,AU00000,2024-02-18T18:47:54Z
transaction,bcf3a9f6-e124-4812-a9af-8884d200a894,posted,Car Maintenance Expense,-4036.48,a2afcc03-8833-431e-ab3f-a0cf8f2e25c9,-4650.36,debit,payment,AU00000,2023-06-05T19:17:12Z
transaction,431f448a-70ce-4945-812b-e29492e59b85,posted,Clothing Store Purchase,-2884.45,2bbfad31-e082-4a6a-b14d-7508698c69c7,-7534.81,debit,bank-fee,AU00000,2023-07-18T19:05:01Z
transaction,3e512b83-f152-4421-a734-2c7e023555de,posted,Wdl ATM WESTPAC IGA BALGOWLAH BALGOWL AU,-541.71,dd286bb5-df46-4d3b-ac5e-8efeba17bef7,-8076.52,debit,bank-fee,AU00000,2023-09-12T03:13:51Z
transaction,76f0942f-04d5-4627-bd26-4d30fc0b437c,posted,Electricity Bill Payment,-2359.59,417a7619-a912-4916-a38e-82e199b62fb5,10816.41,debit,cash-withdrawal,AU00000,2024-01-02T16:38:19Z
transaction,2a1437fd-547c-4a65-a620-362239fb62e3,posted,Wdl ATM WESTPAC IGA BALGOWLAH BALGOWL AU,-1696.47,506f38b5-5b9d-4088-b594-861ad7a1b5b1,9119.94,debit,cash-withdrawal,AU00000,2023-06-27T10:08:04Z
transaction,4591b003-1da1-4b29-b281-cc6c5d790c13,posted,CTRLINK CARERS Ref: 998R6789201610974V,-3447.46,b27213ea-945e-441f-a69d-1ced6439a27d,5672.48,debit,payment,AU00000,2023-11-05T01:07:21Z
transaction,67be608b-4af3-431b-9a33-4c2e4d5dab25,posted,Manly Maths Tutor Wages,-210.42,c971e13c-fe53-4474-aaf7-391ca7e9b2b0,5462.06,debit,bank-fee,AU00000,2023-11-25T05:08:39Z
transaction,e5175ef6-2f13-4e43-965a-4a6a8c35a5d9,posted,Uber Ride,-3946.48,355ad646-8c96-42dd-bd5a-0daffc215cff,1515.58,debit,payment,AU00000,2024-04-30T23:23:30Z
transaction,820b9669-56f3-472e-984e-a79ba4eee6b6,posted,Music Streaming Subscription,-4349.81,fb28cf97-557d-457d-9532-337ceeb35261,-2834.23,debit,bank-fee,AU00000,2023-05-22T23:17:37Z
transaction,c2ffcd98-e890-42d8-8687-d69d139528f2,posted,Mobile Phone Bill Payment,-3390.1,b6a48057-1d30-4fa6-a874-611ec0500ed9,-6224.33,debit,bank-fee,AU00000,2023-11-07T15:47:34Z
transaction,5dc6404b-a080-4bf7-b901-aea7313a88c3,posted,Hair Salon Appointment,-901.1,e28044a4-bed0-43c9-9963-d671d0924078,-7125.43,debit,cash-withdrawal,AU00000,2023-08-03T20:00:32Z
transaction,667a82d0-ae13-4ca1-b033-298282f9e4b1,posted,AGL RETAIL ENERGY LTD (GAS),-3290.22,fd2adeab-38e9-47e2-bde8-d65b20cbacad,-10415.65,debit,cash-withdrawal,AU00000,2023-11-04T23:04:34Z
transaction,b88efc67-7771-4386-ad21-9ee5d025ac92,posted,Gym Membership Fee,-2633.28,4cf70844-7efe-4925-85b8-469378ba22dd,-13048.93,debit,cash-withdrawal,AU00000,2023-12-30T03:11:18Z
transaction,d05ea06f-97e7-4b42-af61-c4b330315428,posted,Non Hooli ATM Withdrawal Fee,-4549.25,9d1fa355-a276-4707-a5b2-fb108d2f030a,10702.76,debit,bank-fee,AU00000,2023-12-28T17:50:45Z
transaction,afa25982-ce16-4619-8c1e-c02caa2cbde1,posted,Clothing Store Purchase,-57.63,3679e861-0906-42de-b174-8fc3f3212eb0,10645.13,debit,bank-fee,AU00000,2023-10-03T05:27:31Z
transaction,efcaa9f3-37cf-4a9b-aaf9-e83a577f32f9,posted,Music Streaming Subscription,-3701.21,e7d95226-4b3c-465d-85d1-6981bd95d931,6943.92,debit,bank-fee,AU00000,2023-12-05T13:22:41Z
transaction,891b465a-95ad-4a26-a577-eab32be76361,posted,Electricity Bill Payment,-1141.62,781630ad-14b8-4f70-8669-0c1365b0a408,5802.3,debit,bank-fee,AU00000,2024-03-22T00:11:15Z
transaction,ecf619f6-1447-4414-a643-86fbe8796dee,posted,Transfer Platnm Homeloan 346454,-3202.28,e0e1eaeb-eec3-4e0b-9945-28d951be5fbf,2600.02,debit,payment,AU00000,2023-10-09T03:41:04Z
transaction,aacb449c-f154-48ee-8a3e-18478e96242f,posted,TFR Acc14000 TO 12389,-4126.47,4a0791d4-e742-41dc-b89d-c1677b15f565,-1526.45,debit,cash-withdrawal,AU00000,2024-02-08T07:53:57Z
transaction,2f31b177-3c76-460b-a0b8-c025341c2b30,posted,Transfer Platnm Homeloan 346454,-3984.25,35e91cf2-b775-4b8c-98bc-ed7d61194344,-5510.7,debit,payment,AU00000,2023-11-21T14:23:52Z
transaction,2b0236a8-355a-420d-92ad-1f7e125684f1,posted,Clothing Store Purchase,-4898.32,6cceaa51-db25-4a36-b453-027bab3087fa,-10409.02,debit,cash-withdrawal,AU00000,2024-02-09T04:27:18Z
transaction,8f595ea3-1ab2-46e4-93a9-18a080638dfe,posted,Manly Maths Tutor Wages,-4403.99,01382283-8388-4f83-949c-78ef712420aa,-14813.01,debit,bank-fee,AU00000,2023-08-17T20:06:20Z
transaction,d22e3d8b-f032-40ab-be56-526dee80669c,posted,AGL RETAIL ENERGY LTD (GAS),-1899.96,77796384-841d-4e02-bfd7-55424216e751,-16712.97,debit,bank-fee,AU00000,2024-03-28T23:58:11Z
transaction,e1071635-8a0d-4e75-8867-4064cae59f5e,posted,Payroll WFRMS 15439393,11696.66,72f154d4-1c77-4cf5-b43c-aea06242218f,24103.52,credit,transfer,AU00000,2024-05-07T01:25:20Z
transaction,027eb4b4-cef3-44de-98bb-f01a440a025c,posted,Wdl ATM WESTPAC IGA BALGOWLAH BALGOWL AU,-2687.86,1628fad0-bab1-4bdc-b4aa-7915efe75a2b,21415.66,debit,cash-withdrawal,AU00000,2023-08-22T16:50:12Z
transaction,279b204b-76da-4bdc-bd4d-5bf2ea331713,posted,Non Hooli ATM Withdrawal Fee,-2521.94,a112d6ea-82ee-48bf-92fc-f5a7ae1fd142,18893.72,debit,payment,AU00000,2024-03-02T14:32:40Z
transaction,ef8365b7-865c-426e-98e2-17564679d750,posted,Online Gaming Purchase,-3375.33,7d9ea43f-9585-4473-8a8a-cc514aaf41db,15518.39,debit,payment,AU00000,2024-04-25T06:46:01Z
transaction,b34f9b77-79b9-461b-9f06-03aafa976995,posted,TRANSFER TO JOANNA SMITH CAMPING,-266.72,a81d77d1-19a4-4693-8cd6-1e9f2fa7476d,15251.67,debit,cash-withdrawal,AU00000,2024-02-03T02:08:29Z
transaction,8d68d386-bc4c-4850-89ea-35dcaa1fe92e,posted,Netflix Subscription,-3656.1,8022d1da-b4c6-4fcb-a377-e95dcfcb8cc9,11595.57,debit,bank-fee,AU00000,2023-06-14T07:48:23Z
transaction,dde581c8-0ff9-4659-80b8-91c73a425ecb,posted,Transfer Platnm Homeloan 346454,-193.42,cf396c90-7c03-47d9-87a0-64727498a48a,11402.15,debit,payment,AU00000,2023-05-20T01:07:49Z
transaction,b59cab7d-9ed2-4e4e-a62b-70bae10faf51,posted,TRANSFER TO JOANNA SMITH CAMPING,-3900.89,88d464d3-a6c7-41f5-918b-f02dbc783ac2,7501.26,debit,bank-fee,AU00000,2024-01-02T17:53:31Z
transaction,7d740a29-1306-424d-ba94-3f68bdf04580,posted,Uber Ride,-219.49,4b6dc0b0-5079-4491-9fcf-eee0a7c4b24d,7281.77,debit,bank-fee,AU00000,2024-03-30T03:38:55Z
transaction,80ddec14-dbaa-4ebc-a1a7-31d5b30f8496,posted,Bookstore Purchase,-1767.3,3130264a-bea2-44b4-8ff1-07b9fecb1b20,5514.47,debit,cash-withdrawal,AU00000,2023-11-06T06:09:38Z
transaction,fe1438c3-86f9-4509-8e0b-e7a8cb8dc221,posted,Music Streaming Subscription,-4460.98,918c1511-bcdf-419c-a5ee-135b671d0a49,7617.63,debit,cash-withdrawal,AU00000,2023-11-20T13:52:50Z
transaction,17d5ce67-0d46-46c1-aaf8-05d21f020006,posted,Online Gaming Purchase,-35.17,36c27bdd-e1da-4078-bbd7-c35a7d7a387c,7582.46,debit,bank-fee,AU00000,2024-03-18T12:31:25Z
transaction,fbcda3c9-2c9c-419e-b389-7d53ada5f73d,posted,CTRLINK CARERS Ref: 998R6789201610974V,-3570.67,513d9223-7ccb-47e3-8eb3-16463e89b451,4011.79,debit,bank-fee,AU00000,2024-03-05T07:37:18Z
transaction,f3e0c707-b83a-41af-bfc4-35fb9da1b0c0,posted,Pharmacy Purchase,-4480.31,502141d4-7c80-41c0-b589-ce8714f86e0d,-468.52,debit,payment,AU00000,2023-06-29T15:41:25Z
transaction,f3500435-8f69-4b53-a884-eb389c083a7a,posted,Pharmacy Purchase,-1219.21,9501c2ac-e309-4fcb-9c8a-eee814856180,-1687.73,debit,bank-fee,AU00000,2023-11-12T03:36:36Z
transaction,59bb570a-171b-4380-ba83-6e18376b19fd,posted,Coffee Shop Purchase,-304.13,c893fd8b-33cf-4555-91be-2b4ee4ba45f1,-1991.86,debit,payment,AU00000,2023-11-30T19:36:24Z
transaction,6463e4e4-c34d-4bf5-9cc4-5827fd6877a2,posted,Gym Membership Fee,-4335.72,23634dab-8556-46d4-8f0a-08f66f420ed3,-6327.58,debit,bank-fee,AU00000,2023-11-23T11:15:56Z
transaction,8e275576-83ff-4fc5-8556-d1ae327b3e7f,posted,Travel Agency Booking,-2049.97,79d16e0b-14b5-4469-96e3-658365380368,-8377.55,debit,cash-withdrawal,AU00000,2024-02-15T17:52:32Z
transaction,ff319632-891a-4e03-9e81-8a337adc18db,posted,Travel Agency Booking,-966.46,06f8376a-3033-4f13-95fe-65afa60c0d23,-9344.01,debit,bank-fee,AU00000,2024-03-31T19:54:07Z
transaction,3459c773-987c-475d-85cb-69c527699f65,posted,Netflix Subscription,-2187.68,5f59e90c-66f6-40d7-b4c0-3a34f1bb0702,-11531.69,debit,cash-withdrawal,AU00000,2023-10-04T23:06:34Z
transaction,01d56281-8003-497c-9908-36179527b2f5,posted,Manly Maths Tutor Wages,-1401.45,e79b6eb8-1430-463b-afc6-1f97b4aa36f6,15062.78,debit,payment,AU00000,2024-01-24T21:41:08Z
transaction,e05633f8-aaa3-4319-8a2b-a951642f1025,posted,Netflix Subscription,-4721.62,31aa65e2-429d-472b-b679-c33853ba7aa9,10341.16,debit,cash-withdrawal,AU00000,2023-08-01T01:01:08Z
transaction,5db7f006-6e9b-4bc1-8ac0-3786c97c13cc,posted,Bookstore Purchase,-3994.14,57334cd7-c152-43f2-9ec0-079a06ecf870,6347.02,debit,cash-withdrawal,AU00000,2023-08-10T09:16:17Z
transaction,200062c6-97f3-4ee8-a403-37e0633b5896,posted,Manly Maths Tutor Wages,-2967.29,73194b3d-5d7e-4ecd-9853-f25613fbdf18,3379.73,debit,payment,AU00000,2023-10-09T14:54:22Z
transaction,a76a5860-1629-45eb-aa74-b1f590ab274c,posted,Pharmacy Purchase,-2334.44,c91f07bc-e6e7-4390-9391-16dbcbfaf860,1045.29,debit,bank-fee,AU00000,2023-12-21T01:09:12Z
transaction,7719b98f-ac06-4316-a22a-cdb0c188a820,posted,Gym Membership Fee,-4734.21,445ef8f2-ae3c-4117-9790-3185eaed257d,-3688.92,debit,cash-withdrawal,AU00000,2023-08-13T06:59:18Z
transaction,d0408e99-76b7-4d8d-99c0-3555baf5862d,posted,Netflix Subscription,-200.56,4ddd302e-0edd-4ff5-9d37-b0df9bed4b44,-3889.48,debit,bank-fee,AU00000,2023-10-14T05:13:20Z
transaction,e6982070-1a35-4e02-9166-c070b6026aa0,posted,CTRLINK CARERS Ref: 998R6789201610974V,-2413.88,80f3b7db-1d55-415f-9861-23a651084f1d,-6303.36,debit,bank-fee,AU00000,2023-06-02T22:06:49Z
transaction,987c1952-6476-42dc-a021-f137a038b2e6,posted,Non Hooli ATM Withdrawal Fee,-415.18,1148befc-b2e7-4631-9a30-0193ba27225d,-6718.54,debit,payment,AU00000,2023-09-15T06:16:20Z
transaction,a39c4e3f-8de1-4c36-821e-e3e136c32069,posted,TFR Acc14000 TO 12389,-2679.44,08034073-bff8-4d49-86ba-69e00c563af0,-9397.98,debit,bank-fee,AU00000,2023-08-20T09:55:37Z
transaction,be3e6c20-9a23-48bd-b19f-9ac5ac0136b7,posted,AGL RETAIL ENERGY LTD (GAS),-683.04,0a61dfe6-b78a-4fa4-8d10-2fe0a8cdbd79,10061.62,debit,payment,AU00000,2023-12-21T20:05:24Z
transaction,2b4ace68-6f1b-47ef-9fe5-ae60ae4da8b0,posted,Amazon Online Shopping,-1071.36,d7412768-d233-4a0b-96a3-8312df222055,8990.26,debit,cash-withdrawal,AU00000,2024-02-25T04:08:05Z
transaction,3e97a663-ff41-42c9-b018-34d3cd3e4de1,posted,Online Gaming Purchase,-2650.22,673a5be4-25a2-4a64-810b-d6483cbeb4ef,6340.04,debit,bank-fee,AU00000,2023-08-05T14:22:16Z
transaction,510f9510-0636-4c4c-905b-bb657d90e5d3,posted,Clothing Store Purchase,-4377.06,e75a4a82-c9b6-4bef-ac5e-1e092a5ed454,1962.98,debit,bank-fee,AU00000,2023-10-24T04:58:36Z
transaction,58401314-afa7-4645-96a7-ee6a58d780ea,posted,Bookstore Purchase,-1532.64,6a41df77-5c93-4d58-ad9a-5dd07060b66a,430.34,debit,payment,AU00000,2023-07-25T14:45:33Z
transaction,493ddc47-a6c6-4ebe-9fdf-be51b3a1c12a,posted,Electricity Bill Payment,-133.58,d0fa94ae-86c1-4b89-ae99-be1587d2811e,296.76,debit,cash-withdrawal,AU00000,2023-06-03T19:26:53Z
transaction,fc0f6528-1af7-4bd9-9323-b6b77eedb666,posted,Clothing Store Purchase,-4774.39,64368b45-1659-4513-8bfb-60e4768a8b3f,-4477.63,debit,cash-withdrawal,AU00000,2023-06-03T20:46:12Z
transaction,1b12d81e-0ece-4958-81ca-02e3c2fe8f21,posted,Netflix Subscription,-2588.11,b5e861cc-5f17-4b9d-a5a6-a3b9295dc2be,-7065.74,debit,bank-fee,AU00000,2024-03-08T17:21:36Z
transaction,484fe00d-1696-4663-a288-4d920f8fb265,posted,Travel Agency Booking,-737.43,d536918b-21bd-4340-a352-91a53ae2bb3b,-7803.17,debit,cash-withdrawal,AU00000,2024-05-10T08:15:12Z
transaction,a07b3852-db54-40d1-9ac9-f56a6f5b5790,posted,Bookstore Purchase,-1511.03,a7854c8d-e0bc-4870-b9b9-96505cddb8b4,-9314.2,debit,payment,AU00000,2024-04-10T23:41:27Z
transaction,10ea7a81-46f6-44a9-8a42-b12f5ea5aaf6,posted,Payroll WFRMS 15439393,11204.96,982b2a9a-afde-44b6-8d45-a20f5895b4ed,22863.57,credit,transfer,AU00000,2024-01-27T13:40:49Z
transaction,2bf30f5b-1a7b-4dda-b4f5-0660a3737b19,posted,TRANSFER TO JOANNA SMITH CAMPING,-4882.85,73504e9f-8e49-4463-847e-852ecad4c55a,17980.72,debit,cash-withdrawal,AU00000,2024-03-25T16:08:19Z
transaction,0cb20989-dd55-4724-acd0-1b75edce0180,posted,Manly Maths Tutor Wages,-102.32,345f2f0d-4cd1-46ac-8ae1-271d56ae5efe,17878.4,debit,bank-fee,AU00000,2023-09-13T03:00:38Z
transaction,0c27efba-ed76-4549-a25b-522e6da3f8ce,posted,TFR Acc14000 TO 12389,-3878.57,11e640b8-6331-4bae-8520-fc3e372c3993,13999.83,debit,payment,AU00000,2024-03-19T19:36:53Z
transaction,7d64ec45-0c97-4021-8c86-64660dfe1664,posted,CTRLINK CARERS Ref: 998R6789201610974V,-3485.74,bac10e2e-4404-4667-93ca-ff19a71dd1e7,10514.09,debit,payment,AU00000,2023-06-27T11:58:03Z
transaction,1c63421e-a474-4c9e-a398-d27ca365ac12,posted,Car Maintenance Expense,-4429.05,d908796c-e83f-461d-8b95-7ac3b0ff9e3e,6085.04,debit,cash-withdrawal,AU00000,2023-08-21T22:21:55Z
transaction,50e7af09-6c32-4d59-b21e-01bf1aca696d,posted,Clothing Store Purchase,-2389.04,aaf596a6-7a79-4f87-8b58-971c0f7226f8,3696.0,debit,payment,AU00000,2023-08-26T21:55:38Z
transaction,bc331a3b-025f-423b-8613-0fe71a5b0e85,posted,Music Streaming Subscription,-3021.92,7e5cb0c9-6b04-40f8-955b-09af39edc75a,674.08,debit,bank-fee,AU00000,2023-09-18T02:54:43Z
transaction,0b8c71c0-2e15-4d97-ab0c-ad4c692cc3d4,posted,Wdl ATM WESTPAC IGA BALGOWLAH BALGOWL AU,-321.59,adf95438-e9c9-46b5-af36-5962f4701be9,352.49,debit,cash-withdrawal,AU00000,2023-08-03T04:37:58Z
transaction,d3d18200-2ec2-425f-a948-c03d26330701,posted,Uber Ride,-1154.81,f1014a19-9516-4a70-9962-5115b31ebe7a,-802.32,debit,payment,AU00000,2024-03-04T03:13:09Z
transaction,2ea0d0a9-8191-4c06-a6dc-2606041c348a,posted,Restaurant Dinner,-3363.75,c51aa608-c46c-420a-bc59-64195feafc2a,5474.79,debit,bank-fee,AU00000,2024-02-10T07:56:06Z
transaction,b79000f3-b4c6-4618-82bd-c4b62df69142,posted,Public Transport Fare,-1167.48,c57bf7a0-5617-4822-a271-aebaeec4763d,4307.31,debit,cash-withdrawal,AU00000,2023-09-04T17:50:25Z
transaction,3821d9bb-dfba-4b2f-bcf1-68c507cf70fc,posted,Netflix Subscription,-4086.85,0c21940e-15dc-414f-85c3-bb410d9d7afa,220.46,debit,payment,AU00000,2024-01-15T13:21:56Z
transaction,200cb62a-a253-4367-a2b7-501c47f1edae,posted,Coffee Shop Purchase,-1998.19,d4c47ad0-1114-4790-8552-9bfa117510bb,-1777.73,debit,payment,AU00000,2023-05-27T09:42:43Z
transaction,f7368689-bde1-4f2e-a5a2-15f01b302333,posted,Travel Agency Booking,-2628.87,00e05d74-4c24-4aba-8cdf-7862522acdd6,-4406.6,debit,bank-fee,AU00000,2023-09-01T07:30:49Z
transaction,21fe99b5-5a8d-40da-ac46-624766187455,posted,Mobile Phone Bill Payment,-952.67,72271405-3285-4704-8127-20343a3c13c7,-5359.27,debit,bank-fee,AU00000,2023-05-14T05:01:03Z
transaction,d379d4e1-d070-4a4d-afc5-80fcb2d0feb9,posted,Travel Agency Booking,-3292.47,286e0cd8-fbb7-46f7-a981-04e0266458a9,-8651.74,debit,bank-fee,AU00000,2023-06-21T19:07:23Z
transaction,86b8a63d-5ee1-4f0e-9ed4-67c9596b65f8,posted,CTRLINK CARERS Ref: 998R6789201610974V,-4618.33,fb03a07e-cda2-4799-837d-6d1230805d14,-13270.07,debit,payment,AU00000,2023-12-27T14:43:11Z
transaction,14720617-b95e-46cc-a642-ec81a8854e2e,posted,Gasoline Purchase,-1394.63,bd90b257-980f-45e8-84ae-b6102425bd07,-14664.7,debit,bank-fee,AU00000,2024-03-26T18:34:45Z
transaction,980707f9-1714-4abd-ab87-183bcfeeef1d,posted,Travel Agency Booking,-213.86,b09bb35c-845a-4efd-a564-5e17a19098a0,-14878.56,debit,bank-fee,AU00000,2023-10-21T07:04:11Z
transaction,acabcdd7-f224-47be-9ab1-5c6daacb0560,posted,Manly Maths Tutor Wages,-173.81,49f917a2-748f-41b0-b330-080aaf39529e,10668.49,debit,payment,AU00000,2023-12-21T23:19:28Z
transaction,2bea1e7c-2979-4fe5-80a2-a79f4b57f227,posted,Wdl ATM WESTPAC IGA BALGOWLAH BALGOWL AU,-1017.46,bff9f8de-6f48-4964-b8fe-896bdfa52601,9651.03,debit,payment,AU00000,2024-02-17T01:10:51Z
transaction,e5ebd890-67b0-4573-8b7a-ceca2840561b,posted,Payroll WFRMS 15439393,11354.76,ebb8fb49-1423-4da8-b0a5-7babf70eb328,21005.79,credit,transfer,AU00000,2023-10-12T22:37:33Z
transaction,edf5e146-e8e5-4411-9e87-7e1bbefb62e2,posted,Uber Ride,-3314.16,4af8f7e0-85f9-48ed-8bf9-6d04ce79e741,17691.63,debit,bank-fee,AU00000,2023-06-26T22:32:02Z
transaction,18795aa1-14d2-4e0a-b2ec-5e952c0867aa,posted,Transfer Platnm Homeloan 346454,-4352.99,ee88add4-3c05-4c42-8ccc-b9284eec3ba2,13338.64,debit,bank-fee,AU00000,2023-07-22T09:25:57Z
transaction,039bfd71-01c7-491d-8837-eaae9902e13c,posted,Restaurant Dinner,-1819.84,dfc3d59d-8f45-4175-ab84-cffccfe1f4aa,11518.8,debit,bank-fee,AU00000,2024-02-05T22:30:01Z
transaction,f66a822a-e049-4dfa-8ed2-0bc7e4857ee2,posted,Coffee Shop Purchase,-2448.12,cb11ed83-3299-4a78-8d4a-b5fb392b3f8b,9070.68,debit,payment,AU00000,2023-12-26T11:40:47Z
transaction,fa4f3d94-8b54-4985-8053-f11534896693,posted,TRANSFER TO JOANNA SMITH CAMPING,-2019.04,937e6a2b-e16d-415f-bede-2b42d856c83f,7051.64,debit,payment,AU00000,2024-03-10T16:42:40Z
transaction,0db83237-08c8-4b4d-a22e-b98108bd585d,posted,Manly Maths Tutor Wages,-1201.25,e3b4f976-57ec-4362-829b-4a1a02f50408,5850.39,debit,payment,AU00000,2024-01-10T15:02:27Z
transaction,b36035c9-bd88-4451-b271-542d47ada395,posted,Gasoline Purchase,-2624.2,c433c202-3df3-47b3-b3de-abd2a50d3f8b,3226.19,debit,bank-fee,AU00000,2024-02-09T17:53:38Z
transaction,2fff8b6e-72f7-42c3-b614-0a4f3a9dcd7c,posted,Coffee Shop Purchase,-4175.21,cff339ba-3baa-497b-a955-182bd84e36f3,6557.61,debit,payment,AU00000,2023-07-18T14:50:14Z
transaction,ba216138-8b73-4d7a-a986-97107d188604,posted,Mobile Phone Bill Payment,-813.49,ed28f021-105d-4f30-a4ea-1a39ebbeaf0e,5744.12,debit,payment,AU00000,2023-09-15T04:24:44Z
transaction,350c5d76-d8e0-45c6-ab90-5974394dfe9c,posted,AGL RETAIL ENERGY LTD (GAS),-4754.37,0ad81a99-51a6-4e11-a5c2-6be6e3e750e6,989.75,debit,cash-withdrawal,AU00000,2023-12-12T10:43:19Z
transaction,a2958e7e-c4ec-4fec-ace4-e9cf41efb2b7,posted,Movie Ticket Purchase,-4286.93,95100ab9-df85-430d-ba63-10dae036a164,-3297.18,debit,bank-fee,AU00000,2023-10-08T15:08:16Z
transaction,c4a5ada9-d025-4cc2-a5b7-300ef41d9d2f,posted,Hair Salon Appointment,-4351.99,7b188a39-eb0d-414d-868d-14edcd53ffa9,-7649.17,debit,bank-fee,AU00000,2023-11-06T11:06:13Z
transaction,d90f086d-4a9e-480e-b331-71af86fafd4c,posted,Uber Ride,-3084.36,27717535-27b1-4994-8889-c30bf5db2a04,-10733.53,debit,cash-withdrawal,AU00000,2024-01-02T20:19:36Z
transaction,95aa6ade-40e6-4c08-b379-b1b0578b4363,posted,Home Improvement Store Purchase,-3112.73,67bc63f7-8439-4b62-ae01-2c6ab1381f2a,-13846.26,debit,payment,AU00000,2023-11-15T17:55:39Z
transaction,a8fc8d4e-ac2f-41af-a9ee-344b8acbbb0e,posted,Wdl ATM WESTPAC IGA BALGOWLAH BALGOWL AU,-4840.75,b7298dd3-ba3b-4d77-bd7d-eaa66e474c4a,-18687.01,debit,bank-fee,AU00000,2023-11-10T05:25:17Z
transaction,0d808f34-3091-43b4-a5e8-ee69e0269386,posted,Hair Salon Appointment,-4787.28,841bb2a4-6929-4694-b7a0-0908973879f1,-23474.29,debit,cash-withdrawal,AU00000,2023-12-26T03:24:03Z
transaction,4b8f6237-8cee-45dd-b2b7-707ea82d114a,posted,Car Maintenance Expense,-3045.23,97295700-3757-45bc-8589-7ebc190fa31d,-26519.52,debit,bank-fee,AU00000,2023-05-17T09:50:13Z
transaction,ae00118c-8b23-4f65-8a83-126682d6408d,posted,Public Transport Fare,-4982.42,99672e7c-15d2-4c7f-8184-512236dff950,11874.16,debit,payment,AU00000,2024-04-28T17:35:47Z
transaction,3b2dc42c-3c7f-475a-aee1-ea44e07b68bc,posted,Amazon Online Shopping,-4949.44,087ea09d-cbc9-4b09-9e24-71fa4517fd04,6924.72,debit,cash-withdrawal,AU00000,2023-08-23T11:49:45Z
transaction,5fe78f53-1e59-4dbb-bda8-898c93eae90d,posted,Restaurant Dinner,-230.26,7a8e3184-a1bb-4c9a-afb3-448a5ead828e,6694.46,debit,bank-fee,AU00000,2024-01-04T20:50:15Z
transaction,fabdc1b5-9591-4902-9a92-b5d436b7a595,posted,Car Maintenance Expense,-4862.5,732a8b57-c9ac-49fb-95ea-f9078de4fc43,1831.96,debit,payment,AU00000,2023-12-16T17:03:45Z
transaction,77b08ba2-0eb1-49f4-85bd-dc92fdc1a903,posted,Mobile Phone Bill Payment,-2777.56,692d8d8f-5522-4198-b747-4a1773a3e4e0,-945.6,debit,bank-fee,AU00000,2024-05-10T22:14:07Z
transaction,66bf13fa-6357-4a0b-9e1d-172cdbe08c0e,posted,Mobile Phone Bill Payment,-511.6,e45dbfe8-1622-4e87-a5d0-1966d38e5b9d,-1457.2,debit,bank-fee,AU00000,2024-04-24T14:14:52Z
transaction,1b01adfa-38ca-4330-98f7-bdc3566454f0,posted,Coffee Shop Purchase,-4349.77,361f5a6f-0481-49d7-85f0-bfee0744962c,-5806.97,debit,bank-fee,AU00000,2024-05-04T01:30:28Z
transaction,b6d5b842-fcab-4d07-9c91-285f16fbf4fd,posted,Restaurant Dinner,-1151.5,06700963-49a1-4676-992b-cf54ab25a17e,-6958.47,debit,bank-fee,AU00000,2023-12-12T09:58:07Z
transaction,6b5db25a-b815-4062-9266-ac8d590fdd18,posted,Restaurant Dinner,-4683.18,d23286f5-6172-488c-8bbe-42fa6042dfba,-11641.65,debit,bank-fee,AU00000,2023-07-11T16:21:48Z
transaction,65f98ba5-e8b0-4152-a80e-bb24c566d090,posted,Wdl ATM WESTPAC IGA BALGOWLAH BALGOWL AU,-3104.24,80c96e6a-152b-46d9-952b-59da4188ba4d,-14745.89,debit,bank-fee,AU00000,2024-02-20T05:37:29Z
transaction,5f0db294-f6f2-4540-a770-d6d92bb1c004,posted,Hair Salon Appointment,-3189.83,f26f6ec0-aae3-4c39-977b-0a76f551624e,7840.2,debit,bank-fee,AU00000,2023-08-10T13:23:11Z
transaction,427bdc49-510a-4fca-a8f0-1fc87c1f54d1,posted,Electricity Bill Payment,-3093.91,0e0cdd61-8bfc-47b7-9ceb-9f288067fc2f,4746.29,debit,bank-fee,AU00000,2024-05-04T09:43:46Z
transaction,bf6c3a01-041c-4339-827a-2f651cb18198,posted,Clothing Store Purchase,-250.87,ebc87157-402e-46c1-b9a8-14a508c2b8a8,4495.42,debit,bank-fee,AU00000,2023-07-14T18:55:42Z
transaction,db507c95-dac2-4e5f-90ab-70c7e6ca324e,posted,Electricity Bill Payment,-3509.81,24825600-c411-4f64-91e6-b56d13d863c9,985.61,debit,bank-fee,AU00000,2024-04-06T15:39:50Z
transaction,b9d2ee59-b804-4608-8b3d-9bf027cd4e22,posted,Bookstore Purchase,-990.83,8765da3d-a8d1-4a67-a5f4-e62c22c51158,-5.22,debit,payment,AU00000,2023-06-06T08:23:26Z
transaction,7b4696c3-5f9d-4601-8f45-2bf4e915ba5c,posted,Restaurant Dinner,-3340.79,ab2e7930-1a86-4121-a41f-f75a37fc3134,-3346.01,debit,payment,AU00000,2023-08-05T12:01:21Z
transaction,435cbe42-c5a2-4153-b7cf-538d414088f8,posted,Manly Maths Tutor Wages,-4013.68,fbf55b00-5eaf-43f5-826c-e621b970e3c9,-7359.69,debit,payment,AU00000,2023-09-27T05:27:56Z
transaction,757e3a57-8746-4aa6-9465-9d46b40e4700,posted,Gasoline Purchase,-308.68,1e2f8b60-e5dd-402b-890d-1d1ff3dc2249,-7668.37,debit,bank-fee,AU00000,2023-07-31T01:06:03Z
transaction,4ccf7eb7-4622-4677-84d2-3337749211d8,posted,TRANSFER TO JOANNA SMITH CAMPING,-3691.37,6cd28fe7-3b0d-4986-8b1a-8a974f152fef,-11359.74,debit,payment,AU00000,2023-08-25T11:06:06Z
transaction,32252c9b-0e75-4587-8927-1e6f524e24d2,posted,Travel Agency Booking,-2032.68,567626cd-6a03-446d-bc89-48a858cae2c0,-13392.42,debit,cash-withdrawal,AU00000,2023-05-24T16:52:58Z
transaction,d6e0d90f-2788-4469-9fee-b32989a73b42,posted,Payroll WFRMS 15439393,11418.68,b9834ed2-fcfa-4576-99e3-cd8ee1fa0861,21508.2,credit,transfer,AU00000,2023-09-26T23:34:15Z
transaction,bd3a6560-b2a9-436d-b52d-43770e022a88,posted,Electricity Bill Payment,-4249.37,edcfe9c4-06f5-4a56-8a78-371270eb74c1,17258.83,debit,payment,AU00000,2023-11-01T12:10:57Z
transaction,a1745814-39b3-4e30-8db5-6e34d64025c6,posted,Bookstore Purchase,-3947.13,b3e2afa9-e573-4148-a508-4b89c8d6fbcd,13311.7,debit,bank-fee,AU00000,2024-01-31T02:32:05Z
transaction,6e34927c-4089-45a1-b198-cbf8c598f84b,posted,Gasoline Purchase,-578.85,2628dfcc-e6e4-4f9b-b508-5a809f265aa8,12732.85,debit,bank-fee,AU00000,2023-10-28T16:32:44Z
transaction,8d7c1150-9a20-4e9a-9cd5-0f62f826e833,posted,Car Maintenance Expense,-2204.54,4150b70c-b71f-48e2-8e72-53f54a334103,10528.31,debit,cash-withdrawal,AU00000,2023-05-13T11:59:02Z
transaction,11e8fc32-85a6-4d18-bcee-83de589dba3f,posted,Restaurant Dinner,-46.46,2deb05ea-650a-4bcd-8848-26a73a250c5b,10481.85,debit,payment,AU00000,2023-11-18T05:48:07Z
transaction,40cdab9b-5ada-49db-b210-1d440816587b,posted,CTRLINK CARERS Ref: 998R6789201610974V,-3635.55,6f31a588-7578-4666-ba3b-dc087631de1d,6846.3,debit,bank-fee,AU00000,2023-11-13T12:09:25Z
transaction,8cee2fa7-820b-44a7-a008-41b27f6bd3a8,posted,Uber Ride,-4547.37,18200e5b-5167-4ce9-bed2-b8dca252537c,2298.93,debit,payment,AU00000,2024-03-01T23:43:42Z
transaction,dccd38f8-a77f-41b3-9f94-f08ee447c1d9,posted,Transfer Platnm Homeloan 346454,-55.93,12bbfe07-2038-4769-82e3-b15dc5c2751f,2243.0,debit,bank-fee,AU00000,2024-02-23T18:41:11Z
transaction,38f58ca0-4d17-4d9f-b4f7-b6e559ad3c43,posted,Mobile Phone Bill Payment,-4472.05,65dcaf28-077c-4f82-b081-c6e45f29a524,-2229.05,debit,bank-fee,AU00000,2023-06-13T18:00:06Z
transaction,690c6ca6-4003-4829-9c99-b2bcb7051a4a,posted,Uber Ride,-2663.81,77b7b90f-f1d0-4873-9ec8-cd45d9a71019,9490.39,debit,payment,AU00000,2023-10-30T17:53:35Z
transaction,2eb8d287-2489-481c-96d5-c47cac95e565,posted,Amazon Online Shopping,-3334.36,d6ca36b3-037c-4798-b21d-3dc9722dc0b2,6156.03,debit,cash-withdrawal,AU00000,2023-12-17T09:05:10Z
transaction,43f6a1f1-ee70-4ab8-9e25-1dc9b34bda7a,posted,Mobile Phone Bill Payment,-483.71,20d5839b-3740-452d-87e4-86e4b01c43b7,5672.32,debit,bank-fee,AU00000,2023-07-28T06:28:38Z
transaction,6109cd34-2d4e-44e9-9534-86967a6ae508,posted,Electricity Bill Payment,-4160.32,fc89115d-561d-4373-abfd-4021e7340de7,1512.0,debit,cash-withdrawal,AU00000,2023-09-18T00:30:54Z
transaction,517b5dd2-e414-42b7-899e-1450811968df,posted,Mobile Phone Bill Payment,-4364.23,c329d12c-3f1f-4708-8a45-b07d02351b46,-2852.23,debit,cash-withdrawal,AU00000,2023-05-23T03:29:21Z
transaction,ff24cf63-11fc-4922-b9c2-67b811cb5c65,posted,Uber Ride,-3141.93,70ceeb68-2092-45ad-8eb7-6f9028bf78ed,-5994.16,debit,bank-fee,AU00000,2023-08-17T02:53:18Z
transaction,57db21f7-e55f-4a84-98ca-17e237f8c7bc,posted,Mobile Phone Bill Payment,-2477.03,78bfeece-da5f-4c5b-9b11-41f5fa3a43fd,-8471.19,debit,bank-fee,AU00000,2023-10-30T16:56:41Z
transaction,d49e511a-4c31-4aac-b61b-3b7659938ead,posted,Payroll WFRMS 15439393,11098.16,d15900c5-75c0-4ca6-bea7-e8d550b4e014,2626.97,credit,transfer,AU00000,2023-09-04T10:24:17Z
transaction,c824f0a5-9c4e-4f4b-b0fc-016090b6575e,posted,Movie Ticket Purchase,-125.34,5f9bd6e2-0874-455e-ae74-e2c2c6790c9f,2501.63,debit,bank-fee,AU00000,2023-07-15T15:46:48Z
transaction,a3018b72-e468-4ca6-abc1-a7c8c5810620,posted,Bookstore Purchase,-359.2,0e5c614a-b69f-4019-b02a-9e8a6d89574a,2142.43,debit,bank-fee,AU00000,2024-05-08T18:07:44Z
transaction,ec429526-616a-42c5-95ca-764404097ed2,posted,Movie Ticket Purchase,-3644.65,b13a7ca2-2896-451c-8b23-3fd141add2a3,11015.0,debit,cash-withdrawal,AU00000,2023-10-27T08:46:16Z
transaction,42590ac2-681d-4987-bc42-5213cdd07bc6,posted,Gym Membership Fee,-2675.51,1d20d52e-1a63-4f7f-b005-2273a194f396,8339.49,debit,cash-withdrawal,AU00000,2024-04-18T05:21:58Z
transaction,bcf27b92-ae97-4476-96d9-abc5818452ed,posted,Gym Membership Fee,-3773.56,fb631266-7d84-4f6b-bb60-5e87bb376f24,4565.93,debit,cash-withdrawal,AU00000,2024-05-05T03:07:31Z
transaction,4bb58433-7fc1-402b-91a6-a0ebd1fb8ddd,posted,Bookstore Purchase,-2309.0,2f71da89-80af-4fcd-bbe2-f33be2acea1b,2256.93,debit,payment,AU00000,2023-06-18T07:57:47Z
transaction,166b7356-8a50-492d-a709-b8a69a09418a,posted,Pharmacy Purchase,-2821.74,bd42772c-53b6-440f-94f8-9b6252b52030,-564.81,debit,cash-withdrawal,AU00000,2023-09-20T12:04:59Z
transaction,fa85a426-7d21-4062-bfb2-e4e8ef99a087,posted,Wdl ATM WESTPAC IGA BALGOWLAH BALGOWL AU,-2970.0,42925a99-5841-4671-8be9-46c42f557734,-3534.81,debit,bank-fee,AU00000,2023-09-13T21:43:09Z
transaction,c4fa23ef-7785-4324-b9be-7bb6470b2bf4,posted,Transfer Platnm Homeloan 346454,-1076.08,6ea8e0e7-7883-472a-a49b-d236f6d7c94b,-4610.89,debit,cash-withdrawal,AU00000,2024-03-01T13:45:54Z
transaction,8846530e-53d7-4969-a957-e8e12f740f4e,posted,Car Maintenance Expense,-4127.26,17994088-fd19-4edd-ba3a-ea057690a946,-8738.15,debit,cash-withdrawal,AU00000,2023-07-13T08:19:05Z
transaction,b928e3e4-c34c-4c62-b3b7-d919be797754,posted,Netflix Subscription,-954.03,d60efdbf-1267-41a2-8604-aff5dc7dc841,-9692.18,debit,payment,AU00000,2024-02-16T03:20:34Z
transaction,7a005795-b8c3-49c9-aaa1-17d0a0e6fd7f,posted,Clothing Store Purchase,-4592.12,dba06700-9fbc-4c36-9199-f5049a1a2103,-14284.3,debit,cash-withdrawal,AU00000,2023-11-23T01:02:49Z
transaction,0476428a-dff2-4683-940e-deccc262442d,posted,Restaurant Dinner,-4951.44,3ee4abea-5e91-4aed-9f31-5f32ddba5664,6658.79,debit,cash-withdrawal,AU00000,2023-08-06T12:07:24Z
transaction,cf1d9bec-94c4-4fae-907a-6e367138aded,posted,Electricity Bill Payment,-2475.11,f91ec81e-1524-4454-ab60-f098db3f0378,4183.68,debit,payment,AU00000,2023-06-30T18:56:08Z
transaction,299900c9-65cb-4729-afe8-eab49a92e72d,posted,Public Transport Fare,-72.92,4438ad3a-25bf-45da-82cd-e82c8d39392a,4110.76,debit,payment,AU00000,2024-02-19T23:10:40Z
transaction,808f88ad-6acf-4fa7-ad42-9cf944136a8d,posted,TFR Acc14000 TO 12389,-3965.99,a56fcabc-0353-4c84-a8f0-35729a7b5c44,144.77,debit,cash-withdrawal,AU00000,2023-08-25T15:38:14Z
transaction,4e9e76f2-db97-4720-a8db-d35503eb17cd,posted,Coffee Shop Purchase,-1807.19,7f14f488-d211-462b-930a-5cb01133e8d7,-1662.42,debit,bank-fee,AU00000,2024-01-24T06:10:33Z
transaction,684c1f2c-685e-4d03-8441-701d3d276eae,posted,Netflix Subscription,-669.98,7b642525-7e25-4992-93b6-9b1bcd1eb6bb,-2332.4,debit,payment,AU00000,2024-03-24T07:54:22Z
transaction,09601fc7-570a-4008-a184-4703401e410f,posted,Mobile Phone Bill Payment,-3789.05,a38dfe53-d48a-4c63-a3dd-63f3a3ae26b5,-6121.45,debit,cash-withdrawal,AU00000,2024-04-24T09:40:15Z
transaction,b54f7524-5ce2-44f1-a519-29130cfc29ed,posted,Clothing Store Purchase,-3305.5,3b04208b-4df7-49bd-96a0-79981c76e89a,-9426.95,debit,bank-fee,AU00000,2024-05-08T05:45:35Z
transaction,0f010c6b-f8dd-44b4-88ae-0efcce7915fd,posted,CTRLINK CARERS Ref: 998R6789201610974V,-3235.99,167b580e-795c-4d12-aa7e-7afac3828064,-12662.94,debit,cash-withdrawal,AU00000,2023-06-27T10:52:12Z
transaction,c5e7e711-4685-4f8d-b0db-cdb3e3551579,posted,TRANSFER TO JOANNA SMITH CAMPING,-945.11,bdac9b55-5004-45d3-8255-2b883f555fa9,-13608.05,debit,bank-fee,AU00000,2023-08-05T20:29:43Z
transaction,2552cccc-773c-4c75-b6d9-904e7e7f3dcc,posted,TRANSFER TO JOANNA SMITH CAMPING,-3128.53,d96ae0d2-a10d-47ba-a15e-b28439be10d0,7679.47,debit,bank-fee,AU00000,2024-02-09T06:40:26Z
transaction,6533b136-b758-43b0-9dc9-7a482d333ce6,posted,Online Gaming Purchase,-4322.2,9d89736b-a097-4352-a94b-9f5737d22c4d,3357.27,debit,bank-fee,AU00000,2024-01-26T10:10:47Z
transaction,b48449c9-95fd-4048-8a80-44151efe2a0f,posted,Car Maintenance Expense,-3734.19,e43cb88f-3f25-487c-b2c6-12c55f0dc6e5,-376.92,debit,cash-withdrawal,AU00000,2023-12-28T07:16:02Z
transaction,9f6d3661-6c2f-4522-8e91-a40d986aeafd,posted,Clothing Store Purchase,-3917.52,1391528b-5fce-4e36-98a2-3f222a0663a6,-4294.44,debit,bank-fee,AU00000,2023-07-24T01:02:19Z
transaction,df986eff-1256-4140-9743-a879c3001474,posted,Amazon Online Shopping,-1263.32,03ff6a54-6a42-4145-a57d-b68cdcdabe51,-5557.76,debit,cash-withdrawal,AU00000,2023-08-19T00:06:46Z
transaction,23d88df9-5641-4402-bd91-19cf442c3fdb,posted,Restaurant Dinner,-1570.03,1b2dfdc1-658d-44c5-8284-27a09e54662a,-7127.79,debit,cash-withdrawal,AU00000,2023-11-14T14:08:54Z
transaction,48a8a041-8bd0-4aec-aba0-9063fe97d3cc,posted,Music Streaming Subscription,-130.7,8ff0e5b0-9b56-4da4-83df-65d250a647c6,-7258.49,debit,cash-withdrawal,AU00000,2023-11-13T13:59:18Z
transaction,e5eea199-9c65-41f9-ba0b-46b8b6fa72a3,posted,Car Maintenance Expense,-369.86,96c5bd46-da02-4a6e-aa67-cdb6ef8c874f,-7628.35,debit,payment,AU00000,2024-04-15T12:02:22Z
transaction,b6f3f761-8977-4e5a-867f-ade17400b85d,posted,Hair Salon Appointment,-3048.59,c06658b9-fa93-4021-9348-e2f6afe2c55f,-10676.94,debit,payment,AU00000,2024-04-04T22:54:04Z
transaction,0ede7b78-d796-4bfe-92b8-19584fe1189d,posted,Transfer Platnm Homeloan 346454,-3009.24,5b7e0d60-8b80-4d82-8642-e5c3c9857528,-13686.18,debit,bank-fee,AU00000,2024-02-06T05:02:32Z
transaction,8729f415-f2cd-467e-8ed7-3439c0c1034f,posted,Mobile Phone Bill Payment,-1732.27,37b09a3f-59ab-4d9e-a0ef-2e6ec18bb7c1,6943.94,debit,bank-fee,AU00000,2024-03-19T00:45:41Z
transaction,e4498b42-db7e-40ce-b101-16647b49fa63,posted,Travel Agency Booking,-2047.53,bd4998a7-3e5d-44ce-a342-0bbae7948a5b,4896.41,debit,cash-withdrawal,AU00000,2023-07-23T14:59:02Z
transaction,d6a21b03-8a21-41ac-8640-2f473d13fe10,posted,Gasoline Purchase,-1500.42,071b7f47-b04c-433e-bae0-026d95e4d74f,3395.99,debit,payment,AU00000,2024-04-20T02:09:54Z
transaction,c83f8621-2fa1-422b-a815-99e6973772b2,posted,Netflix Subscription,-1219.46,30f7b9dc-445f-4def-93ad-77a2d9d0a05e,2176.53,debit,cash-withdrawal,AU00000,2023-11-19T21:10:31Z
transaction,77f3eea6-e5a2-456b-9572-4adc1ff9ea1d,posted,Manly Maths Tutor Wages,-1589.06,e5bbcb17-0bd8-4e2f-9506-8c30792331ed,587.47,debit,bank-fee,AU00000,2023-06-24T08:06:25Z
transaction,072665a6-3526-4e63-80d7-c9d88466052b,posted,Mobile Phone Bill Payment,-3881.65,41431443-bdf9-488a-b72a-ef657db06118,-3294.18,debit,cash-withdrawal,AU00000,2023-09-10T18:45:20Z
transaction,925c9c91-89db-46ba-9509-c4e71d572345,posted,Non Hooli ATM Withdrawal Fee,-847.5,65658aeb-bce4-47c7-a614-54e8a9ca474f,-4141.68,debit,payment,AU00000,2024-01-18T21:09:03Z
transaction,a6040ccb-4808-4a57-b4e5-3aa3fee18938,posted,Mobile Phone Bill Payment,-4564.98,c9d7a587-27b1-46cd-b439-5a1a3e59e923,-8706.66,debit,cash-withdrawal,AU00000,2023-05-28T05:41:52Z
transaction,eadaa064-f480-40eb-9373-1e6252909795,posted,Public Transport Fare,-227.06,6e43136b-efe6-4b1d-bfae-958c92511fca,-8933.72,debit,payment,AU00000,2023-06-21T02:27:42Z
transaction,8de57462-c3c0-4e1b-88ad-62494e11770c,posted,Coffee Shop Purchase,-4642.81,e6df65d8-0ec8-4ebe-8cf0-f1188d442c98,-13576.53,debit,payment,AU00000,2023-06-03T03:31:52Z
transaction,37e79c37-d9e4-4abf-9cd6-5ca1baf71d7d,posted,AGL RETAIL ENERGY LTD (GAS),-2761.51,c499a288-7577-4b95-9323-7b4fb667f339,11800.91,debit,payment,AU00000,2023-10-13T05:27:18Z
transaction,b5446690-e71c-4159-bf12-214ec30c85c2,posted,Netflix Subscription,-3111.92,817d14d9-16c1-40d8-a5c3-8c985695cb6b,8688.99,debit,payment,AU00000,2023-11-06T17:44:32Z
transaction,a950927b-0b3e-48c1-8d9e-1f1b0a7da513,posted,Coffee Shop Purchase,-1626.94,3dbab2f3-58d7-421f-b0f3-c1a872c68336,7062.05,debit,cash-withdrawal,AU00000,2023-05-17T19:09:09Z
transaction,d3044f4e-c4a6-4cb5-bdd6-4500793328ca,posted,Music Streaming Subscription,-2663.72,22575cbe-f38c-47be-8235-80bbc094b4d7,4398.33,debit,payment,AU00000,2023-10-28T07:45:08Z
transaction,048f1817-5942-4ed3-809b-9892bf3c3dc7,posted,Clothing Store Purchase,-1384.39,42e92ecd-d050-482f-a54c-e00e468cfae9,3013.94,debit,bank-fee,AU00000,2023-10-16T13:23:43Z
transaction,3f2fa24a-b417-4c9e-bb86-ebccd7001feb,posted,TFR Acc14000 TO 12389,-120.52,4e4b20a3-1829-405d-afd8-02aed4ca2bec,2893.42,debit,payment,AU00000,2023-07-03T08:41:08Z
transaction,2e4d70a7-aae8-4f25-82fb-ba32bb25d291,posted,Music Streaming Subscription,-2337.72,90f8f359-8f1a-416e-a857-df5a6cf20391,555.7,debit,payment,AU00000,2024-05-03T18:38:54Z
transaction,61415308-7728-491b-b314-9f8dfe0c5d35,posted,Mobile Phone Bill Payment,-241.44,b40c568c-9413-4da5-aacd-27cf3bb806ec,314.26,debit,payment,AU00000,2024-02-11T15:25:22Z
transaction,9a83a655-112b-4bac-970d-474577f87b3b,posted,Coffee Shop Purchase,-3441.2,ddccb2e9-92a9-4d73-9946-67b819e7c06a,-3126.94,debit,bank-fee,AU00000,2023-05-16T21:30:59Z
transaction,1c669b6b-abd7-49e8-bb60-09c4f7a75477,posted,Gasoline Purchase,-464.57,12f5c5c1-a1fd-4478-8f34-54724ff15a09,-3591.51,debit,payment,AU00000,2024-02-09T03:10:42Z
transaction,d3574baa-a286-443d-9f26-70f26228bca0,posted,Bookstore Purchase,-172.91,dbe1995c-1864-436b-8282-b2f5ef3e18f2,15093.24,debit,payment,AU00000,2023-05-25T03:02:29Z
transaction,75323258-cd3d-4cf3-a002-c30f9a69cfd2,posted,Netflix Subscription,-1139.21,d975dbb3-9090-4354-9c1a-832ae12800b5,13954.03,debit,payment,AU00000,2024-03-16T15:02:20Z
transaction,93c4a482-e839-4600-bfa4-c7b7e7c651b5,posted,Electricity Bill Payment,-2026.5,41adde4b-e0cd-410a-8c25-a88766fa5e4e,11927.53,debit,bank-fee,AU00000,2023-08-01T05:58:37Z
transaction,e664b359-3c26-488e-a06b-5dd925b8ae50,posted,Travel Agency Booking,-3602.74,df79f413-df70-477b-85da-1c72da1d6f71,8324.79,debit,cash-withdrawal,AU00000,2023-07-02T04:53:57Z
transaction,869ff1b3-20f0-4a75-a348-54d25d6b6740,posted,Amazon Online Shopping,-722.23,55dcb4ff-c30d-4634-be99-1eeb43d4139e,7602.56,debit,payment,AU00000,2024-04-22T22:58:28Z
transaction,0d2285f7-31c5-4e2a-b720-ca031104c46b,posted,TRANSFER TO JOANNA SMITH CAMPING,-4899.16,49af1730-05ba-46d2-ba6d-655021a758c4,2703.4,debit,cash-withdrawal,AU00000,2023-08-21T13:49:23Z
transaction,bfa5a5bd-1dfe-4bf7-a0fd-534da660697b,posted,TFR Acc14000 TO 12389,-275.57,56355e4d-3d88-4213-aeff-0d5284c153e4,2427.83,debit,bank-fee,AU00000,2023-09-25T05:00:00Z
transaction,225fa0c8-e4b1-46c6-a820-398dd8cb8d35,posted,Music Streaming Subscription,-4485.79,b982547b-1756-4469-bad8-8671414931ca,-2057.96,debit,cash-withdrawal,AU00000,2023-10-27T04:43:05Z
transaction,c2e93fd5-e50f-4a19-b1b6-a6987ea15090,posted,Pharmacy Purchase,-3673.21,3a7c8650-37be-4681-acce-4871c264ce3e,-5731.17,debit,cash-withdrawal,AU00000,2023-10-03T14:26:27Z
transaction,97bc42b7-d256-4c61-bf16-c8a2d7a51dcf,posted,Car Maintenance Expense,-3567.18,64c709b5-2a1c-4225-9625-c7ca5b3250bb,-9298.35,debit,bank-fee,AU00000,2024-01-30T08:25:54Z
transaction,7fe2946e-5a96-4fa4-ae42-56e0219d6d1c,posted,Gym Membership Fee,-1912.89,888d57e7-fc88-469c-8623-c9b9e7b9a7c8,9507.39,debit,cash-withdrawal,AU00000,2023-08-06T07:48:59Z
transaction,3bff8648-34ba-4179-9aa2-3175ed07882e,posted,Payroll WFRMS 15439393,11721.74,55a0fcef-9985-400f-9b9d-2f346b25894b,21229.13,credit,transfer,AU00000,2024-01-25T01:38:08Z
transaction,d9939255-a804-48f9-998d-7e0e56058ad8,posted,Netflix Subscription,-576.71,4db9b933-a824-4615-bc99-2a692b56ba34,20652.42,debit,payment,AU00000,2023-11-28T04:59:48Z
transaction,c708f5ed-3083-47fd-a29d-7351ecb0a283,posted,Manly Maths Tutor Wages,-2765.59,2115b471-9a2b-45cd-ac1e-d65d7edcf182,17886.83,debit,payment,AU00000,2024-04-03T00:05:14Z
transaction,70c96878-b5eb-4a4d-951b-b88cc992195f,posted,Music Streaming Subscription,-4855.5,ce624603-cbc4-4658-8541-7e209c715570,13031.33,debit,cash-withdrawal,AU00000,2023-08-31T02:31:55Z
transaction,3ea7a1bf-d826-4b36-86af-119074d11fe0,posted,Bookstore Purchase,-1688.98,03277b37-7b3b-40c3-a646-cbe5dde2c275,11342.35,debit,cash-withdrawal,AU00000,2023-07-23T17:57:46Z
transaction,289fcc40-1e85-47a2-8a51-c8b9d656ca83,posted,Travel Agency Booking,-3725.55,be910a5b-dc56-4c20-9e5a-12e7ef79739b,7616.8,debit,bank-fee,AU00000,2023-07-10T08:06:26Z
transaction,c700f292-0648-4428-b01a-6e3b3c8ecde7,posted,Coffee Shop Purchase,-4544.1,239144cd-d163-4b35-8c4e-fd13e4496f62,3072.7,debit,cash-withdrawal,AU00000,2023-12-30T02:55:41Z
transaction,6ac926bf-5003-463e-86d9-8d0a54713b98,posted,Netflix Subscription,-1776.25,8ce57944-b9de-44bf-90d7-876b47ee52d2,1296.45,debit,payment,AU00000,2023-09-07T00:21:12Z
transaction,c6d70e30-3c0e-43e9-9286-a8ed131bff69,posted,Car Maintenance Expense,-3950.32,fbe666e9-9530-492c-b6f1-1ae28cfca61f,-2653.87,debit,payment,AU00000,2023-10-03T06:33:32Z
transaction,e44f3e8c-22a3-4dae-bff0-6db809568605,posted,CTRLINK CARERS Ref: 998R6789201610974V,-1872.19,9af62b2a-6b48-4d3b-b418-debf75ee9789,13955.69,debit,cash-withdrawal,AU00000,2023-10-09T06:28:50Z
transaction,e90b220d-a998-4dd2-947c-3e6c0431edec,posted,Gasoline Purchase,-1369.89,c1bfa590-1298-419b-ab6c-b9123eb432af,12585.8,debit,bank-fee,AU00000,2023-09-21T05:25:13Z
transaction,b4fff148-f50a-4973-8a02-f25e6705880d,posted,Travel Agency Booking,-184.78,0a14133f-75f9-4151-a5ae-5f04fba5b106,12401.02,debit,payment,AU00000,2024-01-05T04:37:28Z
transaction,398469fa-e930-4205-93e1-ea11c82f8b08,posted,TFR Acc14000 TO 12389,-3476.43,a62f92b7-160c-4dc2-ba87-ed32dced0ccb,8924.59,debit,bank-fee,AU00000,2024-04-28T16:43:34Z
transaction,a5f6f2c1-d0ba-49a8-b081-e6daf9d8b862,posted,Wdl ATM WESTPAC IGA BALGOWLAH BALGOWL AU,-4072.52,c7516a71-d599-4881-8e4e-52f7358463ca,4852.07,debit,payment,AU00000,2024-01-10T09:00:16Z
transaction,362710f2-d8b8-44e6-ac9b-d1cc31f8f9a3,posted,Mobile Phone Bill Payment,-2697.14,022c042b-323f-4ec7-87c4-16168dfd5348,2154.93,debit,bank-fee,AU00000,2024-03-10T03:13:18Z
transaction,aa7e32f6-0b34-4b40-886d-f65d2126f646,posted,Restaurant Dinner,-1118.29,551ef48f-b020-4317-bb4a-26cc4ef9265a,1036.64,debit,cash-withdrawal,AU00000,2023-07-25T13:59:18Z
transaction,50348887-cd2f-4376-9de1-7eb856ecf046,posted,Amazon Online Shopping,-3405.25,e0bea46e-70a5-4cd7-b65a-2bef1a2909be,-2368.61,debit,cash-withdrawal,AU00000,2023-08-02T19:27:06Z
transaction,3fb20cb4-583f-4e74-a963-f7b3904db52c,posted,Travel Agency Booking,-3976.67,803c4712-c557-47f6-b7d1-540a5eb15d2f,-6345.28,debit,cash-withdrawal,AU00000,2023-12-23T19:11:25Z
transaction,ea13182f-0ad4-46a9-9b08-ec8cc5ec80db,posted,Home Improvement Store Purchase,-1840.05,a8e7f2d7-2fe1-47c4-a208-6659471e11f0,-8185.33,debit,payment,AU00000,2024-04-02T11:20:48Z
transaction,1b1ea75c-7dcb-402c-965f-a6e2547cb5a9,posted,Movie Ticket Purchase,-1144.07,7a5302cf-b06a-4388-9389-1339910671fb,13823.53,debit,bank-fee,AU00000,2024-04-23T13:16:59Z
transaction,228dc0d8-95ee-49fe-aa73-4f24561e8a93,posted,Travel Agency Booking,-778.97,75c769fb-d437-4889-9139-4970768be08c,13044.56,debit,cash-withdrawal,AU00000,2024-03-18T22:57:00Z
transaction,8570f3e7-b275-463b-918b-4cd9dc72ea48,posted,TRANSFER TO JOANNA SMITH CAMPING,-1019.61,229fdc85-159c-4ae4-8794-5e859525f218,12024.95,debit,bank-fee,AU00000,2024-02-14T13:56:47Z
transaction,ed24a09f-5d77-4c78-9eca-e37d7c2184da,posted,Bookstore Purchase,-4434.86,fe9dfe05-6e97-4acc-a41e-66fd7f1b74ac,7590.09,debit,payment,AU00000,2024-03-17T06:27:02Z
transaction,b51d33a4-d196-489c-b0fb-b6c884201319,posted,TRANSFER TO JOANNA SMITH CAMPING,-300.07,e815fcb5-0c0d-4f95-918f-fc05a7319a1e,7290.02,debit,cash-withdrawal,AU00000,2023-09-04T10:05:59Z
transaction,dd3283b8-3ba6-4630-a7a6-5440a6af69b2,posted,CTRLINK CARERS Ref: 998R6789201610974V,-1608.63,fdb68765-2b61-4a26-b7aa-0ee8837a57d2,5681.39,debit,bank-fee,AU00000,2024-02-08T18:12:29Z
transaction,f8cd16a7-e454-4829-a601-07e55bc08405,posted,Coffee Shop Purchase,-227.5,e1dcb555-136c-47c7-a0e4-887372eed256,5453.89,debit,cash-withdrawal,AU00000,2024-02-07T07:11:19Z
transaction,e072fa52-3986-4333-b083-f7da9f9c064d,posted,Coffee Shop Purchase,-2221.68,a75c7784-be96-4656-9071-d9c1bcd84f17,3232.21,debit,bank-fee,AU00000,2024-04-05T16:14:12Z
transaction,455be8ee-629d-43fc-825a-350b4b213d4b,posted,Hair Salon Appointment,-239.32,d770158b-b1cc-49ff-a2c4-258fb75d98b5,2992.89,debit,payment,AU00000,2024-04-21T11:48:47Z
transaction,2900a5fb-8e36-40b4-919a-f350fe49b577,posted,Music Streaming Subscription,-4587.81,97d29af4-c713-4d25-981b-0609ad468ca3,-1594.92,debit,bank-fee,AU00000,2023-08-14T19:06:29Z
transaction,a53996bb-6f7f-455a-9df2-56da01d10ac9,posted,Wdl ATM WESTPAC IGA BALGOWLAH BALGOWL AU,-4849.78,d1ea79ee-7252-455a-81be-b33918aaacbf,13021.1,debit,cash-withdrawal,AU00000,2023-11-03T03:16:29Z
transaction,bdf64890-e4f0-493c-ac22-e7e3ade0a76d,posted,Public Transport Fare,-1209.53,96e44d55-8dc5-411c-8cb5-fc2b9627e42b,11811.57,debit,bank-fee,AU00000,2024-02-23T02:05:46Z
transaction,9b08e52d-49e7-4a4a-a0ef-e19227a1339d,posted,Car Maintenance Expense,-1343.19,9a99ae87-42db-443d-851b-095f9fafd1d6,10468.38,debit,payment,AU00000,2023-12-18T12:20:08Z
transaction,e89276da-befd-4efb-9c71-99a91aeee60a,posted,Manly Maths Tutor Wages,-270.26,fa6106c9-487e-4847-afad-fc718bbe9f9d,10198.12,debit,cash-withdrawal,AU00000,2023-10-18T22:17:36Z
transaction,473a140d-b305-453c-ba35-e73a8f8ad3f8,posted,Travel Agency Booking,-3266.79,b0c206e1-2813-4be6-816d-bc5e20459fb2,6931.33,debit,payment,AU00000,2023-07-14T11:52:53Z
transaction,57542f94-813b-4936-a737-bf81fca95dc5,posted,Wdl ATM WESTPAC IGA BALGOWLAH BALGOWL AU,-1582.49,63897e18-d900-4c95-99b1-abf907608cd6,5348.84,debit,cash-withdrawal,AU00000,2024-03-13T22:51:55Z
transaction,8e040eef-5372-480c-b584-b52c5afff2ac,posted,Payroll WFRMS 15439393,11367.05,c84bd373-19df-4ca5-9c9b-8700834305d1,16715.89,credit,transfer,AU00000,2023-08-25T13:25:56Z
transaction,80e3cf16-e60e-4cc1-88f5-1f2bb54f2fe5,posted,Coffee Shop Purchase,-4796.12,d18c15d8-9c57-44f6-a6a1-66ae8acc15f5,11919.77,debit,payment,AU00000,2023-10-09T22:54:10Z
transaction,0c5f1298-5ddd-4e25-ac87-6da65854e593,posted,TRANSFER TO JOANNA SMITH CAMPING,-4906.5,58728883-2373-47b2-87a4-91ba6ae626d8,7013.27,debit,cash-withdrawal,AU00000,2023-06-11T10:08:01Z
transaction,8ddb3cb8-ba76-4fb3-ac2a-49e748dbfa93,posted,Gym Membership Fee,-3080.37,40010b65-d7be-442f-9749-f18c9111aced,3932.9,debit,cash-withdrawal,AU00000,2024-01-08T23:20:15Z
transaction,d624841d-0278-4ac8-9053-2b6c0a0cae86,posted,Coffee Shop Purchase,-4115.25,07ee6a7d-26e0-4ec7-b664-82be8602ba27,1996.62,debit,payment,AU00000,2023-06-07T02:38:17Z
transaction,0c9ee83c-cb6c-4ef7-bfa0-b36ddfb50a6f,posted,Wdl ATM WESTPAC IGA BALGOWLAH BALGOWL AU,-978.37,610e3b43-d256-4d4d-943a-9b810cf27891,1018.25,debit,payment,AU00000,2024-04-14T11:46:30Z
transaction,5e8b7947-f931-4689-b1e8-e833d515728c,posted,Restaurant Dinner,-3007.5,ddabe511-aa74-43d8-ada3-8fe479298dcb,-1989.25,debit,cash-withdrawal,AU00000,2023-10-14T20:13:31Z
transaction,bdcc4ef8-83cc-4889-91ce-fc3e4d514f19,posted,Pharmacy Purchase,-1038.74,567ef6a5-c938-4af6-b50e-716d14d3da93,-3027.99,debit,payment,AU00000,2023-09-25T20:53:25Z
transaction,7e31d518-2e71-4798-8894-54cfdb20790a,posted,Travel Agency Booking,-1344.07,3534f5c2-6d3e-4360-a096-91d443dedb9c,-4372.06,debit,payment,AU00000,2023-09-24T23:34:48Z
transaction,d2627312-eade-4de2-99c5-327d83b2c212,posted,Uber Ride,-1464.78,a161bef5-4d43-40ff-9e7a-5d9c891c882e,-5836.84,debit,payment,AU00000,2024-02-09T05:12:23Z
transaction,35eadd16-ba06-4342-93b5-4d93037c9aa1,posted,Restaurant Dinner,-3807.34,c3f496ca-56d4-49ff-a6ad-7ecb40535ed6,-9644.18,debit,cash-withdrawal,AU00000,2024-01-27T08:40:33Z
transaction,14c2cf84-a98c-4b7b-9816-7b4e661db2a9,posted,Wdl ATM WESTPAC IGA BALGOWLAH BALGOWL AU,-759.91,d0c557d7-d27d-45ec-ade8-297a8337ab11,-10404.09,debit,bank-fee,AU00000,2023-08-12T00:56:51Z
transaction,4d4c281c-9f0a-4bb8-8ad4-ef605d4d85f1,posted,TRANSFER TO JOANNA SMITH CAMPING,-3841.88,4ea87ae2-e0f5-49e8-9b6b-943aaa69a448,-14245.97,debit,bank-fee,AU00000,2023-09-20T12:49:31Z
transaction,b47ae218-02ec-4ed3-9acc-4aad5fc3da1b,posted,Electricity Bill Payment,-2640.77,cb371ecb-d30f-443a-9970-fd51a45502c0,-16886.74,debit,payment,AU00000,2024-04-09T23:41:45Z
transaction,1b77a7b0-a997-4f5f-ba82-d419cf5b01ea,posted,Online Gaming Purchase,-864.44,3f2c4b58-830f-41c1-a7b5-1331706e1260,17626.1,debit,bank-fee,AU00000,2023-11-03T11:39:47Z
transaction,01b84c03-2797-4a8f-8793-e34f664539cf,posted,Public Transport Fare,-24.43,d0927a57-ff47-43de-b469-600096df16cc,17601.67,debit,payment,AU00000,2023-10-05T03:16:01Z
transaction,eee3adfc-9274-477e-b989-0dec772abfce,posted,Online Gaming Purchase,-1315.3,ddf1baa4-ab63-489a-b1ee-a7624f798a7a,16286.37,debit,payment,AU00000,2024-02-29T17:15:46Z
transaction,2eb2d209-e812-4992-9d79-574a2bfd5281,posted,Travel Agency Booking,-4453.35,91bdc47f-722d-473a-bd2d-11634f88f456,11833.02,debit,bank-fee,AU00000,2024-03-14T08:12:24Z
transaction,7a9e9056-b575-4d2a-bf8a-ad33950bc7a8,posted,Movie Ticket Purchase,-3224.91,ab478c10-31db-49d9-822d-ce558f08d845,8608.11,debit,cash-withdrawal,AU00000,2023-07-29T19:44:35Z
transaction,dcadf4b8-c206-4c0a-9248-6c02acd96dde,posted,Online Gaming Purchase,-3166.68,2d88ee52-3b35-45df-81e7-3716e054567c,5441.43,debit,cash-withdrawal,AU00000,2023-10-29T17:13:43Z
transaction,76adf41a-9ca4-4e1c-af54-68029d18821c,posted,Electricity Bill Payment,-501.73,069892a9-098d-4c5d-af64-66cc6fbe1548,4939.7,debit,bank-fee,AU00000,2024-02-27T03:22:18Z
transaction,647fe467-19c4-4bd2-91af-df88d7b1aad6,posted,Restaurant Dinner,-1994.04,b0eacbef-839d-4a25-bc61-bc6c35609f60,2945.66,debit,bank-fee,AU00000,2023-09-22T12:40:16Z
transaction,ec850227-5daf-4da5-9ded-cc8dea1cb6be,posted,Netflix Subscription,-1661.01,0fcba5e5-e21e-4765-96ae-629660e6e7a4,1284.65,debit,cash-withdrawal,AU00000,2024-04-13T17:04:22Z
transaction,3977af8d-9838-42b3-b544-6bee91773501,posted,Payroll WFRMS 15439393,10318.08,a6d3771f-7683-47df-9c87-fa6cc0e0bf32,11602.73,credit,transfer,AU00000,2024-02-24T00:30:16Z
transaction,d90f56f1-c5c8-48b4-b156-85bbdd0463b1,posted,Music Streaming Subscription,-162.67,e97f9a2e-54e4-49f0-ac1d-f3ce2375253f,10342.74,debit,cash-withdrawal,AU00000,2023-07-31T05:16:05Z
transaction,32ef057a-b797-4e5b-9528-c3fb9131ada5,posted,Netflix Subscription,-4831.86,a95f3b98-556c-4086-94da-59f306fdaf93,5510.88,debit,payment,AU00000,2024-02-22T03:14:02Z
transaction,807c92a4-1244-487f-ae39-db702d563980,posted,Restaurant Dinner,-1916.16,4353aa48-b533-407d-813b-18f58b35e7c1,3594.72,debit,payment,AU00000,2024-02-22T03:55:27Z
transaction,d53c6287-4c13-4eae-ba9f-0c36d143e471,posted,Wdl ATM WESTPAC IGA BALGOWLAH BALGOWL AU,-502.86,8e621bc6-8304-472e-a0bd-b143c847666b,3091.86,debit,payment,AU00000,2024-03-05T11:10:44Z
transaction,05e51b88-0714-468d-b7ee-fe6a4b16d430,posted,Manly Maths Tutor Wages,-4412.18,3422f68c-35e6-485c-85d5-a2bb7f0674e3,-1320.32,debit,cash-withdrawal,AU00000,2024-04-19T02:21:01Z
transaction,cd77ecc5-af3d-4303-8875-dd26c19717c6,posted,Non Hooli ATM Withdrawal Fee,-4325.31,d75b256e-b6bb-4562-b1bb-84d195b997b5,-5645.63,debit,bank-fee,AU00000,2023-05-13T11:07:09Z
transaction,5b2f6b19-83b8-4e36-8060-7a2f3a695a4f,posted,Music Streaming Subscription,-3473.53,7e59b69a-fb32-4e5b-9760-f55480d5268f,-9119.16,debit,cash-withdrawal,AU00000,2024-01-18T14:28:28Z
transaction,40b8dde5-9f64-401a-ab2e-057d4a87454f,posted,Mobile Phone Bill Payment,-4242.68,54594428-814f-40ed-8752-a43da54294fe,-13361.84,debit,cash-withdrawal,AU00000,2024-02-10T21:02:28Z
transaction,6851dd3a-6a21-4148-af14-999abb5eaac0,posted,Public Transport Fare,-1626.14,ea01f472-3c33-4fe7-868f-3fd59acbccce,-14987.98,debit,payment,AU00000,2023-08-05T22:42:18Z
transaction,dadd723d-c5a5-40ee-893f-919cf295885c,posted,Home Improvement Store Purchase,-1914.13,6d316795-a820-4843-b10b-ada93615b701,-16902.11,debit,cash-withdrawal,AU00000,2023-06-09T07:47:38Z
transaction,5cc14033-0481-4c02-9135-aaa410709fee,posted,Restaurant Dinner,-3943.54,63b27a0e-b2c8-4908-b2eb-3feb679224ab,2772.54,debit,payment,AU00000,2024-01-28T03:54:43Z
transaction,106a015f-51dc-4c3b-b3e9-aaadc7a648b1,posted,Gym Membership Fee,-2705.54,613e15df-e4fb-4f70-9257-6e0b33968ad0,67.0,debit,bank-fee,AU00000,2023-09-23T14:23:46Z
transaction,0c777f34-724e-4359-88b9-9ca1f52a2769,posted,TFR Acc14000 TO 12389,-4321.44,0a23e32a-48ab-4c15-9d9d-48be75af4a5d,-4254.44,debit,cash-withdrawal,AU00000,2023-11-26T14:00:01Z
transaction,f724e143-ee36-4e60-919c-875aec32884f,posted,Transfer Platnm Homeloan 346454,-334.07,ca6a5c2a-4bd4-49ab-910a-39a76b7cfd57,-4588.51,debit,cash-withdrawal,AU00000,2023-07-27T07:24:11Z
transaction,055a4c97-c717-4a6c-a613-806983c7450a,posted,TRANSFER TO JOANNA SMITH CAMPING,-533.62,d23644b3-7872-4a96-b5fb-8de5af13cf69,-5122.13,debit,bank-fee,AU00000,2023-06-23T04:17:47Z
transaction,ef4c170a-528a-4b21-aa3d-973784127490,posted,Coffee Shop Purchase,-4083.22,eddc57b5-eb34-4713-9c60-d8dd7ce99820,-9205.35,debit,cash-withdrawal,AU00000,2023-10-22T01:41:59Z
transaction,97559376-4ea8-4b04-b1a0-bb369d466800,posted,Restaurant Dinner,-2209.67,eb166538-8faa-4282-9bad-63bd2ff1c2ed,-11415.02,debit,payment,AU00000,2023-05-17T02:59:42Z
transaction,8f8f43e1-27f2-4218-8e6c-1f69f5edbc37,posted,Public Transport Fare,-3891.21,0e810329-adf7-476e-8938-a2da0892709d,-15306.23,debit,bank-fee,AU00000,2024-05-10T19:26:45Z
transaction,1ab1b358-b35a-4b4d-a41c-87b098b9908f,posted,Gasoline Purchase,-325.52,3b9195d1-a0fc-48ef-9a2f-410f27156f2f,-15631.75,debit,payment,AU00000,2024-05-07T10:17:39Z
transaction,fddc7e7e-fb3b-43b7-a451-42ecb8089125,posted,Wdl ATM WESTPAC IGA BALGOWLAH BALGOWL AU,-1807.49,f7f04729-9f61-40c9-a03a-e7cae973177c,-17439.24,debit,payment,AU00000,2023-11-17T20:12:56Z
transaction,13ba922f-db54-4998-a686-fb21dcb3eec1,posted,TFR Acc14000 TO 12389,-4534.12,83adc8dd-70aa-4f26-b6de-a5bcbb7661d1,12824.36,debit,cash-withdrawal,AU00000,2024-02-15T07:20:11Z
transaction,2e4c21b2-0e48-4788-8a5f-9c9f90bfdffa,posted,Gym Membership Fee,-1019.92,54ee0a3e-e48b-43c3-9db8-00f74acb5adb,11804.44,debit,bank-fee,AU00000,2023-08-08T10:42:07Z
transaction,38155ee0-00ac-48d9-9404-24a0045627ca,posted,Clothing Store Purchase,-1863.26,907786a9-7cd3-4df0-a17f-59b9161d1a8b,9941.18,debit,payment,AU00000,2023-12-04T13:14:16Z
transaction,395777c5-2b56-4e1e-8b8f-660aa9e7037b,posted,Coffee Shop Purchase,-1017.4,b1ff16c9-23d8-459a-94dc-c6301804fee9,8923.78,debit,payment,AU00000,2024-03-17T14:40:50Z
transaction,7108a687-eed8-4c2d-9e9f-9f36a7a4f27c,posted,Public Transport Fare,-4518.43,c24092fa-bbc5-4163-92df-46c58a60ae36,4405.35,debit,bank-fee,AU00000,2023-08-07T20:51:57Z
transaction,b76780ec-ff05-4dd1-8e77-69ec50014b2b,posted,Movie Ticket Purchase,-2691.13,9b2e09bd-9539-4f19-a77e-f40d1489b559,1714.22,debit,cash-withdrawal,AU00000,2023-11-14T21:45:05Z
transaction,9458f242-2f11-410d-9be0-0bea0aabeef0,posted,Pharmacy Purchase,-2671.95,e225785e-987c-41a9-b616-2ce8ee2cd819,-957.73,debit,cash-withdrawal,AU00000,2024-03-01T21:14:26Z
transaction,0e7b8658-b830-4e16-9cac-99bb2628cb37,posted,Home Improvement Store Purchase,-2202.42,2fd64fac-212b-42b7-8cf6-8ccd3e972875,-3160.15,debit,cash-withdrawal,AU00000,2023-10-26T20:22:14Z
transaction,14dc7c7c-5f0b-44f6-94fd-2ca0695b44cd,posted,Public Transport Fare,-676.16,8c8314c5-41e1-482c-8246-4b73f60299fb,-3836.31,debit,cash-withdrawal,AU00000,2023-10-17T17:47:13Z
transaction,74fc4ab2-9457-46b4-b98e-7d9382067e57,posted,TFR Acc14000 TO 12389,-3756.79,cb0712d1-bd04-4321-be40-a4d79546ba7e,-7593.1,debit,payment,AU00000,2023-10-29T16:15:54Z
transaction,76b2dee9-94dd-4b0e-84fa-43651f3f52bd,posted,Gym Membership Fee,-1910.01,ed2d490f-853d-44b6-b216-0d88b17826d3,5328.14,debit,bank-fee,AU00000,2023-06-11T23:39:20Z
transaction,b09856af-34a3-4f3a-9702-267925ca795c,posted,Electricity Bill Payment,-424.54,af3ec6b0-f01e-4e3e-bf3b-53e902e63107,4903.6,debit,cash-withdrawal,AU00000,2023-11-24T03:34:59Z
transaction,2cf65680-753b-4943-887a-9cc8de5e6239,posted,Coffee Shop Purchase,-289.54,c90b3624-af68-4336-8847-12cc5f87856c,4614.06,debit,bank-fee,AU00000,2024-02-12T07:38:27Z
transaction,dc38ca78-83a5-4a37-9723-ed0676d9ec47,posted,Wdl ATM WESTPAC IGA BALGOWLAH BALGOWL AU,-1526.36,a01f0cab-1507-4e46-9d89-d32c80e9b5d2,3087.7,debit,cash-withdrawal,AU00000,2023-11-25T21:39:42Z
transaction,de8e72b8-34bc-49ec-b6d2-2f035eacf9f9,posted,Restaurant Dinner,-3642.28,76e960b5-f1ca-4b55-8097-b9ea771eb24d,-554.58,debit,bank-fee,AU00000,2024-03-26T07:36:19Z
transaction,1e8dc49b-f862-4656-910f-31cb559af964,posted,Uber Ride,-676.74,a681cff0-c459-4ed8-9f01-270d6bf605fc,-1231.32,debit,payment,AU00000,2023-10-21T22:38:55Z
transaction,7ae558ea-7111-4d98-ba7e-5e65f36e6330,posted,Manly Maths Tutor Wages,-1685.83,1c20cf2c-faa8-4396-b072-8ef404e46134,-2917.15,debit,bank-fee,AU00000,2023-12-14T07:45:08Z
transaction,843ddf99-651b-4b06-99a6-bb3c7acc783b,posted,Payroll WFRMS 15439393,11882.92,d32cb886-2aae-41e3-9471-299176b57898,8965.77,credit,transfer,AU00000,2024-02-14T06:21:38Z
transaction,afbbde5d-47cb-4618-a833-9f1ecb6d7752,posted,Music Streaming Subscription,-3238.77,df7fd045-43d6-4bf5-a486-08ced9cec0ed,5727.0,debit,payment,AU00000,2024-05-03T12:48:16Z
transaction,e80271da-163a-486d-b6b4-be6282f7a871,posted,CTRLINK CARERS Ref: 998R6789201610974V,-1588.68,a40ae3a8-e58a-42e7-a295-fcc7f0a8ccc7,4138.32,debit,bank-fee,AU00000,2024-05-08T20:39:15Z
transaction,add1c718-b6ef-4359-8160-c61917ff303b,posted,TRANSFER TO JOANNA SMITH CAMPING,-3472.53,c2aa118d-aed2-4e77-919b-aaf16e7ba659,14028.45,debit,payment,AU00000,2023-08-21T09:50:24Z
transaction,713b34d4-613d-41bc-90db-4c84243ab20c,posted,Car Maintenance Expense,-3128.24,44478de9-77a5-48a5-b1a4-8b53a0d9e44b,10900.21,debit,payment,AU00000,2023-08-30T21:58:12Z
transaction,ef8bad04-0e5e-44ef-9cf7-1042b1441ab1,posted,Home Improvement Store Purchase,-4354.34,6c8eb875-1392-4bcd-b29a-74fc67e12354,6545.87,debit,bank-fee,AU00000,2024-03-16T23:21:44Z
transaction,68ee8d3d-6e1f-4c27-9843-95f85715d34a,posted,AGL RETAIL ENERGY LTD (GAS),-3339.11,a80e8a18-820c-4657-b8b8-725337438d0c,3206.76,debit,cash-withdrawal,AU00000,2024-04-29T10:48:48Z
transaction,3c265739-68b7-4838-839f-85aa59c5e366,posted,Clothing Store Purchase,-4707.08,facb2a44-8b56-4547-a886-d77c6f301c0a,-1500.32,debit,payment,AU00000,2023-08-30T15:15:40Z
transaction,aaa99629-ad2d-40c9-a1de-4a0db7793315,posted,Mobile Phone Bill Payment,-465.0,92ac84ae-0df9-4fbd-92ab-bdf93637a404,-1965.32,debit,payment,AU00000,2023-11-14T05:12:11Z
transaction,85fb49a6-ac89-4fe6-80b7-8df11f2aa29b,posted,Hair Salon Appointment,-429.75,e0e3bd95-0ef1-459a-8de2-5f44d9168f7e,-2395.07,debit,payment,AU00000,2023-07-30T22:52:18Z
transaction,0725460d-944e-432b-b40e-b4369d7dc02e,posted,Amazon Online Shopping,-2910.51,5144767b-40cd-4ba0-bb57-473557457cc8,-5305.58,debit,cash-withdrawal,AU00000,2023-08-18T21:45:05Z
transaction,8e56a4da-26dc-4f1f-99c9-a8328e026aa3,posted,Gym Membership Fee,-1560.37,b9addbd6-bcef-4d50-893c-0c2fb8313ecc,-6865.95,debit,payment,AU00000,2023-08-28T08:02:25Z
transaction,c1d516f8-5e2d-4c46-849b-19e44d9d3f6a,posted,Pharmacy Purchase,-3169.63,d99be0fc-9a2f-421d-9328-555eb1f68dad,-10035.58,debit,payment,AU00000,2023-12-26T03:19:23Z
transaction,b4559785-80e8-43b4-ac48-e2c8628809a2,posted,Non Hooli ATM Withdrawal Fee,-3956.63,ffcf4c88-6a1e-442a-bc8a-c623bcd0e4cd,9026.43,debit,bank-fee,AU00000,2024-02-09T04:30:46Z
transaction,2865d8b3-e60a-4ee9-9189-f5a70bb07663,posted,AGL RETAIL ENERGY LTD (GAS),-40.82,3049ae28-1a16-4de0-a422-1cdb1b5bf763,8985.61,debit,bank-fee,AU00000,2023-07-31T09:08:32Z
transaction,7e357636-969f-4d47-8da7-c7f5332b0a6d,posted,Bookstore Purchase,-2510.95,a3d88ce7-20aa-4a8e-82a8-70acae60fc85,6474.66,debit,bank-fee,AU00000,2024-03-13T19:13:59Z
transaction,a850d59c-8215-4e0a-916b-050735240196,posted,Restaurant Dinner,-1002.6,98dd6e2f-c523-4c7b-93da-4e089857fe82,5472.06,debit,payment,AU00000,2023-12-01T20:29:24Z
transaction,c2206bce-252e-432b-8f6a-8bc4db6dcfc3,posted,Amazon Online Shopping,-2786.67,1c173dec-e56b-41fb-9613-612a4be62446,2685.39,debit,bank-fee,AU00000,2024-03-18T12:16:44Z
transaction,e61ccd86-ecae-4e88-a42c-6fdaf64bd0f8,posted,Payroll WFRMS 15439393,10799.22,dabf5a50-b510-43eb-993f-dfa558167328,13484.61,credit,transfer,AU00000,2023-10-17T20:25:23Z
transaction,99e834e5-db30-42dc-90b0-09463ee3b90e,posted,Transfer Platnm Homeloan 346454,-977.17,d95ba726-f1dc-408c-94bc-bfe6bd4ea90a,12507.44,debit,payment,AU00000,2023-12-30T18:18:05Z
transaction,fcad1393-4578-46c4-8046-a59d768e57c1,posted,CTRLINK CARERS Ref: 998R6789201610974V,-3206.92,119e9d66-34d3-4db9-be39-385d303bafd9,9300.52,debit,bank-fee,AU00000,2023-12-21T13:09:17Z
transaction,d5608e91-c44b-48e7-b069-6919fb93f097,posted,Coffee Shop Purchase,-3055.45,586107b4-1d91-4859-8c2c-60e23e743674,6245.07,debit,cash-withdrawal,AU00000,2023-06-16T08:45:02Z
transaction,9d2f297d-abde-40b5-9284-5ea348052dc6,posted,AGL RETAIL ENERGY LTD (GAS),-439.43,382087d8-e537-47ef-83eb-e9e68a9bbe14,5805.64,debit,payment,AU00000,2024-02-24T04:49:33Z
transaction,b4d3b626-11ae-4fb1-b664-265d8585216c,posted,Amazon Online Shopping,-4810.58,538c897e-c48e-4720-8523-cc74cbabae2c,9858.19,debit,payment,AU00000,2023-06-03T16:31:16Z
transaction,bd6f6e78-9112-4ba8-9d70-e08f82310532,posted,Mobile Phone Bill Payment,-4885.17,03ce3ed8-b9d5-43a0-a38f-22ffc8a3c831,4973.02,debit,payment,AU00000,2023-12-06T16:05:44Z
transaction,c485e40b-406f-43f5-9844-2d9dadede233,posted,Netflix Subscription,-2008.02,4b1b40f7-8d32-4ff3-8c7e-3bb03e8bd2e6,2965.0,debit,cash-withdrawal,AU00000,2023-09-14T18:00:56Z
transaction,7ee7f6db-9ad5-49e1-a787-155a6faa309d,posted,Manly Maths Tutor Wages,-2049.92,30113b6b-7aeb-4b5b-aaa7-d9f428e1e3cb,915.08,debit,cash-withdrawal,AU00000,2024-03-02T02:41:02Z
transaction,ca32e19e-6dcf-4ba4-9167-af3a26657aaa,posted,Clothing Store Purchase,-1105.33,8051b1ed-7020-4889-8c73-dcf30f42b40a,-190.25,debit,payment,AU00000,2024-04-02T19:32:21Z
transaction,81298f16-a31e-4cc0-8175-728b96581b61,posted,Transfer Platnm Homeloan 346454,-844.37,4b1d5557-1e30-460d-952c-28b80120530d,-1034.62,debit,cash-withdrawal,AU00000,2024-04-24T12:29:19Z
transaction,79cc26c8-07e4-4121-bd97-8a651ee73f8d,posted,Coffee Shop Purchase,-2728.89,65abd462-527e-45b4-9e00-758690f0f1e0,-3763.51,debit,bank-fee,AU00000,2024-04-19T08:40:10Z
transaction,97e55207-22c8-4c5b-9c72-795f42454e76,posted,Coffee Shop Purchase,-890.67,946155d5-7ac8-4cca-a200-794de091e875,-4654.18,debit,payment,AU00000,2023-11-17T22:21:00Z
transaction,3e9e90cb-8630-4ba8-837b-38deb9363cda,posted,Car Maintenance Expense,-923.61,95bf1b6c-0988-4997-b71c-b5350bb1ba31,-5577.79,debit,cash-withdrawal,AU00000,2024-02-21T08:25:31Z
transaction,bc6c750f-5b63-4080-9b62-73a046862e78,posted,Pharmacy Purchase,-3931.31,973fb020-0ff5-4898-913f-c7ab6e00139a,-9509.1,debit,cash-withdrawal,AU00000,2023-08-13T00:02:13Z
transaction,4a45a957-7da9-4a87-ac5f-14ec5156b091,posted,TRANSFER TO JOANNA SMITH CAMPING,-2516.26,6f4d6c09-deb0-46d5-986f-aadfbcfa1699,7161.61,debit,payment,AU00000,2023-05-20T13:03:18Z
transaction,cd5da09b-47b4-45f9-93d5-300302c9cee9,posted,Non Hooli ATM Withdrawal Fee,-3972.92,7d7c002e-8aca-4822-8502-254ab6418405,3188.69,debit,cash-withdrawal,AU00000,2024-03-17T03:29:42Z
transaction,581ace73-3feb-4f1b-807f-5661fc427d24,posted,Wdl ATM WESTPAC IGA BALGOWLAH BALGOWL AU,-126.36,d7fa64bc-e7d4-4896-8a4a-b9154db4b60f,3062.33,debit,cash-withdrawal,AU00000,2023-06-30T06:28:48Z
transaction,66cf6a9a-8903-49ad-b5a8-b0b1c802ffa0,posted,Gym Membership Fee,-4795.57,eda6ad63-2569-4469-a563-8d9db402c9e4,-1733.24,debit,cash-withdrawal,AU00000,2023-08-01T10:43:52Z
transaction,385b156b-484e-4b61-a350-dd4daafb4cfe,posted,TFR Acc14000 TO 12389,-2889.55,5878daa5-d44d-4038-a725-2e27b57f96f7,-4622.79,debit,cash-withdrawal,AU00000,2024-04-28T11:37:59Z
transaction,1dabc548-0519-4377-8454-2d8c63f8dfbe,posted,Manly Maths Tutor Wages,-1094.56,ba4770f4-a803-424e-8c1e-74db18e5a6ba,-5717.35,debit,bank-fee,AU00000,2024-01-29T13:03:07Z
transaction,800135da-81a9-4ab8-80fb-a80de8d955de,posted,Movie Ticket Purchase,-1218.92,7c7fc8b4-7c9b-4995-a16c-74efb0dd7ed8,-6936.27,debit,payment,AU00000,2024-01-16T01:14:56Z
transaction,467094b7-e1e3-4122-a654-280da1339a8e,posted,Gym Membership Fee,-3759.46,0dd5ce76-e356-4812-ba2e-e7fe96356a79,-10695.73,debit,cash-withdrawal,AU00000,2023-12-29T11:38:53Z
transaction,01b4a343-0972-4790-8cdf-dae8397aa085,posted,Restaurant Dinner,-4765.57,62798dfd-2521-4c7a-a21e-2a87ba7a9c97,-15461.3,debit,cash-withdrawal,AU00000,2023-05-12T23:06:16Z
transaction,32120de5-d260-4ed5-88c1-4cd8769faa49,posted,TRANSFER TO JOANNA SMITH CAMPING,-1883.45,724f9986-042d-4943-ad18-7789f4712d6d,-17344.75,debit,cash-withdrawal,AU00000,2023-08-30T01:19:36Z
transaction,2433225a-81fd-4eb7-8778-bb0607f6d1d1,posted,Gym Membership Fee,-4876.82,bc5dba49-7bb2-413e-89a7-3ab5201f9a0e,8785.23,debit,cash-withdrawal,AU00000,2023-11-29T01:48:30Z
transaction,e148b708-7fd4-49a7-b29d-c7af5b3bc164,posted,AGL RETAIL ENERGY LTD (GAS),-4027.38,e8e52549-e58c-4119-baa0-4b7bf6633291,4757.85,debit,bank-fee,AU00000,2024-03-23T21:55:51Z
transaction,0d47a7b8-cabb-486e-ab54-d4cd3ba64429,posted,Pharmacy Purchase,-1184.29,d9fb3cb4-42ef-49f7-91ee-6a5e37b4a9d9,3573.56,debit,cash-withdrawal,AU00000,2024-01-07T05:08:04Z
transaction,23be6e06-ba2e-450d-bdd8-adfeeb5ab869,posted,Netflix Subscription,-4863.14,1a0f8934-b4c2-42a8-8692-f490ec90fc9a,-1289.58,debit,payment,AU00000,2024-01-29T22:05:08Z
transaction,ff871843-0f3e-4ca7-acaf-6278f8334baf,posted,TFR Acc14000 TO 12389,-3531.08,360c28d4-df66-4f7f-8d6e-1098b85e4b97,-4820.66,debit,cash-withdrawal,AU00000,2023-10-01T20:25:52Z
transaction,2a1a9161-1401-4867-a6c7-06dce283c787,posted,Coffee Shop Purchase,-1914.94,95b09100-dc38-4f2e-bd25-2bf6481044ca,-6735.6,debit,cash-withdrawal,AU00000,2023-12-05T21:44:24Z
transaction,a814ba56-a459-4176-a9ad-410642ab2577,posted,TRANSFER TO JOANNA SMITH CAMPING,-2141.01,b14665b4-ac1c-423a-bda3-4ff64f004aa3,-8876.61,debit,cash-withdrawal,AU00000,2024-03-07T00:43:05Z
transaction,e91361f1-689c-42db-bf45-37e513544ef9,posted,Travel Agency Booking,-1484.32,90cc5c58-6602-4c32-adee-0edbcd770aa4,-10360.93,debit,payment,AU00000,2023-07-03T20:28:39Z
transaction,c53e00c2-f6f4-4a0c-849c-03dea12327ad,posted,Clothing Store Purchase,-2939.27,c985fc97-c742-42ef-bb77-60e22f7b0f6c,-13300.2,debit,payment,AU00000,2023-10-12T10:15:26Z
transaction,bcac60ed-2576-4723-9b24-f1916d0efabf,posted,Electricity Bill Payment,-4598.11,6f4c1841-4e88-44c9-80b9-22d119f3a959,-17898.31,debit,payment,AU00000,2023-12-12T13:19:59Z
transaction,990fb001-d2dc-4144-be03-af91d4571128,posted,Hair Salon Appointment,-1680.54,6aeff16a-4ddc-4931-85d9-2271853a6eaf,16670.84,debit,cash-withdrawal,AU00000,2023-10-10T13:49:42Z
transaction,261a3d2e-18e2-4a79-8597-3daabec7950e,posted,Bookstore Purchase,-2235.17,9d8ca2b8-8a1f-4da9-bce8-2a23696bf3ae,14435.67,debit,cash-withdrawal,AU00000,2024-04-28T10:47:19Z
transaction,949fb08e-bb1c-41ba-8bd6-1075bfff5d13,posted,Clothing Store Purchase,-1934.51,45f96ede-c5c6-4b3e-b113-eb7ebe1080af,12501.16,debit,bank-fee,AU00000,2023-10-21T06:45:14Z
transaction,7b1cb63b-a13a-480d-9268-e7f25ceefd61,posted,AGL RETAIL ENERGY LTD (GAS),-3700.77,2f85bbb3-a9bb-4ed2-9c97-4fa02c67377a,8800.39,debit,payment,AU00000,2023-07-22T00:54:39Z
transaction,a20dee8f-040a-424f-b184-14d887940b4c,posted,Music Streaming Subscription,-3142.44,815a8bed-7fd4-42b7-8638-2982be334c15,5657.95,debit,bank-fee,AU00000,2023-06-22T05:40:37Z
transaction,8cbaef12-1516-4917-b472-9bf21cd8e767,posted,TRANSFER TO JOANNA SMITH CAMPING,-4428.76,1d9e9bdc-2e83-40ec-9116-e7ea753d684e,1229.19,debit,bank-fee,AU00000,2024-02-17T06:31:38Z
transaction,b48a602f-3dca-4d9e-9c28-68542850c0e6,posted,Mobile Phone Bill Payment,-1495.2,25b7ac35-3441-41c0-9b5a-8cb7a2a9bf2b,-266.01,debit,cash-withdrawal,AU00000,2024-02-01T19:08:01Z
transaction,4c407b92-914e-4daa-85b6-af2ea2d77748,posted,Coffee Shop Purchase,-1830.28,0b32c780-379a-4028-8974-0bfa13c370bd,-2096.29,debit,payment,AU00000,2023-06-04T06:45:01Z
transaction,e901327a-7d2c-4e04-af12-d9b9bc831b96,posted,TRANSFER TO JOANNA SMITH CAMPING,-425.42,c503a12b-4f3f-4135-97b4-564be2b21d08,-2521.71,debit,bank-fee,AU00000,2023-08-31T22:05:05Z
transaction,8e604c0e-deb4-4c5a-97ad-0c644ed09151,posted,Pharmacy Purchase,-265.96,fed8137d-ec3f-445c-8a57-562ac2f22f54,-2787.67,debit,cash-withdrawal,AU00000,2023-06-16T00:59:48Z
transaction,cdca2fb4-d821-4306-a189-e9f48b0fa039,posted,Movie Ticket Purchase,-410.88,6ff58dff-cf3e-4469-97d3-487fca21337d,7206.11,debit,payment,AU00000,2023-09-20T18:10:58Z
transaction,9da98c68-a6d8-433e-bce6-5776577763e2,posted,Coffee Shop Purchase,-2552.61,5b622c22-d019-40ae-b63d-384b057d5f1f,4653.5,debit,bank-fee,AU00000,2023-08-06T04:14:12Z
transaction,d7fa3dc7-c63e-4af4-9cab-72a2438c7f4c,posted,Gasoline Purchase,-3359.74,328a4a90-02c3-44c3-9912-024f5be3a3e9,1293.76,debit,payment,AU00000,2024-01-04T08:20:40Z
transaction,f1b65069-5a0f-476b-9bdf-d7666769b86c,posted,TRANSFER TO JOANNA SMITH CAMPING,-4837.4,f9a6059a-9570-4a02-80b4-17b247dafbf9,-3543.64,debit,cash-withdrawal,AU00000,2024-05-01T19:22:53Z
transaction,8d520e77-71e1-4928-9920-5785452a3e60,posted,Hair Salon Appointment,-2372.58,27aa20da-fe87-488e-a05d-e8e313e327c6,-5916.22,debit,cash-withdrawal,AU00000,2023-09-12T19:16:42Z
transaction,b9ae6a7e-f57d-46b5-b265-b7f532708138,posted,Pharmacy Purchase,-4561.54,a59d5e75-0779-41ab-8384-9d709c84cd75,-10477.76,debit,cash-withdrawal,AU00000,2024-01-03T12:50:39Z
transaction,af4dbff0-2e54-4291-ac94-4c34f6b8df21,posted,Non Hooli ATM Withdrawal Fee,-3040.72,982f72bb-59fc-4fa4-8954-74a37d7bfc26,-13518.48,debit,payment,AU00000,2023-05-16T10:12:59Z
transaction,6c7aa139-133e-420f-afbd-a70a4fcac69c,posted,Manly Maths Tutor Wages,-255.92,ce2ab509-d634-4ce4-a70b-755adb3541d2,-13774.4,debit,payment,AU00000,2023-11-14T22:49:53Z
transaction,a75a2e34-c8dd-42ad-a519-55930095ffda,posted,Car Maintenance Expense,-295.06,3e578c28-fa18-45e3-80e2-8133e84adc16,-14069.46,debit,payment,AU00000,2023-11-07T21:36:16Z
transaction,3a32496f-863f-4303-8bee-f121d6ad5048,posted,Home Improvement Store Purchase,-1015.19,1e004866-e50a-4bf4-be28-c33c1165bdd0,-15084.65,debit,cash-withdrawal,AU00000,2023-08-31T02:20:10Z
transaction,c241c992-708e-40e5-b31b-4a8a14a7bd1a,posted,Uber Ride,-2313.61,74dff6ff-b89c-4dd3-9905-222397a33cd2,6604.55,debit,cash-withdrawal,AU00000,2023-11-02T17:18:21Z
transaction,71c39919-212a-4bee-89bd-0439aa2db6f6,posted,Non Hooli ATM Withdrawal Fee,-3184.24,e47ba70d-59ba-4b6b-8bbb-5eca7ae6fba7,3420.31,debit,payment,AU00000,2023-12-22T02:22:31Z
transaction,a5bc6a95-5eef-49ed-8661-639341218ba8,posted,Travel Agency Booking,-2286.79,c0228249-ed73-459d-b90c-784bbdcabcd5,1133.52,debit,payment,AU00000,2023-08-09T06:00:13Z
transaction,f27add4e-8f1e-4026-97fe-4d4634a0e284,posted,Electricity Bill Payment,-3710.34,447cb40f-9d2f-4969-a87e-85a7571c070e,-2576.82,debit,payment,AU00000,2024-01-21T15:32:46Z
transaction,0a2aed21-f859-4a02-8309-0ada67a2e4c0,posted,Hair Salon Appointment,-1267.59,f859f694-a992-41e8-9b33-df20254b3bd4,-3844.41,debit,bank-fee,AU00000,2023-08-04T18:43:59Z
transaction,164cd7ea-efcd-49ac-8d37-70da2034a1db,posted,Clothing Store Purchase,-4207.54,ee92b53e-a2c4-4429-a3db-38ab429991eb,-8051.95,debit,cash-withdrawal,AU00000,2024-03-24T04:09:06Z
transaction,5136f3cb-9ab7-4279-812c-c526b96f4a23,posted,Payroll WFRMS 15439393,11992.64,eafdbb8d-59a1-4372-b0af-69d2217790ac,3940.69,credit,transfer,AU00000,2023-11-21T12:52:32Z
transaction,624e866a-c608-456c-a70d-0478526b2638,posted,Electricity Bill Payment,-787.6,339a0e27-994a-4260-bfd4-e2db1d86dab0,3153.09,debit,payment,AU00000,2024-02-01T14:13:36Z
transaction,a455132f-8018-498a-873e-e0ee6e9c01ff,posted,Gasoline Purchase,-3511.36,4dbc2e52-1693-4ce7-a4cc-6ac3e12911b3,-358.27,debit,payment,AU00000,2023-10-31T13:28:40Z
transaction,1585f638-2e4d-4cb6-8b3a-b0a40a7b5526,posted,Travel Agency Booking,-200.06,996b15b9-343b-45da-bfee-3367b352fd6a,-558.33,debit,cash-withdrawal,AU00000,2023-12-14T16:43:12Z
transaction,ca130f1d-1441-4c8c-a79f-251dc0295f27,posted,Travel Agency Booking,-1911.42,1237e8d8-9ab5-4b87-973d-bdcefa4a0f7d,14702.58,debit,bank-fee,AU00000,2023-11-18T05:33:55Z
transaction,c12ecf5b-991f-406e-8c25-8c8ec4769e57,posted,Movie Ticket Purchase,-865.47,740473e5-4079-4871-8995-bf372c190826,13837.11,debit,cash-withdrawal,AU00000,2024-01-29T04:49:38Z
transaction,05beac0a-2099-42d9-8ffc-9570c63566b6,posted,Online Gaming Purchase,-2185.24,758b9f08-f81f-488a-9361-160cd6d35daa,11651.87,debit,payment,AU00000,2024-03-26T22:32:46Z
transaction,754d1df0-e5fb-4921-aec0-f1e535b5fa98,posted,Wdl ATM WESTPAC IGA BALGOWLAH BALGOWL AU,-4605.06,0b8fd144-b63b-4760-b6f7-dbc65d88e344,7046.81,debit,bank-fee,AU00000,2023-12-04T20:16:43Z
transaction,d397e318-86a2-486f-a3e2-7d4880a75203,posted,Pharmacy Purchase,-2198.48,a9196a71-4b1c-4c52-9f8f-01be4c1ade9d,4848.33,debit,payment,AU00000,2024-02-27T07:44:08Z
transaction,d578e257-22ca-4134-8823-3ffb916055d4,posted,TRANSFER TO JOANNA SMITH CAMPING,-2518.76,2bc4b842-c510-4da6-bd85-848711148af5,2329.57,debit,payment,AU00000,2023-11-03T00:31:36Z
transaction,1d4ac5c2-977a-490c-9920-05a4dff6a70d,posted,Netflix Subscription,-2983.61,8111976d-b4a8-4461-8d0e-403ff6e7b95c,-654.04,debit,payment,AU00000,2023-12-05T15:01:07Z
transaction,df3a3ebc-c0a6-4992-8770-5fe0054cadc8,posted,Uber Ride,-1436.62,6dff58f8-ff78-48e5-9537-9fc223991534,-2090.66,debit,bank-fee,AU00000,2023-11-09T14:57:03Z
transaction,0da54367-b05c-41cc-92c8-201d80dfc642,posted,Netflix Subscription,-3064.86,24b757af-f848-49cf-9acf-5c7b0e0ae81d,-5155.52,debit,bank-fee,AU00000,2024-05-09T22:28:49Z
transaction,0c2e3eca-df1a-4029-824a-bc7b0e400733,posted,Gym Membership Fee,-2470.6,282c39ea-1f97-4aac-be6b-155fc13fe14e,-7626.12,debit,payment,AU00000,2023-06-16T11:02:05Z
transaction,40def085-f428-48c8-9b5d-ed580d8d5f2a,posted,Manly Maths Tutor Wages,-1028.68,7c311405-8c29-414d-85c8-cc171efab82c,8393.27,debit,payment,AU00000,2023-12-16T20:51:20Z
transaction,9f186f6f-2dbc-4baa-8321-05105117b97d,posted,Uber Ride,-4168.05,6a33f717-ec0d-4b82-b30d-f18ca92b37eb,4225.22,debit,cash-withdrawal,AU00000,2024-02-07T07:45:14Z
transaction,89dcc25b-ed51-476f-8047-823e569e83c0,posted,Travel Agency Booking,-4344.91,aaa4a662-d282-45a8-9528-dc06c726c489,-119.69,debit,bank-fee,AU00000,2023-12-31T15:25:21Z
transaction,46476b41-9c32-4834-957b-97ed5793352c,posted,CTRLINK CARERS Ref: 998R6789201610974V,-4070.07,fa398c1f-3b24-43ee-8d58-91e3bc39cf70,-4189.76,debit,bank-fee,AU00000,2023-06-19T20:48:27Z
transaction,3f4cece4-065b-4805-ad16-445e99d9cd8f,posted,Electricity Bill Payment,-3925.84,59b8faee-f829-49b4-a139-8da1f507475f,-8115.6,debit,bank-fee,AU00000,2023-06-14T16:06:22Z
transaction,aabfc483-4e36-4789-ac2c-d22fcc516afc,posted,Manly Maths Tutor Wages,-4384.27,abdf5eb0-870f-4d35-a6cd-d7bc742944b4,-12499.87,debit,bank-fee,AU00000,2023-07-13T22:47:37Z
transaction,8d7868ba-f0e0-4cae-8a0a-14a28a9a385a,posted,Netflix Subscription,-119.61,c93f56b6-7880-4123-9256-5551eee60fad,-12619.48,debit,bank-fee,AU00000,2023-10-24T22:29:55Z
transaction,0897bf73-c599-48d1-a212-a75b0b7140d2,posted,Music Streaming Subscription,-2100.25,d0a14ac1-9937-4073-b698-4dd8ea49b698,-14719.73,debit,bank-fee,AU00000,2023-05-20T18:51:12Z
transaction,a910d848-5fd6-4d25-90a6-59e6372a1ac8,posted,Non Hooli ATM Withdrawal Fee,-608.79,6150dd98-4c87-44f0-8d3d-6ec11b188d82,-15328.52,debit,payment,AU00000,2023-07-07T18:16:31Z
transaction,14a687b1-d3e2-4d42-b946-50956b329933,posted,Public Transport Fare,-3753.14,31e1eb1c-62a5-44c4-b389-591c2cff8fac,-19081.66,debit,cash-withdrawal,AU00000,2023-11-20T09:40:50Z
transaction,cdb4d123-ed05-4d66-bf8a-5ac026430bc5,posted,Online Gaming Purchase,-2338.8,a556b11c-70d6-458c-bd36-99ed01ffdc97,16175.72,debit,payment,AU00000,2023-08-02T13:10:10Z
transaction,c2db9bb4-e921-49e2-a62c-42ebef1d8afc,posted,Hair Salon Appointment,-4501.45,884e6107-2d1a-4d70-848b-1ab6005ac283,11674.27,debit,payment,AU00000,2023-11-22T19:06:24Z
transaction,b99d025d-44af-4b70-a5ca-f1a2dc738e35,posted,Restaurant Dinner,-4901.06,2f6281f3-acc5-48b9-8faf-5a9103d63dd6,6773.21,debit,bank-fee,AU00000,2023-11-05T15:41:25Z
transaction,a6cb1492-77ea-429f-86f9-918dbef58bca,posted,Clothing Store Purchase,-4709.46,4733d310-3f81-433e-9a5e-c68c8eaa8090,2063.75,debit,cash-withdrawal,AU00000,2024-01-21T13:10:21Z
transaction,bf72cb0a-d28e-4922-98ed-9f612d41f71e,posted,Non Hooli ATM Withdrawal Fee,-611.97,a39e3fe8-19c9-4d93-b7d7-1dd1fffd1c66,1451.78,debit,cash-withdrawal,AU00000,2024-04-07T14:12:41Z
transaction,30958325-a9e6-413f-b999-a00fe4949de0,posted,Payroll WFRMS 15439393,11337.73,1b1b4608-343a-4acf-b2ba-6e277ff8b9f3,12789.51,credit,transfer,AU00000,2023-09-23T07:56:20Z
transaction,479fd006-a765-4f28-bd4b-75a1b59928e7,posted,Netflix Subscription,-1017.07,bf457f53-45c3-4473-958d-195711ffc3dd,11772.44,debit,bank-fee,AU00000,2023-07-22T05:04:48Z
transaction,73c0de15-4429-47d2-aa78-84e9b799932f,posted,CTRLINK CARERS Ref: 998R6789201610974V,-1916.02,882f9588-2614-4faa-a01c-993021677b6e,9856.42,debit,payment,AU00000,2023-12-30T21:51:18Z
transaction,1b98ef33-80a1-4f86-8f00-421c891cea28,posted,Clothing Store Purchase,-282.08,9efb1ccf-d919-41cc-bece-a5ef371c996c,9574.34,debit,bank-fee,AU00000,2023-08-19T01:13:36Z
transaction,f2283c2d-956b-46dd-abb3-f6de3d6f1d1a,posted,Manly Maths Tutor Wages,-4342.89,49c0cefd-711e-42cd-ace8-8307f7f12259,5231.45,debit,cash-withdrawal,AU00000,2023-11-30T01:17:12Z
transaction,e46ae005-6f22-4cb1-88b2-195680a2f28d,posted,AGL RETAIL ENERGY LTD (GAS),-926.87,5d995cd1-dab1-4943-8ea3-73a9353ef7f0,13994.49,debit,bank-fee,AU00000,2024-01-18T12:50:09Z
transaction,1e8e78c7-9940-4759-b8af-839a132e7a5b,posted,Clothing Store Purchase,-1697.4,42a0aeec-71b2-4568-9882-0c347cb1dbc8,12297.09,debit,cash-withdrawal,AU00000,2024-03-13T09:17:59Z
transaction,9fa102a3-37cb-4c6a-8673-bee87bb75bcf,posted,TRANSFER TO JOANNA SMITH CAMPING,-4077.59,b483c5f0-6061-46ad-acda-02d3b5ad2265,8219.5,debit,bank-fee,AU00000,2024-02-27T09:08:49Z
transaction,a15ff7c8-11f5-4326-9433-a66fcd73397c,posted,Payroll WFRMS 15439393,10395.58,158800b4-6657-4597-878b-43d4546e8ea6,18615.08,credit,transfer,AU00000,2024-05-07T12:17:51Z
transaction,d476e595-a39c-4379-a398-4169572de8aa,posted,Restaurant Dinner,-2848.87,e6e9c28a-15e9-416a-a0a6-dd9a687eadb9,15766.21,debit,bank-fee,AU00000,2023-07-16T21:03:21Z
transaction,431b9a5e-aff6-4bcd-82ed-2d8daf709579,posted,Non Hooli ATM Withdrawal Fee,-4038.96,854794fc-3ae5-4620-b6ba-ffbb8baa4fed,11727.25,debit,payment,AU00000,2023-07-13T14:58:11Z
transaction,38244bc4-2348-4a92-b9b4-ad3065582871,posted,Manly Maths Tutor Wages,-2878.44,32095782-7453-4d0a-b53b-42d7f935c69c,8848.81,debit,cash-withdrawal,AU00000,2023-08-03T13:43:33Z
transaction,bbf3dde6-cd25-4b77-9d7f-c7fabb41ad45,posted,Manly Maths Tutor Wages,-4513.99,73297840-90d7-44f6-bf79-b3d198089a2a,4334.82,debit,cash-withdrawal,AU00000,2023-08-17T01:20:35Z
transaction,55deec1a-91e4-4e99-831e-0def4a15ddcd,posted,TFR Acc14000 TO 12389,-1791.05,76853c7d-4588-4d61-9b49-5708b8fbb19c,2543.77,debit,cash-withdrawal,AU00000,2023-12-03T14:36:23Z
transaction,75bec6b1-b723-4918-87d0-a5d60959c7c1,posted,Electricity Bill Payment,-1907.78,026fcdee-d01e-467d-beb6-7918fd045ce6,635.99,debit,cash-withdrawal,AU00000,2024-01-08T00:12:48Z
transaction,e579a4b4-e397-407a-9e20-7f9cefd30c0a,posted,Wdl ATM WESTPAC IGA BALGOWLAH BALGOWL AU,-1081.33,9a990689-e434-49ca-9e5a-067809b51910,7228.48,debit,bank-fee,AU00000,2023-08-21T18:17:55Z
transaction,5f4c28e0-cbce-4840-a7cc-7b15ca975517,posted,Manly Maths Tutor Wages,-4731.77,420e5589-7637-4f3f-9429-f2f93dbae1e4,2496.71,debit,bank-fee,AU00000,2024-02-04T18:02:49Z
transaction,7eea81fd-baa1-418d-8a20-033506218513,posted,Pharmacy Purchase,-2492.78,648e364d-edcd-495e-9781-6030ae2cc5e4,3.93,debit,cash-withdrawal,AU00000,2024-04-12T12:27:21Z
transaction,be6eb9ac-450e-4169-84ff-072e42658dcb,posted,Uber Ride,-4969.84,c17a9d8d-ef7e-4df9-bd21-de70956ca7a4,-4965.91,debit,bank-fee,AU00000,2023-06-13T13:15:25Z
transaction,9a4e3346-5e55-42c7-84f1-17cf0841a6fc,posted,Hair Salon Appointment,-1704.33,0fdfe40b-f029-4dcf-9861-34425c7c4556,-6670.24,debit,bank-fee,AU00000,2024-01-29T03:09:18Z
transaction,943ba2c1-b393-44a3-bdd8-77044cbb021f,posted,Restaurant Dinner,-3405.56,f959d875-2e7f-4a14-beca-aed946fbd2a1,-10075.8,debit,bank-fee,AU00000,2023-07-03T23:42:18Z
transaction,8d2dd3ea-382e-499b-a0c9-eb4c5edf8709,posted,Non Hooli ATM Withdrawal Fee,-4676.49,a7d69ac5-1ac0-4b39-a1c7-4a9e8b3a6ed2,-14752.29,debit,bank-fee,AU00000,2023-06-25T19:25:05Z
transaction,1286a1a2-49f4-4bde-b3d1-f36e3a6add52,posted,Gym Membership Fee,-2144.84,f255c543-02e1-4299-b6c4-fbd2dcaa5f7d,-16897.13,debit,cash-withdrawal,AU00000,2023-10-19T08:57:34Z
transaction,66b8de98-1de0-46d9-9fcf-c25241cfca5f,posted,Transfer Platnm Homeloan 346454,-2364.07,cc6a7012-280b-4676-8157-c779cc599dca,-19261.2,debit,payment,AU00000,2023-10-31T02:26:36Z
transaction,544e949f-e84c-41ab-bdf0-1c7586181bd2,posted,Coffee Shop Purchase,-3561.33,8aedd4de-a3c2-4fa7-a76a-d1c0a6618d3f,-22822.53,debit,bank-fee,AU00000,2023-10-18T10:06:50Z
transaction,c3b92898-0b81-404d-a88b-dec91ccb2a6c,posted,Music Streaming Subscription,-1784.36,600b3767-5f0e-4a15-9a17-54c879aa8a24,15435.56,debit,cash-withdrawal,AU00000,2024-02-11T15:39:13Z
transaction,f48af18b-8d57-47ba-b077-a47cc899c537,posted,Wdl ATM WESTPAC IGA BALGOWLAH BALGOWL AU,-2882.58,60b5f06e-515a-43e1-bb88-6dae326bc9dc,12552.98,debit,cash-withdrawal,AU00000,2024-01-16T13:53:31Z
transaction,e8f2006a-1b2f-4c19-8341-43bc887a1842,posted,Music Streaming Subscription,-1725.03,878dd307-5cf8-4527-bfde-80f9296062cf,10827.95,debit,cash-withdrawal,AU00000,2023-07-24T02:51:57Z
transaction,b50aa470-fb33-4a4a-88d2-575be4213896,posted,CTRLINK CARERS Ref: 998R6789201610974V,-1623.54,ea1684c2-060a-4aee-91d9-96ecd7e1d8ac,9204.41,debit,payment,AU00000,2023-10-20T01:13:30Z
transaction,4b2bcbb9-4ee6-47d4-a268-4f1542b8de9b,posted,Gym Membership Fee,-2321.04,4661abbc-19ac-4f20-ab7d-3a1b812a099b,6883.37,debit,payment,AU00000,2024-02-15T09:51:37Z
transaction,46700808-3482-47b3-9a83-7b06722eb86d,posted,Pharmacy Purchase,-816.93,22bed3dd-7d8d-4f35-aee3-5cfe06174d48,6066.44,debit,payment,AU00000,2023-07-16T01:44:27Z
transaction,25079ae2-2aa0-48b2-a58d-2a20a0f59efe,posted,Gym Membership Fee,-2195.92,473d2318-1c8c-4b4a-ab60-8e06d9d36dfb,3870.52,debit,payment,AU00000,2023-06-14T12:29:34Z
transaction,575a1e85-3e5f-4307-ad5d-ebc83f2417a9,posted,Home Improvement Store Purchase,-2318.27,aa5483a4-ca84-4549-a49a-d2faacca3dd8,1552.25,debit,bank-fee,AU00000,2023-06-14T02:59:17Z
transaction,8bbe881f-3719-459a-9ab7-608eab7be591,posted,Mobile Phone Bill Payment,-2005.65,8cd31933-6a39-4a20-8102-89ee9aed043e,-453.4,debit,cash-withdrawal,AU00000,2024-03-27T12:26:09Z
transaction,eee2fbf1-416e-4144-a5df-1792fe34e634,posted,Uber Ride,-1495.36,9e3b7662-7afd-4457-8e68-b9cfcb94be12,-1948.76,debit,cash-withdrawal,AU00000,2023-08-30T06:12:59Z
transaction,bca92599-81d7-495d-be1a-7132a17cef7f,posted,Pharmacy Purchase,-1286.41,74c56823-0a54-4406-ac69-3324ab9983b3,8624.58,debit,cash-withdrawal,AU00000,2024-05-06T05:36:24Z
transaction,8eab6ae2-fee4-4426-b034-e55433bad2b7,posted,Gasoline Purchase,-3308.88,3f41e866-cde5-414a-b503-a521551509cf,5315.7,debit,bank-fee,AU00000,2023-08-28T19:14:42Z
transaction,776fa12e-99d7-4b27-b303-0fd7e6b87e3b,posted,AGL RETAIL ENERGY LTD (GAS),-3077.63,045e03b3-4b10-4207-8640-038036816e98,2238.07,debit,payment,AU00000,2023-09-13T02:58:15Z
transaction,f481417e-f434-4ed0-b0eb-873d003a08b5,posted,Electricity Bill Payment,-2510.65,b0a44e1b-4893-4f9d-9fab-0014badb8d55,-272.58,debit,bank-fee,AU00000,2023-05-13T06:13:20Z
transaction,5b1519ee-144e-4161-b4af-611771179485,posted,AGL RETAIL ENERGY LTD (GAS),-4426.87,e4b75018-f45c-4ade-953c-33d482aee979,-4699.45,debit,payment,AU00000,2023-06-08T20:23:40Z
transaction,9002a24d-948b-4515-aaa5-49efbde34ed3,posted,Restaurant Dinner,-912.72,a77b67fe-1dec-4c5d-a372-d5c9dc796348,-5612.17,debit,bank-fee,AU00000,2023-08-10T20:45:57Z
transaction,8054683a-aef1-4760-9346-829aa89df773,posted,Online Gaming Purchase,-3150.84,87bcb5b8-83d2-4a72-8152-7d82f5606770,-8763.01,debit,cash-withdrawal,AU00000,2023-10-17T22:54:16Z
transaction,34634a18-3217-44ec-8856-bd635793db0f,posted,Clothing Store Purchase,-3601.44,3fbf30fd-fdc3-43d7-ab63-16455a49b782,-12364.45,debit,payment,AU00000,2023-12-06T15:32:03Z
transaction,adbad749-9bec-479f-bc32-30c4fc3001db,posted,Coffee Shop Purchase,-1499.72,0bd30696-4102-4937-951d-a0fbd6e89d84,-13864.17,debit,bank-fee,AU00000,2023-11-19T13:14:03Z
transaction,7dbdd557-9afb-4113-9200-b2ae35c59dba,posted,TFR Acc14000 TO 12389,-1254.09,20927555-8bd8-4c79-87c2-2ef45f0aa6a6,-15118.26,debit,payment,AU00000,2023-08-24T09:24:25Z
transaction,239b774d-a121-43f1-b68b-f2f7e246616d,posted,Electricity Bill Payment,-2377.94,48b663f8-bfe6-427e-a455-ea5c1379b510,7653.54,debit,payment,AU00000,2023-10-17T09:15:26Z
transaction,c6b0dd06-c987-419a-af98-c9201ef3b6e7,posted,Car Maintenance Expense,-4016.25,d6aef253-161a-43a8-b79a-a8764cccb0e6,3637.29,debit,cash-withdrawal,AU00000,2023-11-03T08:59:56Z
transaction,e6469897-58c1-4cd6-8d75-3d6620d6c2fc,posted,Non Hooli ATM Withdrawal Fee,-771.36,838b922e-6d57-421b-9350-8eb95625bd93,2865.93,debit,bank-fee,AU00000,2023-07-16T23:33:31Z
transaction,244ce333-ba9d-44dc-bb8b-401cf08ca02f,posted,Electricity Bill Payment,-304.45,80a8f7ba-7f2a-4a82-b058-87d10d7f4570,2561.48,debit,bank-fee,AU00000,2023-05-13T08:22:02Z
transaction,ca46d553-cb05-4e58-b026-9b666737a4b8,posted,Coffee Shop Purchase,-1766.83,8100d976-6be5-4b52-8789-dd92b29205cb,794.65,debit,cash-withdrawal,AU00000,2024-01-02T20:32:52Z
transaction,7351ea94-9531-4dd3-9217-fc7d2154136b,posted,Bookstore Purchase,-1834.46,b5066946-b54f-48b3-b7eb-adcc7b1b7e38,-1039.81,debit,bank-fee,AU00000,2023-12-20T11:43:24Z
transaction,8f1aacaf-7990-4b72-aa7b-a05af92afe5e,posted,Coffee Shop Purchase,-843.71,4e7481db-bb5f-4ade-8b9c-ab484659d313,-1883.52,debit,payment,AU00000,2023-06-09T07:59:21Z
transaction,e263eabb-3335-4c74-af91-e2988542be00,posted,TRANSFER TO JOANNA SMITH CAMPING,-2072.89,aeaa895d-0e3a-4297-8380-b95ec375d365,-3956.41,debit,payment,AU00000,2023-10-03T17:03:02Z
transaction,d69d5351-cbcf-46bb-9e5a-a5a09eb77342,posted,Gasoline Purchase,-2214.37,0efc1789-17e9-4016-8bef-00e6bd8d89a1,-6170.78,debit,payment,AU00000,2023-10-31T23:13:46Z
transaction,fddb7b83-66bd-452e-8890-132e64112392,posted,CTRLINK CARERS Ref: 998R6789201610974V,-4648.31,a0ee7693-87e2-4f31-9f0c-0cb114b23c14,-10819.09,debit,bank-fee,AU00000,2023-08-24T09:09:13Z
transaction,4f94561f-acfd-4fb9-9e03-9020d1c15a90,posted,AGL RETAIL ENERGY LTD (GAS),-1240.43,c06f1515-38dc-4ee0-ba73-b390c62f9b39,10205.85,debit,cash-withdrawal,AU00000,2023-10-30T22:37:30Z
transaction,4dd646b4-94e7-49d7-92b0-bf43ac576f81,posted,Hair Salon Appointment,-956.18,16105569-dec5-4c8f-97fa-179a937eb287,9249.67,debit,payment,AU00000,2023-05-13T10:29:17Z
transaction,b47244a1-77b4-4460-a9f6-fc7194bac76f,posted,Car Maintenance Expense,-3131.2,e39af33e-5d58-4f3d-a47d-61dbe6645fd7,6118.47,debit,cash-withdrawal,AU00000,2024-01-11T20:14:12Z
transaction,8e09443a-22c4-4c34-bded-3867b0e96c19,posted,Travel Agency Booking,-319.23,fb40c5b9-b3fa-400f-abdc-d1ae519fbfce,5799.24,debit,bank-fee,AU00000,2023-07-03T15:24:03Z
transaction,27dff1f2-f874-45ae-87e2-a94adf8ec725,posted,TRANSFER TO JOANNA SMITH CAMPING,-2923.05,65c51b2b-d7d0-4067-a398-214eb6b18c3e,2876.19,debit,cash-withdrawal,AU00000,2024-03-12T11:52:03Z
transaction,63bc8d70-7097-4e20-b53a-690dd6fa16e9,posted,CTRLINK CARERS Ref: 998R6789201610974V,-3579.36,ef4fb75b-0eb5-40c1-a02f-78ebefaa7a31,-703.17,debit,cash-withdrawal,AU00000,2023-06-25T06:32:09Z
transaction,75277da5-355d-4706-9fc9-8cbbfaf85768,posted,Wdl ATM WESTPAC IGA BALGOWLAH BALGOWL AU,-1800.5,bd551700-095b-4785-a86b-2e5790f27937,-2503.67,debit,bank-fee,AU00000,2024-01-18T16:31:31Z
transaction,db3a7d3b-dcaf-476a-b4fb-5cefa1491c19,posted,Gasoline Purchase,-2092.85,57627816-9a7d-415d-99fa-783c5b2b1aa3,-4596.52,debit,bank-fee,AU00000,2023-07-26T20:23:19Z
transaction,0b236d54-fd61-4790-a10e-c44adc4ab38f,posted,Clothing Store Purchase,-4871.17,7aa48f2f-2a79-45d3-9c7f-39b525b50dd4,-9467.69,debit,cash-withdrawal,AU00000,2023-05-18T21:01:24Z
transaction,01b60f19-e183-449a-b6e3-05d61fa06a77,posted,Gym Membership Fee,-10.43,8cc01bc1-79ce-4fca-a183-41d0feedcd58,-9478.12,debit,cash-withdrawal,AU00000,2024-04-22T13:59:34Z
transaction,f95b2246-4f77-4fa4-94e9-5603fb365aad,posted,Electricity Bill Payment,-3852.04,2427f0d4-3033-41d5-88e9-0e71cc7c17df,7248.69,debit,cash-withdrawal,AU00000,2023-05-23T22:22:56Z
transaction,f6441cf9-56dd-4c6f-9960-051497562e2c,posted,Non Hooli ATM Withdrawal Fee,-804.25,63ab6127-4b2f-40be-b711-8d77d792749e,6444.44,debit,cash-withdrawal,AU00000,2023-10-23T20:52:43Z
transaction,9bc49d22-3cd8-4e67-afaa-63eec1c8425f,posted,Car Maintenance Expense,-1373.49,f3b5d497-239a-4bad-b65e-fdd987a866c8,5070.95,debit,bank-fee,AU00000,2023-11-03T13:12:54Z
transaction,52e78a51-8fe1-4d1a-baea-f0cfe3de4f5b,posted,Movie Ticket Purchase,-3840.4,2a8c42ac-21ff-4c31-aa05-2a903c913da9,1230.55,debit,payment,AU00000,2023-05-12T18:48:45Z
transaction,7e238f99-4175-443b-b67c-5c1d1cac9558,posted,Payroll WFRMS 15439393,11731.85,614bdf58-e550-485f-9f05-9de74a82182f,12962.4,credit,transfer,AU00000,2023-07-04T11:47:11Z
transaction,c4048ee6-baaa-48e5-92fd-42a7d38cb481,posted,Uber Ride,-2899.0,506a5597-40a2-4ad4-b301-0810c163de4c,10063.4,debit,cash-withdrawal,AU00000,2023-07-14T09:18:38Z
transaction,358a1ad2-7be3-493d-acfa-9606e81eb260,posted,Hair Salon Appointment,-2275.91,f3769201-578f-42b9-b81c-dab8781b2319,7787.49,debit,cash-withdrawal,AU00000,2024-01-12T15:08:35Z
transaction,8f5e417c-44c2-4078-a189-b2a008502d3f,posted,Mobile Phone Bill Payment,-101.2,17a10cbc-03f9-4454-b71a-fdb97f5be992,7686.29,debit,bank-fee,AU00000,2024-03-30T00:09:32Z
transaction,27ba09db-cb51-4771-92b6-c70954f5cedc,posted,Hair Salon Appointment,-1529.32,1fc7a598-79a7-4f34-bbbd-d68d6aed3031,6156.97,debit,payment,AU00000,2024-01-16T03:17:11Z
transaction,a29d4bca-2cce-4011-9d5d-73bcfcb38808,posted,Bookstore Purchase,-208.94,6eed78be-ebd7-4f13-971f-6384f045eb21,5948.03,debit,bank-fee,AU00000,2024-01-29T14:06:40Z
transaction,bed558af-a313-49f7-92b9-40e7c418b1e8,posted,Transfer Platnm Homeloan 346454,-962.08,2f015928-c033-4c23-8efe-ec6ec3bb0d47,15667.88,debit,cash-withdrawal,AU00000,2023-06-23T20:01:52Z
transaction,3fd078af-6200-44db-98c8-05bbbdd43638,posted,Wdl ATM WESTPAC IGA BALGOWLAH BALGOWL AU,-4250.99,af152db2-7661-4736-bc1b-0237b16b05ec,11416.89,debit,bank-fee,AU00000,2023-08-02T14:05:08Z
transaction,8dc4aee0-6511-48f4-89b1-26ead77f9e54,posted,Netflix Subscription,-1778.44,5b3a18d5-54f0-4313-8870-78d12f3af5b5,9638.45,debit,payment,AU00000,2023-10-16T17:36:04Z
transaction,a671c4e9-3a03-4664-a43e-e26eba117a99,posted,Car Maintenance Expense,-2105.7,14864f8b-4fa0-4208-a446-138362d0d63f,7532.75,debit,bank-fee,AU00000,2023-05-12T09:54:02Z
transaction,eb61275b-e4cf-4c88-a09a-c69a3646abed,posted,Music Streaming Subscription,-4727.88,a801c554-21b2-40a5-a022-4684c3af9312,2804.87,debit,bank-fee,AU00000,2024-03-31T16:16:43Z
transaction,6c69edff-44cb-42fb-9a97-d089fa66c3aa,posted,TFR Acc14000 TO 12389,-2600.52,118a3835-7592-4309-be60-91717bd489ab,204.35,debit,payment,AU00000,2023-10-13T10:51:21Z
transaction,2b3be9fc-1ac0-4a7c-9412-66dbea684b47,posted,Home Improvement Store Purchase,-4208.82,83387bc1-eee9-4f66-ae1b-4751cc548645,-4004.47,debit,payment,AU00000,2023-12-10T15:01:54Z
transaction,10a2877e-eefb-4bfa-9a88-cd313447df4e,posted,Coffee Shop Purchase,-1694.53,e816ee1b-67fc-4447-b174-2ef1997c5703,-5699.0,debit,bank-fee,AU00000,2024-03-03T00:26:28Z
transaction,c8001a2a-f1a4-4c9f-a338-b1d9c7e41cd0,posted,Bookstore Purchase,-166.8,0dae0f7f-3765-499d-ac69-84ff75be39f8,-5865.8,debit,payment,AU00000,2023-10-09T21:07:49Z
transaction,b447ffc7-8d78-433d-b768-24643e76e8b6,posted,Coffee Shop Purchase,-2913.65,eebce907-1874-4220-a574-c648d7b27927,-8779.45,debit,payment,AU00000,2023-11-08T06:41:45Z
transaction,2b175c58-83d4-4217-85d1-1e0bbcf897ed,posted,Car Maintenance Expense,-4866.36,c6ceecb5-22e3-4bc5-bac3-bb607b0a913a,4437.45,debit,payment,AU00000,2023-09-10T18:16:53Z
transaction,534d07b5-39b9-458a-a437-fd1375ae71ef,posted,CTRLINK CARERS Ref: 998R6789201610974V,-2617.86,598d6186-41f1-4793-9f67-7981158e401a,1819.59,debit,payment,AU00000,2024-02-05T23:37:47Z
transaction,edcf17a1-d58c-4bb3-a2db-aae9d9975ae5,posted,Clothing Store Purchase,-1738.12,327f4746-d3c3-48a0-bfc0-7155b36bd9c2,81.47,debit,bank-fee,AU00000,2023-06-22T13:26:35Z
transaction,03e80e49-b2ce-4506-9d5d-50b8560cd356,posted,Hair Salon Appointment,-1436.2,941cd93e-b2bf-4b41-b997-48f88389832f,-1354.73,debit,payment,AU00000,2023-10-13T19:17:39Z
transaction,8fbcc119-e16f-4e14-b161-6a142921ae22,posted,Non Hooli ATM Withdrawal Fee,-3064.56,2b6adefc-0654-44fb-a9d0-d458a0b6cbee,-4419.29,debit,payment,AU00000,2023-06-27T21:50:38Z
transaction,d287bace-9ef5-43ad-ae5e-71ce200a517d,posted,Payroll WFRMS 15439393,11189.88,2f626bb7-6b9b-4e12-a5a9-75cc12c2b8e3,6770.59,credit,transfer,AU00000,2023-07-05T22:59:21Z
transaction,70c03776-be64-4add-83ec-20bbc530f835,posted,Payroll WFRMS 15439393,11777.9,8e1230ba-66fd-48a0-9a40-c04656ebef17,18548.49,credit,transfer,AU00000,2023-05-27T14:32:29Z
transaction,6f57adfd-c1b1-47e2-b7f7-31fcb1704424,posted,Payroll WFRMS 15439393,10370.75,6c28af69-a876-4f72-b6f8-22715ee6c1c9,28919.24,credit,transfer,AU00000,2023-06-09T03:40:07Z
transaction,7ecf24eb-959f-40dd-9bd1-c4f146457f0e,posted,TRANSFER TO JOANNA SMITH CAMPING,-26.17,9b99c243-00a5-43cf-b790-0cc7720015e7,28893.07,debit,payment,AU00000,2024-03-20T21:00:59Z
transaction,63ec8a8c-1dcc-4243-8db3-054b48b64bef,posted,TFR Acc14000 TO 12389,-3407.96,1b899442-351b-4164-b3d7-c515291bb95e,25485.11,debit,bank-fee,AU00000,2024-02-18T12:16:03Z
transaction,4d8c6e24-9fe1-41a4-b1a4-4e17d158b346,posted,Online Gaming Purchase,-642.91,3fde02c0-0eaf-4a8c-b7b4-9fe4b043e93c,9211.19,debit,bank-fee,AU00000,2024-04-08T09:24:07Z
transaction,1246aad2-468e-455e-82ce-096ef5a10851,posted,Travel Agency Booking,-2216.05,b93824c2-b428-4364-81f4-b5218e2dcc93,6995.14,debit,cash-withdrawal,AU00000,2023-09-25T09:07:17Z
transaction,90078d6a-648e-445d-9f18-a25c09d8b4e2,posted,Amazon Online Shopping,-2314.27,f8da7146-eab1-49b3-8654-ae43929f5445,4680.87,debit,bank-fee,AU00000,2023-11-26T22:43:59Z
transaction,72548139-75d9-43ef-a05c-3e03b80899ae,posted,Payroll WFRMS 15439393,10479.89,cefd169b-6926-44dd-b593-a458ea02a7bb,15160.76,credit,transfer,AU00000,2024-03-14T11:36:54Z
transaction,1fcaf965-05be-41b9-a954-6ea7edf9f18c,posted,TFR Acc14000 TO 12389,-988.45,9edbc525-e852-4f4c-a06a-26d7b2c1c28f,14172.31,debit,payment,AU00000,2023-07-09T21:39:20Z
transaction,39364baa-b07e-40c8-9ef5-4072b51b6925,posted,Public Transport Fare,-1258.39,121f520f-9553-4c54-9738-0db6408b48b6,12913.92,debit,bank-fee,AU00000,2023-12-06T07:37:34Z
transaction,24b32520-3caa-4b51-8b62-8f4ccd4bf064,posted,Manly Maths Tutor Wages,-4991.38,f69a2f5d-e502-4093-b160-e195253889b1,7922.54,debit,payment,AU00000,2023-06-20T17:14:05Z
transaction,884993ef-4ed1-47a7-8128-8dea91e14b24,posted,Electricity Bill Payment,-623.83,d87ebe0a-b26e-44e4-8203-89b3d47cc68d,7298.71,debit,cash-withdrawal,AU00000,2024-01-27T19:55:31Z
transaction,e661e430-128f-4ffb-b6f1-1334d772d403,posted,Mobile Phone Bill Payment,-3816.34,214631a2-ae92-4752-83d5-921769e0d2a5,3482.37,debit,cash-withdrawal,AU00000,2024-03-08T09:50:37Z
transaction,8ab7ddf3-b797-4eb4-bdd1-c58090dfe82f,posted,Transfer Platnm Homeloan 346454,-3343.21,7fbb2ef2-4712-49c4-aba5-b348b255bc1f,139.16,debit,payment,AU00000,2024-04-10T02:29:32Z
transaction,42af3011-2be1-449c-bfd2-5e96a23737d6,posted,CTRLINK CARERS Ref: 998R6789201610974V,-2458.42,75c4fdc3-8061-4358-80f3-4cf1a985d4b4,13305.74,debit,cash-withdrawal,AU00000,2024-04-03T21:12:02Z
transaction,9909c2bc-82c2-4c8a-9ded-eaa63c268be3,posted,Travel Agency Booking,-2192.4,01d93477-326e-4ea2-9f98-6b9b5e9a7dbd,11113.34,debit,payment,AU00000,2024-03-15T20:38:38Z
transaction,1aacd6c9-282b-4915-85ca-88386d686fb4,posted,AGL RETAIL ENERGY LTD (GAS),-3290.87,0422e355-b341-43a4-9639-ddf1450099ad,7822.47,debit,bank-fee,AU00000,2023-05-31T02:43:28Z
transaction,1d569153-6bee-46dc-88ad-c1eaa58a457d,posted,Gasoline Purchase,-3143.94,81dff4f4-0f26-4c13-abb5-4d51442e5486,4678.53,debit,cash-withdrawal,AU00000,2023-07-10T16:05:43Z
transaction,eea86548-608b-4868-9849-68475085fd38,posted,Clothing Store Purchase,-1832.26,99f4402d-3887-44e5-95b3-b6333228bd37,2846.27,debit,cash-withdrawal,AU00000,2024-03-06T10:44:53Z
transaction,06ccfed9-06d1-4711-8ee4-ad5869c43007,posted,Music Streaming Subscription,-3568.76,4082d3c1-c8de-49d0-8479-e1588d7ccab8,-722.49,debit,cash-withdrawal,AU00000,2023-05-21T21:11:58Z
transaction,33c5c966-5b48-4354-8b49-25150074f6d2,posted,TRANSFER TO JOANNA SMITH CAMPING,-697.96,b7891bf9-dab6-4f2b-9950-78bd14fc42af,-1420.45,debit,bank-fee,AU00000,2023-06-11T07:33:53Z
transaction,95ea34e5-eb7d-4660-92d4-f903e83fb769,posted,Amazon Online Shopping,-4477.5,f389e900-763d-4792-ad68-edc4a6f0dd79,-5897.95,debit,cash-withdrawal,AU00000,2024-02-13T07:30:21Z
transaction,33a01861-4a48-45a5-a6ed-9ae42a0babe9,posted,Gym Membership Fee,-3264.69,ff02fc87-53ab-4c6e-aa59-5aefd46ee647,-9162.64,debit,payment,AU00000,2024-03-08T10:36:13Z
transaction,81042aa9-4c79-47a0-bb27-52e9f6ac85e1,posted,Pharmacy Purchase,-277.74,d301f41b-cc92-4160-adea-e86729653822,-9440.38,debit,cash-withdrawal,AU00000,2024-01-14T15:37:54Z
transaction,84194f28-e7e3-4122-9119-83a84a79c5ae,posted,Non Hooli ATM Withdrawal Fee,-3784.57,760f41d7-3ee8-4dd7-aae8-8f0921c60379,3381.99,debit,bank-fee,AU00000,2023-12-26T06:07:31Z
transaction,48561a58-49d3-4297-a741-ecff93cf79d9,posted,Movie Ticket Purchase,-3465.02,ec78feab-8f5d-40d4-b721-221174d3ba4f,-83.03,debit,payment,AU00000,2023-12-23T08:13:59Z
transaction,427efdb1-6b72-4bf7-811a-8f94772f1372,posted,TFR Acc14000 TO 12389,-1911.55,4d0933f1-69f6-47f8-b15b-20ff3ceb46c5,-1994.58,debit,payment,AU00000,2023-11-23T14:57:09Z
transaction,14c83a86-9ae7-4e17-9746-59f40df94206,posted,Coffee Shop Purchase,-2862.84,31c69f98-8b00-43fa-b496-0fdec35f619a,-4857.42,debit,payment,AU00000,2023-12-15T12:08:56Z
transaction,9ed229fb-6992-4a53-92d8-90f495d278fb,posted,TFR Acc14000 TO 12389,-3699.72,17fb070f-dd3a-49be-a0c4-41c5b2de0287,-8557.14,debit,payment,AU00000,2024-04-08T23:30:01Z
transaction,3d6beb1e-0df6-4d0d-86fd-118a221a8789,posted,AGL RETAIL ENERGY LTD (GAS),-4527.34,7be67cb7-cf4e-4084-9226-9a6c603f32ce,-13084.48,debit,payment,AU00000,2023-06-18T01:55:01Z
transaction,98eb2390-ab76-4755-92c7-c49c58575313,posted,Mobile Phone Bill Payment,-4425.95,7d028c0b-0eae-404d-b3d5-32ca55293e82,-17510.43,debit,bank-fee,AU00000,2024-03-30T06:19:47Z
transaction,66dbb42f-eba4-4d40-a593-84efac406a2a,posted,Restaurant Dinner,-3092.92,40901eab-acdf-4ff9-bc46-2410d7bcb984,-20603.35,debit,cash-withdrawal,AU00000,2023-09-02T01:30:04Z
transaction,eb5f336e-dde4-482c-92a3-da38c962c4d4,posted,Public Transport Fare,-563.55,3ea40854-1e07-4a67-97f0-5fd43c4c360b,-21166.9,debit,payment,AU00000,2023-07-12T07:28:25Z
transaction,1f6157a6-cb42-4d66-a9a3-febaae6fa734,posted,Hair Salon Appointment,-3787.34,64cc4987-aea4-42b6-a4fd-a1637d035c8c,-24954.24,debit,bank-fee,AU00000,2023-05-13T13:40:07Z
transaction,4089ae26-d8b2-47d1-8fab-f636a63c16a1,posted,Bookstore Purchase,-3162.99,9cb1c289-ec09-43da-bd59-b530881c038a,4924.48,debit,cash-withdrawal,AU00000,2023-10-14T11:10:28Z
transaction,f826d8ed-5017-4fad-9538-b760a9d02cf1,posted,Coffee Shop Purchase,-4187.22,51461162-e9c5-403a-b015-26cc8b375844,737.26,debit,cash-withdrawal,AU00000,2024-05-03T03:00:59Z
transaction,43c4a373-2ed5-4750-a99c-fbe638a2fed5,posted,Movie Ticket Purchase,-1920.29,575b44dd-9485-4ec8-9cb6-88031fb6409d,-1183.03,debit,payment,AU00000,2023-05-21T17:55:03Z
transaction,aeebe820-0db8-40d7-a1a9-e420e4986544,posted,Amazon Online Shopping,-4540.7,2397ffa7-2f41-4bbb-bfd7-279392ca79f2,-5723.73,debit,payment,AU00000,2023-08-13T03:53:44Z
transaction,f197df77-96e6-4fa6-aada-499b06147051,posted,Electricity Bill Payment,-2528.81,1b4d51da-144a-47cd-b68e-56172524024a,-8252.54,debit,payment,AU00000,2024-02-22T06:33:07Z
transaction,809f05e3-219d-4157-9227-13184b505cbe,posted,Bookstore Purchase,-1335.33,3c3092a3-d38b-4bff-8ccb-33431bc16f36,-9587.87,debit,payment,AU00000,2023-08-26T11:34:11Z
transaction,a602339c-3a47-4025-b303-ad4259b7a1d6,posted,Amazon Online Shopping,-961.64,ebf45a8b-02f5-443a-886c-23cddf44f577,-10549.51,debit,payment,AU00000,2023-08-31T22:32:29Z
transaction,4a1c04ee-a3e5-4c29-8ebb-d41f7acad470,posted,Manly Maths Tutor Wages,-3897.51,e7ee1478-c643-4a43-93f4-3279a60f5a86,-14447.02,debit,cash-withdrawal,AU00000,2023-08-30T19:20:04Z
transaction,c12e4403-3979-4592-a179-e2fceb082a43,posted,Gasoline Purchase,-4259.94,70aac530-0248-43e4-987d-84542f63942a,-18706.96,debit,payment,AU00000,2023-08-23T19:33:48Z
transaction,d1fa28d1-aa7a-473b-b99b-72f68d1f0168,posted,Car Maintenance Expense,-3511.03,719abb00-68cf-4115-84f2-0b9831c50d05,-22217.99,debit,bank-fee,AU00000,2024-02-11T07:44:17Z
transaction,27c453c5-5a86-47f7-ae61-11b3feb13e5f,posted,Online Gaming Purchase,-1704.33,99f95cae-d742-4dc4-a559-551eba223597,13290.17,debit,bank-fee,AU00000,2023-09-13T12:36:27Z
transaction,d424549e-2ddd-404b-b110-cafd3c88e39d,posted,TFR Acc14000 TO 12389,-2223.34,d56165b4-5ba8-4b17-97d8-40b8cb48fb9e,11066.83,debit,payment,AU00000,2023-06-23T22:40:23Z
transaction,ce4e84f2-4f40-4e7f-b855-791ca867b69f,posted,TFR Acc14000 TO 12389,-3669.26,8298d9f5-56d0-48e9-bfb3-335029d62eee,7397.57,debit,cash-withdrawal,AU00000,2023-10-07T09:56:31Z
transaction,d70296b4-4c8c-4f30-9d8e-5d71e5cc6c7d,posted,Manly Maths Tutor Wages,-1566.85,8e42f5b5-00af-4e48-92cd-f55443c73b86,5830.72,debit,payment,AU00000,2023-11-19T19:06:20Z
transaction,401b1fcc-9836-4ba4-a702-7ace7a3a70f6,posted,Travel Agency Booking,-3563.47,a87c56f0-d137-41f9-9265-7cd41c78aef5,2267.25,debit,payment,AU00000,2024-01-15T15:38:49Z
transaction,e0923ae1-5c06-4222-80ae-48cd6fd59d6f,posted,Gasoline Purchase,-3129.1,e76dfcb0-ef20-4051-a059-f6311d897685,-861.85,debit,bank-fee,AU00000,2023-09-09T22:49:15Z
transaction,00aa2085-947c-48ba-86c6-d952508a4224,posted,Bookstore Purchase,-129.45,71624cc9-c3cc-4317-bc86-272178baca61,-991.3,debit,cash-withdrawal,AU00000,2024-05-04T08:44:05Z
transaction,8f24d04d-60b4-4239-8c22-1e874b851606,posted,Pharmacy Purchase,-4910.06,60a0e39b-f1b7-41e2-85ea-b344f8dd142f,-5901.36,debit,bank-fee,AU00000,2024-03-26T09:26:30Z
transaction,73025612-cced-4960-b8b8-c02688c8077e,posted,Bookstore Purchase,-108.23,c1cabc6c-cd6f-4a81-9442-6466ee8d851c,-6009.59,debit,cash-withdrawal,AU00000,2024-04-24T05:24:45Z
transaction,03ca3cd1-82e2-4ffc-a6bd-9b147111bb9e,posted,Travel Agency Booking,-2188.07,55937285-46c4-437b-9304-03a126b28010,-8197.66,debit,bank-fee,AU00000,2023-12-17T16:00:54Z
transaction,24362110-f816-4b08-b845-4874d6d1978d,posted,Clothing Store Purchase,-2009.15,e2f0274f-8e68-4c85-8c82-e5b707d00eed,4566.61,debit,bank-fee,AU00000,2023-10-08T20:41:15Z
transaction,860821e4-e07f-4551-a6cb-c294d0ea203a,posted,TFR Acc14000 TO 12389,-2761.47,8dd0cb88-0fb7-4b19-bb4a-26103bdab867,1805.14,debit,cash-withdrawal,AU00000,2023-11-04T11:37:56Z
transaction,7245273f-b653-4a87-a312-cdbf29a35c04,posted,Hair Salon Appointment,-3643.07,245ec7b2-f663-4a58-85c2-76a49d4abee1,-1837.93,debit,bank-fee,AU00000,2023-07-17T16:59:10Z
transaction,f617e831-bf0f-430d-b262-1be80516ad49,posted,Clothing Store Purchase,-4361.49,88813669-b08b-41eb-8ba6-302b835148e3,-6199.42,debit,payment,AU00000,2023-10-06T17:09:55Z
transaction,be19b429-f3e5-4fa3-b178-1b412167123f,posted,Music Streaming Subscription,-3886.24,84fee05a-d52b-430b-9be9-5fb9528e33f6,-10085.66,debit,cash-withdrawal,AU00000,2023-10-16T00:40:24Z
transaction,658210fc-682a-4862-a593-2fa49996ed1d,posted,Non Hooli ATM Withdrawal Fee,-3088.56,5af6007f-3d8c-47c8-8b70-69216218a168,-13174.22,debit,payment,AU00000,2023-08-04T03:38:56Z
transaction,6e2d3c03-6c57-494a-a681-c9429be44cf0,posted,Music Streaming Subscription,-3540.2,e98bf7ed-239f-43f1-9480-37ef47563be2,-16714.42,debit,payment,AU00000,2023-09-21T14:39:29Z
transaction,20849bef-dcb5-4831-8478-54533af10b1e,posted,Hair Salon Appointment,-1568.18,78a711fa-393a-4c01-9ed9-2e0b3a0df5f5,-18282.6,debit,cash-withdrawal,AU00000,2024-02-12T07:28:57Z
transaction,e070d24f-6a4e-49f5-bb70-e15bf1ae3c50,posted,Transfer Platnm Homeloan 346454,-4219.32,eec11429-1719-494b-9c4d-b8f82d9a5238,-22501.92,debit,payment,AU00000,2023-11-22T11:14:42Z
transaction,4202904d-f82a-4458-be11-4c4d471c104a,posted,Gasoline Purchase,-670.64,5b96b01d-92b0-4563-bafd-be168166c8b8,-23172.56,debit,payment,AU00000,2024-03-20T17:08:50Z
transaction,e2edf2d6-19c9-4459-b194-e605ef1ebd42,posted,Hair Salon Appointment,-437.32,ac603067-02b7-4fe8-a037-a90562eb4e11,14674.17,debit,bank-fee,AU00000,2024-03-08T16:23:16Z
transaction,b34a1fb5-5ed2-490f-9007-1998315e3b6d,posted,TRANSFER TO JOANNA SMITH CAMPING,-2416.19,32b57aeb-bccf-434d-a72a-c55f91ba6434,12257.98,debit,cash-withdrawal,AU00000,2024-01-03T22:57:30Z
transaction,1b238969-fd63-47c3-ac3e-b5f7b0cadf67,posted,Clothing Store Purchase,-36.86,d3ac9d31-2370-4ff0-8611-3e7cc2524b5b,12221.12,debit,payment,AU00000,2024-01-10T08:46:35Z
transaction,0866b688-1cc9-4354-b4b8-8012fbda0819,posted,Gym Membership Fee,-3601.1,bf04fd58-9f52-4fad-ba70-73e6da99b4b9,8620.02,debit,payment,AU00000,2023-08-25T04:29:34Z
transaction,221be2b5-3321-4f7a-838f-0dd986424228,posted,Uber Ride,-913.72,ca674295-de8a-4cf4-8be9-7f3473506cc3,7706.3,debit,bank-fee,AU00000,2024-01-19T21:19:10Z
transaction,ec9ec42e-9186-47ea-b038-de39c71ead99,posted,Gym Membership Fee,-61.27,ddee49ea-7575-4f4f-8d69-38cf435f6b8b,7645.03,debit,bank-fee,AU00000,2024-02-08T13:13:28Z
transaction,235736c0-f93d-4734-8269-60dda8f976ca,posted,Home Improvement Store Purchase,-2215.06,be60f55c-b7ff-4183-848a-cb9a13d60933,5429.97,debit,cash-withdrawal,AU00000,2023-07-16T00:22:40Z
transaction,fe4e2486-b12b-42e5-b942-7c3d4ea2704b,posted,Car Maintenance Expense,-1965.56,90421a9d-ff9f-449d-9f99-05dd082201ba,3464.41,debit,cash-withdrawal,AU00000,2023-09-29T05:06:13Z
transaction,e35b1dd6-f30a-4707-a868-cbf409e255a0,posted,Public Transport Fare,-4671.0,b27d9366-cb82-43aa-93b4-f7d71a694782,-1206.59,debit,bank-fee,AU00000,2024-01-28T08:00:30Z
transaction,d21acd72-15d7-4c0d-96f7-7522f870bbfd,posted,Netflix Subscription,-2629.31,92d7cd6a-be3d-431c-be0f-fc2e556ef75e,-3835.9,debit,cash-withdrawal,AU00000,2024-02-03T14:34:04Z
transaction,6f6ecee8-c9c9-4827-9f39-1bf5764cad34,posted,Netflix Subscription,-3089.69,04077dc6-d4c2-43fd-bd65-ee8fd6b0e46c,5594.93,debit,bank-fee,AU00000,2023-07-15T07:28:55Z
transaction,19f21def-331d-4b9e-b764-5f5d4cec7f98,posted,Payroll WFRMS 15439393,10604.69,c64745a6-8e35-46b0-b93f-fa29d50056fc,16199.62,credit,transfer,AU00000,2023-10-07T11:21:20Z
transaction,947b9215-2bb0-46d8-a4bc-4ac4aa2fcc5e,posted,Gasoline Purchase,-2853.36,fa4c72df-132f-4b33-945b-e0f31c7cc6dd,13346.26,debit,cash-withdrawal,AU00000,2024-04-19T12:18:41Z
transaction,68f54452-7359-4054-9623-9d41c727d6f4,posted,Manly Maths Tutor Wages,-4796.08,705fc60c-884a-4836-b9cd-412adde08ad3,8550.18,debit,bank-fee,AU00000,2024-02-06T23:05:40Z
transaction,aa77373d-b3a8-470e-ade3-053c50be2aa1,posted,Movie Ticket Purchase,-2639.88,e5dad619-be91-4c01-bcb1-a6bb62b3d7a7,5910.3,debit,cash-withdrawal,AU00000,2023-06-15T12:01:26Z
transaction,6c2a9e7c-a282-47cf-878a-dade3a9f61cf,posted,Car Maintenance Expense,-3330.08,522e1de3-ac51-444e-9108-70a2db3aaf3a,2580.22,debit,cash-withdrawal,AU00000,2023-10-24T14:31:11Z
transaction,633f7dac-62fd-46de-b51e-9b1273358772,posted,Uber Ride,-2479.6,4a221772-f6ed-474b-99b6-01df3f286e9e,100.62,debit,payment,AU00000,2023-11-08T01:35:34Z
transaction,ae6cedab-4bf8-4730-8ab9-dec12b63b007,posted,Coffee Shop Purchase,-1244.86,970f4622-24e5-4427-a7a6-f4710ab96940,-1144.24,debit,payment,AU00000,2023-11-14T20:13:50Z
transaction,d1080a77-0d74-4bcd-a72d-9fe84a039920,posted,Car Maintenance Expense,-591.43,d2ffb703-7c65-4cdc-a4c2-9bf7b8cbd8ac,-1735.67,debit,cash-withdrawal,AU00000,2023-11-27T19:13:34Z
transaction,e463a7e5-3683-4ce6-9ace-f71de4f30233,posted,Payroll WFRMS 15439393,11293.42,9f8b630b-fb11-432c-8d00-d90b9dc81b66,9557.75,credit,transfer,AU00000,2023-06-25T13:03:49Z
transaction,ebf6e070-76de-4443-bfad-e29fef00dfe8,posted,Restaurant Dinner,-4077.73,9a731f6a-c083-4020-aae7-ef0e766d1667,5845.62,debit,cash-withdrawal,AU00000,2023-12-21T20:45:30Z
transaction,f664f64f-7de4-444e-ac26-a2b3bb5d4035,posted,Clothing Store Purchase,-1471.62,84cf5f73-82be-472d-8824-682f2da7c416,4374.0,debit,bank-fee,AU00000,2023-09-23T06:12:52Z
transaction,7d120e95-6f95-4294-a278-d8ef8181d60a,posted,Home Improvement Store Purchase,-4492.54,9ebe8f99-3a1b-4426-aff9-1f14a66f8119,-118.54,debit,payment,AU00000,2023-08-18T16:52:17Z
transaction,7ccc7b19-0f93-43bc-b290-f1ca91c7e219,posted,Manly Maths Tutor Wages,-2748.18,d56a541c-14c7-4229-9fad-f42792c568e9,-2866.72,debit,bank-fee,AU00000,2024-04-03T13:08:27Z
transaction,8d8915ca-eff0-4ffb-8bdd-dea196c93ec4,posted,Payroll WFRMS 15439393,11003.08,1f20a3cd-2303-4ddb-bcfa-045fbf70dcba,8136.36,credit,transfer,AU00000,2023-10-23T14:36:58Z
transaction,8bce7e0b-8c7a-4a9a-ad00-e102c48d942b,posted,Clothing Store Purchase,-1533.08,4d4e7ffe-0219-4f47-b716-ce70413205d5,6603.28,debit,cash-withdrawal,AU00000,2024-01-21T13:32:42Z
transaction,d443a782-394b-4e10-9597-4931060467a0,posted,Movie Ticket Purchase,-4718.76,74cd6c41-125e-4339-a9a7-cac1a46abba8,1884.52,debit,bank-fee,AU00000,2023-11-03T02:24:21Z
transaction,d70d7d41-268e-47f7-87f6-907f20bd42a4,posted,Transfer Platnm Homeloan 346454,-4423.03,faa78d8f-d8ed-4bca-971f-f9e98882a942,-2538.51,debit,payment,AU00000,2024-04-04T22:05:43Z
transaction,d1110a34-0d00-4ab1-afa7-4ced3c11ef0e,posted,Music Streaming Subscription,-4139.05,a705e2e7-7e9c-4643-938c-2fecf0c94764,-6677.56,debit,bank-fee,AU00000,2023-11-09T13:14:06Z
transaction,e4032676-49bf-4329-82f4-321e2cabeef6,posted,Non Hooli ATM Withdrawal Fee,-2783.1,9c4e413a-09d5-4f1b-aa7c-27bb76a4fff1,-9460.66,debit,payment,AU00000,2024-01-21T20:56:09Z
transaction,ef08381e-561f-41c1-b9be-bb6d6b3d31f6,posted,Mobile Phone Bill Payment,-1649.38,1f7adac8-0645-44cf-8170-2226fe008b30,17639.03,debit,payment,AU00000,2023-07-05T23:37:15Z
transaction,727badae-9ec6-4eb7-9ec3-c2c8460ec8bb,posted,Travel Agency Booking,-4058.58,508e2090-bd66-40f0-987d-f0d9a8e0af8c,13580.45,debit,cash-withdrawal,AU00000,2024-02-16T11:30:41Z
transaction,f2e3fdba-6252-41e3-aff9-76b4c626b518,posted,Clothing Store Purchase,-4751.54,ddf00b4d-bc28-45fd-8982-00793c20216a,8828.91,debit,bank-fee,AU00000,2024-03-28T09:01:42Z
transaction,78bf7b2d-851d-4eff-b5ba-7e245d1c5f49,posted,Transfer Platnm Homeloan 346454,-3668.7,513b939f-892d-4008-98eb-4f4b209a25d4,5160.21,debit,payment,AU00000,2023-11-27T08:12:51Z
transaction,d1b226f1-754c-4bd8-b4b2-fd424505e6ef,posted,Mobile Phone Bill Payment,-2990.93,07b9ae82-9c8b-48e0-96cf-29e2d73ff934,2169.28,debit,bank-fee,AU00000,2023-06-26T16:33:22Z
transaction,3ff3968b-9285-4247-a37f-9cad1eca31b4,posted,Payroll WFRMS 15439393,10285.66,7d118022-7a4d-4173-aa68-e657f832bc52,12454.94,credit,transfer,AU00000,2024-01-24T13:16:24Z
transaction,6c6fca36-b0c0-425d-b31e-69c19e6d6c77,posted,Clothing Store Purchase,-825.79,8287d779-6a74-44e4-8ca3-448d7f408659,11629.15,debit,payment,AU00000,2023-06-16T10:59:26Z
transaction,e8d5e340-075b-4ae2-a016-c70071cb69b1,posted,Home Improvement Store Purchase,-1827.08,fd5b56fe-0042-4230-a0a3-9f4aee4aa3e3,9802.07,debit,payment,AU00000,2023-10-05T19:01:24Z
transaction,f72944f0-61bf-46e9-847e-88469e0a0dc5,posted,Gym Membership Fee,-1741.15,e2e6b96e-1b83-4e6f-9c3f-bc710380dc1c,8060.92,debit,payment,AU00000,2023-05-17T17:15:24Z
transaction,9a792951-4adf-42f6-804c-f01f4fcdf3df,posted,Movie Ticket Purchase,-3561.51,026cecbb-d86e-4c09-a25c-c4253647d5d4,4499.41,debit,bank-fee,AU00000,2023-08-14T18:43:35Z
transaction,b5cbd83d-0c23-4ce0-9d97-2db50dae1f25,posted,Coffee Shop Purchase,-2064.28,e39beb91-c3ba-4eaf-be9d-644aae88dea7,3222.04,debit,payment,AU00000,2023-07-01T10:30:52Z
transaction,65815960-07fa-4dff-b862-125bb10459e3,posted,Hair Salon Appointment,-2951.47,c2797fba-f334-45f0-9c61-4b1778164419,270.57,debit,payment,AU00000,2023-06-09T10:49:34Z
transaction,64808771-a3f4-4d15-848a-70a752e382e2,posted,Hair Salon Appointment,-2100.57,3f79e503-5a16-41fe-aaba-c2481af43db5,-1830.0,debit,payment,AU00000,2023-12-08T09:39:25Z
transaction,955046ac-8824-4727-98c0-e7a5f6124552,posted,Manly Maths Tutor Wages,-4351.15,563cb4e9-2e60-4ac8-9205-934d32b90ed3,-6181.15,debit,bank-fee,AU00000,2024-01-04T22:11:22Z
transaction,245ce467-4753-4391-b4ed-77b8a971415b,posted,Netflix Subscription,-3987.22,8415d25c-de20-4da6-9891-62c15af2bc68,-10168.37,debit,payment,AU00000,2023-07-22T08:00:13Z
transaction,3e2555e2-2595-4194-9dbf-dfa43e2261dd,posted,Mobile Phone Bill Payment,-1782.01,8631757a-e582-41ac-a830-952774ea1df7,-11950.38,debit,payment,AU00000,2024-01-29T14:22:48Z
transaction,f2304815-4db3-4ac5-af07-d071a1a6ed18,posted,Clothing Store Purchase,-859.19,9fd9287f-6c22-4b1c-8a65-39bb50bc9c5b,-12809.57,debit,cash-withdrawal,AU00000,2023-06-04T10:52:33Z
transaction,1189aff7-de89-4d87-a08f-e021f5f91a66,posted,Hair Salon Appointment,-1013.54,780507df-4d04-41b6-9e1a-94e687f087e9,-13823.11,debit,cash-withdrawal,AU00000,2024-04-26T17:44:58Z
transaction,8927b6d1-becc-4539-b383-99f19919404f,posted,Non Hooli ATM Withdrawal Fee,-9.22,d30828b1-75a6-49d2-8e62-b1da2e28438a,-13832.33,debit,payment,AU00000,2023-08-24T04:16:53Z
transaction,da528612-e24f-460c-9703-d0f8e00e5d18,posted,Non Hooli ATM Withdrawal Fee,-804.12,dc2d97c5-9b29-4ac7-b7e5-2ec7cbdb77e4,-14636.45,debit,bank-fee,AU00000,2023-12-23T20:54:18Z
transaction,b97e946f-5fda-4785-b7fb-dfeb7bac6f27,posted,Wdl ATM WESTPAC IGA BALGOWLAH BALGOWL AU,-3516.53,d6d5b0db-8126-46a2-be4f-48d3eb60e174,8731.78,debit,payment,AU00000,2023-05-25T02:15:31Z
transaction,65ee7987-efe0-49e9-978a-8f5aa1715232,posted,Coffee Shop Purchase,-732.87,209283bc-39eb-4873-9d99-c3876c841a94,7998.91,debit,cash-withdrawal,AU00000,2023-10-29T15:31:28Z
transaction,71908ac7-8987-458a-8eed-bdb15e0aea6a,posted,Pharmacy Purchase,-4850.8,b5ca5eb9-9700-4e7b-a377-322528f2cbfb,3148.11,debit,payment,AU00000,2024-02-21T09:26:07Z
transaction,ea2fc1c9-1df0-4fb5-90c3-a8d57cb88906,posted,CTRLINK CARERS Ref: 998R6789201610974V,-112.34,c011b634-2ef9-43ee-bc1b-493500852608,3035.77,debit,bank-fee,AU00000,2024-03-17T17:25:35Z
transaction,1d07b5a6-3f3c-4ec2-96ee-101e03c72d6d,posted,Bookstore Purchase,-858.61,1812d6aa-c3d7-4271-afd2-68699629b8c2,2177.16,debit,bank-fee,AU00000,2023-11-20T01:15:32Z
transaction,9e19431e-b141-4ec9-b216-fa42a7dcee87,posted,Coffee Shop Purchase,-2275.47,165419e4-5903-4c4c-a10e-3aaecc9cc589,-98.31,debit,payment,AU00000,2024-03-05T23:06:06Z
transaction,98dd4635-fe6f-4fed-834f-7f005af694a8,posted,Travel Agency Booking,-1674.43,f0b91e3b-29d6-42d1-9fd1-2b34c79011e0,-1772.74,debit,cash-withdrawal,AU00000,2023-06-12T03:47:32Z
transaction,6ce5815a-834e-4c38-a571-78dcba375eeb,posted,Coffee Shop Purchase,-2185.55,583aea64-5165-4c8b-8b3f-a052e1539f0d,-3958.29,debit,cash-withdrawal,AU00000,2024-01-12T19:25:00Z
transaction,2ebb8171-c2cf-4752-8f3a-e6fbbe36cf92,posted,Public Transport Fare,-637.75,07bf0292-fba2-4566-9d7a-30bb28dda7e6,-4596.04,debit,bank-fee,AU00000,2023-10-15T16:09:15Z
transaction,10755cdf-761f-4f29-90e5-cf1addc5b3b6,posted,Hair Salon Appointment,-4295.48,d2a4e4de-0650-4851-a6cc-159d68e927ec,-8891.52,debit,bank-fee,AU00000,2024-03-12T04:14:40Z
transaction,3f52612c-b65e-445d-959f-927bb9c6fdbd,posted,Payroll WFRMS 15439393,10531.76,7027e623-26d5-4237-9314-d834f5a53a26,18201.31,credit,transfer,AU00000,2024-02-19T21:23:40Z
transaction,a99fdd87-ddea-443e-b92b-16e80656c49f,posted,Gasoline Purchase,-4320.75,6b2e9443-5390-4403-ae2f-8499c3e803a0,13880.56,debit,cash-withdrawal,AU00000,2023-06-15T13:34:02Z
transaction,698bbf85-6b32-4766-8ef4-b401b3eb4f0c,posted,Manly Maths Tutor Wages,-914.04,7c5b66f4-dea5-4664-abbb-ee4ec1a2fc84,12966.52,debit,cash-withdrawal,AU00000,2023-06-09T02:40:32Z
transaction,0896df51-13c2-409e-8bf6-62858e5037ab,posted,Movie Ticket Purchase,-569.77,94b0aefc-8448-43e4-9615-026807302fbf,12396.75,debit,bank-fee,AU00000,2023-12-19T07:04:58Z
transaction,baa73193-e280-4726-b4fe-dedc127aac15,posted,TFR Acc14000 TO 12389,-302.24,44350f9d-d5e0-40ea-95d7-dc822972e9a3,12094.51,debit,bank-fee,AU00000,2024-02-03T09:16:34Z
transaction,e4ec7f8c-0555-4127-bfdb-b9b200abceee,posted,Restaurant Dinner,-88.75,8b50a778-d59f-49c2-a4b9-cd236e0fed86,12005.76,debit,payment,AU00000,2024-03-10T21:37:10Z
transaction,06d1aaf1-3cc2-433a-aeff-18ce1be33d39,posted,TRANSFER TO JOANNA SMITH CAMPING,-1589.59,51320680-e2a1-494a-bcad-da8739e0ab23,10416.17,debit,bank-fee,AU00000,2023-11-09T06:56:27Z
transaction,ba4bfa06-a107-4753-967e-a1735a5e4ee4,posted,AGL RETAIL ENERGY LTD (GAS),-4309.9,5ae19a44-3d87-4d15-886f-da1498c3d6b8,6106.27,debit,cash-withdrawal,AU00000,2024-02-14T16:36:47Z
transaction,24ca698c-9de1-4cd9-aeca-1430ac0ecaeb,posted,Wdl ATM WESTPAC IGA BALGOWLAH BALGOWL AU,-3821.09,1025e0ba-bda7-4d2f-9a23-4bdb802309c9,2285.18,debit,bank-fee,AU00000,2024-01-03T16:20:47Z
transaction,73b5dd6c-c0f4-4043-bf62-c0c86ac58c89,posted,Online Gaming Purchase,-1359.3,5b776cff-e5ef-4346-8b66-14e32526ef5f,925.88,debit,cash-withdrawal,AU00000,2024-02-06T14:50:21Z
transaction,3dd62f77-733f-4456-a963-a31edd9319f4,posted,CTRLINK CARERS Ref: 998R6789201610974V,-4106.26,c1407417-b731-4a39-826b-340bfb4aa485,3742.9,debit,cash-withdrawal,AU00000,2024-02-26T05:08:38Z
transaction,eb7fd1ad-531c-4125-a32d-44941b086a82,posted,AGL RETAIL ENERGY LTD (GAS),-2197.19,4ed4ada9-6591-4fea-8bec-112152cd904f,1545.71,debit,bank-fee,AU00000,2024-01-29T06:17:05Z
transaction,9169a598-1f1c-4492-87a0-12631bf415a1,posted,Music Streaming Subscription,-57.0,9984146a-1d02-4732-8577-ef4c64293a99,1488.71,debit,bank-fee,AU00000,2023-11-06T07:32:21Z
transaction,8916e1cb-3e81-4d9f-9908-b7ed8a822ba7,posted,Payroll WFRMS 15439393,11925.5,01764bc1-4906-424e-aa1b-71e24653318b,13414.21,credit,transfer,AU00000,2023-08-14T08:23:23Z
transaction,2f2250ff-05e0-4bbd-8cde-0ce2fadc666f,posted,Gasoline Purchase,-2903.38,de804485-667b-4175-80d6-fe7eff9444a5,10510.83,debit,payment,AU00000,2023-11-28T07:16:23Z
transaction,9d0d3432-5fe6-4ff9-83ac-7fe3cb53d18e,posted,Online Gaming Purchase,-1678.96,67b94293-2816-4cb2-a9f8-35471ff76329,8831.87,debit,cash-withdrawal,AU00000,2023-10-27T12:22:13Z
transaction,200560a2-790e-40da-9675-c5285e65197c,posted,Gasoline Purchase,-3568.26,a6070450-893b-4f70-b6a9-492415113d0a,5263.61,debit,payment,AU00000,2023-12-07T14:54:13Z
transaction,bb5b71c3-9add-4379-ae7e-06a843aa215e,posted,Restaurant Dinner,-1368.4,bbcb0e4c-edea-4141-a3b7-244558d8f02d,3895.21,debit,cash-withdrawal,AU00000,2023-06-16T05:15:27Z
transaction,2a4deb92-c11e-4a1e-a728-87cde597ef66,posted,Amazon Online Shopping,-958.83,3911a8dc-fb8a-485f-bd80-4226f9f61186,2936.38,debit,payment,AU00000,2024-04-25T00:28:04Z
transaction,eac77796-e21a-4b2b-9d33-c22fdc5a433e,posted,Restaurant Dinner,-3175.62,f17bfc47-5c77-4cf8-b5a3-4d9931c02225,-239.24,debit,payment,AU00000,2023-12-16T12:11:43Z
transaction,0527bb16-b733-425c-adcb-a2901db563be,posted,Restaurant Dinner,-3833.67,70036763-8d06-406b-8bc4-1aa8529dc225,13264.56,debit,bank-fee,AU00000,2024-03-02T09:52:13Z
transaction,58726748-5a49-4fa6-9e53-69c59f2e8c09,posted,Amazon Online Shopping,-1832.56,c8144eb2-8879-4b00-a9c5-3351e87c7ceb,11432.0,debit,bank-fee,AU00000,2024-02-15T18:19:26Z
transaction,949e2d50-f3e4-4bdf-a989-59b61796948e,posted,Gasoline Purchase,-3190.13,04233917-9ff1-4514-bc9d-b28b07dc6823,8241.87,debit,bank-fee,AU00000,2024-04-25T08:07:24Z
transaction,80929669-0ea0-4355-92ae-e769d4f37917,posted,Mobile Phone Bill Payment,-4310.99,fb5fd59d-cfe9-4aad-bdd8-81dcaadc60df,3930.88,debit,payment,AU00000,2024-02-09T15:05:28Z
transaction,2e35721e-7a32-4bda-840e-8021faad4de8,posted,Movie Ticket Purchase,-3547.7,bbb42ed2-1ffe-49ca-b8c6-313bcc53b343,383.18,debit,cash-withdrawal,AU00000,2023-07-03T09:31:28Z
transaction,11dd07e0-54e1-43ff-aec4-1e60df8d3fed,posted,AGL RETAIL ENERGY LTD (GAS),-423.13,1b61574f-c466-4d66-a2c9-5b1487f5a461,-39.95,debit,bank-fee,AU00000,2023-08-10T06:56:06Z
transaction,b9cdb353-5b63-44ec-baa3-8b399e6105a0,posted,Uber Ride,-1399.19,c823398f-7e76-4680-9e36-742338172f34,-1439.14,debit,payment,AU00000,2023-08-15T11:45:02Z
transaction,7fa9205d-d0c8-4cc5-a611-a332bd3b05c9,posted,Hair Salon Appointment,-4682.32,15c59d22-0426-4c16-b4f4-6152de3b7bc6,-6121.46,debit,cash-withdrawal,AU00000,2023-06-06T05:15:42Z
transaction,332a709f-ba29-4b28-a047-b9e73b05fad9,posted,Clothing Store Purchase,-977.9,f3c9da09-50c0-45f3-a947-847e0349cd42,-7099.36,debit,bank-fee,AU00000,2023-07-23T07:58:20Z
transaction,080dc93b-01ea-4d90-a9d7-29808191459f,posted,AGL RETAIL ENERGY LTD (GAS),-3280.18,b48eaa20-44c7-4fd9-b1e3-84adeb600426,-10379.54,debit,bank-fee,AU00000,2024-02-09T08:19:08Z
transaction,f3dfdbd0-4fbe-458c-974d-5797d81ed73b,posted,Restaurant Dinner,-3300.63,cc2d7c16-d056-46b0-96ba-6dc420e4ac02,8128.89,debit,bank-fee,AU00000,2024-01-23T00:14:35Z
transaction,8f162133-9ee8-4d76-a749-8deedea7da4a,posted,Uber Ride,-2372.35,dc44969a-2b55-4c7e-a38c-7b01889793ef,5756.54,debit,cash-withdrawal,AU00000,2023-06-19T17:32:35Z
transaction,88ba3d56-0d8f-4467-b721-f4b41e405063,posted,Mobile Phone Bill Payment,-1747.12,958ca206-0e1d-460d-acda-5218c7eeb700,4009.42,debit,cash-withdrawal,AU00000,2023-09-30T14:30:05Z
transaction,bf5ba706-3f41-4b19-bc2f-91b4d7fe76f8,posted,Netflix Subscription,-1202.1,b6d27efc-7f4d-4764-bc4d-f07183366eee,2807.32,debit,payment,AU00000,2024-01-14T19:06:39Z
transaction,afe812b0-517b-4858-8acf-f858a25a7c6b,posted,Car Maintenance Expense,-2996.62,78d61fe1-5069-4721-9037-76e451abe779,-189.3,debit,payment,AU00000,2024-03-07T20:22:58Z
transaction,5c7c452b-a7bd-474a-9b17-a4d43c4cd04f,posted,Payroll WFRMS 15439393,11980.64,7295c9ae-f069-4a36-a11c-d12c66b4a21d,11791.34,credit,transfer,AU00000,2024-04-24T09:33:04Z
transaction,ced2a705-7a99-4403-96a0-09fb91558bce,posted,Bookstore Purchase,-1661.32,8fa4659c-1d60-4593-9a20-c08246a10e2c,10130.02,debit,cash-withdrawal,AU00000,2023-11-18T14:37:15Z
transaction,96b1a79f-3962-479f-8853-2956cc194210,posted,TRANSFER TO JOANNA SMITH CAMPING,-530.89,8cab56c8-301a-4f33-af52-9584cd93ef8b,9599.13,debit,payment,AU00000,2024-03-08T10:00:21Z
transaction,df0a024d-c992-4524-94fc-9dce53e6e59c,posted,Wdl ATM WESTPAC IGA BALGOWLAH BALGOWL AU,-2036.93,ffc047d4-4e45-442f-b313-c88039c8dc2d,7562.2,debit,cash-withdrawal,AU00000,2024-03-07T23:13:32Z
transaction,2b1a2b5b-eb62-4e21-931a-39603642771a,posted,Gym Membership Fee,-4674.73,465d07e6-172c-4fc9-9e6e-3f0ed13ebe53,2887.47,debit,bank-fee,AU00000,2023-06-26T18:59:53Z
transaction,feb9affc-65d5-4aee-affd-266d63994fe6,posted,Public Transport Fare,-1843.13,19efb5f0-b95c-4938-8c5e-174385add4f2,11840.75,debit,payment,AU00000,2024-01-04T20:07:44Z
transaction,9ba09b13-ae00-4b63-9283-cd0539372329,posted,Online Gaming Purchase,-4660.88,8956e8e5-09c4-4df5-afe7-76450e81962e,7179.87,debit,bank-fee,AU00000,2024-05-04T14:21:59Z
transaction,b733ce3f-1bc0-4d8d-86c1-8e70df533a10,posted,Restaurant Dinner,-1475.29,61c6c9d5-334a-4224-8a49-4433d85349bb,5704.58,debit,payment,AU00000,2023-11-27T04:51:48Z
transaction,c7bca310-d217-4f1c-90c6-f5faf789c279,posted,Payroll WFRMS 15439393,10730.61,c85f2691-c6f5-4541-a14b-a5aba4b15fc0,16435.19,credit,transfer,AU00000,2024-03-14T20:53:33Z
transaction,fb4d0a20-15d5-4052-9140-8ec56cd88149,posted,Pharmacy Purchase,-684.77,36ef8135-a163-4449-8cc4-3eb6b5f2a904,15750.42,debit,cash-withdrawal,AU00000,2023-07-06T02:05:45Z
transaction,7493759e-ee12-46d5-8404-148306b0dc6b,posted,Public Transport Fare,-851.87,9891b3ba-20b8-4ddf-bc81-c8931aba69d3,14898.55,debit,bank-fee,AU00000,2024-03-12T01:17:01Z
transaction,f02927ea-390f-4468-b6a0-cc547be5a849,posted,Gym Membership Fee,-810.1,c3eaef56-5e62-43f6-96ff-4db53187b14e,14088.45,debit,cash-withdrawal,AU00000,2023-12-19T06:38:03Z
transaction,d9d0adf8-ba64-4afb-b120-55125c601a23,posted,Bookstore Purchase,-1834.33,5024b3cc-642d-4463-850a-7601574ef749,12254.12,debit,payment,AU00000,2023-10-18T01:16:31Z
transaction,f85c2c0f-131f-4620-aa3e-473ae92052c2,posted,Online Gaming Purchase,-3730.75,b8b366c0-e483-4c0d-90e0-941be4307d96,8523.37,debit,cash-withdrawal,AU00000,2024-03-09T13:01:31Z
transaction,b633cda6-b970-473b-a2cb-f8aa842aab1d,posted,Travel Agency Booking,-2007.7,f1f154d7-3134-483e-bfc6-9d3cbcc3df30,6515.67,debit,cash-withdrawal,AU00000,2023-08-10T20:34:51Z
transaction,704bf110-d6f5-47fb-b133-9f23fd81373a,posted,CTRLINK CARERS Ref: 998R6789201610974V,-3005.72,f9b77ecc-e802-4338-b4ad-1a431076431a,12793.48,debit,cash-withdrawal,AU00000,2024-04-20T13:21:41Z
transaction,48e7617b-0170-43ea-9a1d-60e0000f7bb7,posted,Hair Salon Appointment,-1564.62,2ac7b985-535e-4786-8ab0-3c567389e907,11228.86,debit,payment,AU00000,2023-05-29T12:25:25Z
transaction,6bed3bf2-ce07-421a-8c8b-7739ed78c8b3,posted,Gym Membership Fee,-2733.67,0dbff573-6af1-4dee-ac7c-202ef7c9d78b,8495.19,debit,cash-withdrawal,AU00000,2023-11-10T04:25:48Z
transaction,2db1dc4d-f40b-498d-b1e8-4f57b9394dcd,posted,Travel Agency Booking,-4986.98,d2c03996-31fd-493c-8c27-6299df982db6,3508.21,debit,payment,AU00000,2023-12-20T05:44:27Z
transaction,5e4cf9a6-1f7e-4dca-9bae-93f3df20273a,posted,TFR Acc14000 TO 12389,-1185.63,436433c8-e21d-4fc6-a68e-8f37b79c2409,2322.58,debit,cash-withdrawal,AU00000,2024-03-16T19:21:19Z
transaction,57c22293-024a-47a1-8f0c-9508a0043036,posted,Coffee Shop Purchase,-4853.27,4806057a-ba51-4a64-bc7f-bbd8c73da056,-2530.69,debit,bank-fee,AU00000,2023-09-09T19:43:19Z
transaction,b3b8e36c-7524-4c72-9bd7-f71c6cb829fc,posted,Mobile Phone Bill Payment,-2267.81,0ce801e9-0fc6-4dbd-9b50-d5c65ef8678e,-4798.5,debit,payment,AU00000,2023-10-31T21:18:09Z
transaction,6ee5d3bf-87c9-4289-b56f-896901d795c3,posted,TRANSFER TO JOANNA SMITH CAMPING,-4802.11,8fb6f61e-5e07-494d-b412-fa947b9f9330,-9600.61,debit,cash-withdrawal,AU00000,2023-09-12T09:51:32Z
transaction,fb85a9f0-9515-47af-9447-5798e8623d25,posted,Pharmacy Purchase,-663.23,b4815b91-dea2-44bf-94a0-ca1ca4ad458b,-10263.84,debit,bank-fee,AU00000,2024-03-27T16:58:27Z
transaction,0c7d2a6b-59fd-4e74-9bc4-372518ad7314,posted,Music Streaming Subscription,-2960.5,9af579ff-3465-485a-a37a-79a8bb21e9f5,-13224.34,debit,cash-withdrawal,AU00000,2023-06-20T05:59:17Z
transaction,093405f8-8de0-490d-92f8-66cb0b293fd4,posted,Hair Salon Appointment,-4980.11,9f434f87-4014-49d9-aa12-1aa281758e19,14132.41,debit,bank-fee,AU00000,2023-05-23T18:20:36Z
transaction,7ebf9677-0cdc-403d-8585-8250df27ab2e,posted,TRANSFER TO JOANNA SMITH CAMPING,-677.49,a842dbc1-3a75-4543-9f99-da2288edeac2,13454.92,debit,payment,AU00000,2023-08-13T22:18:48Z
transaction,362c14f3-8b35-4ca1-9830-00bfa6f35e02,posted,AGL RETAIL ENERGY LTD (GAS),-4769.23,3c80cdd6-24fd-402a-b4db-91c2b641e628,8685.69,debit,bank-fee,AU00000,2023-07-26T01:20:00Z
transaction,8202a389-aa07-43c6-8a5c-d5b3d6fdfea3,posted,Car Maintenance Expense,-2954.29,37bca086-3c1f-4bdd-859b-845338d6367e,5731.4,debit,payment,AU00000,2023-11-01T21:27:53Z
transaction,cf1d5d43-d759-41c0-81b5-fb9230a2930e,posted,Music Streaming Subscription,-3583.77,c2e758ab-ce45-43c3-bf5b-2f6660e3b7e1,2147.63,debit,cash-withdrawal,AU00000,2024-04-08T14:10:33Z
transaction,e17ffb77-9dde-4a29-ac65-7ceced1ddbab,posted,TRANSFER TO JOANNA SMITH CAMPING,-530.38,a8c424c6-9903-4595-bc4b-849e7f2b5fa4,1617.25,debit,cash-withdrawal,AU00000,2023-08-05T09:33:05Z
transaction,408990a4-05b2-444c-b965-7e0036f5b5e6,posted,Clothing Store Purchase,-3652.04,0b7a8582-c530-42d3-98e7-896cabdb3cb6,-2034.79,debit,payment,AU00000,2023-08-29T14:12:54Z
transaction,62a874a2-cd49-41b9-9227-5017690022c8,posted,Coffee Shop Purchase,-451.27,5356bfdb-f7a9-409b-bd85-08f616317954,-2486.06,debit,cash-withdrawal,AU00000,2024-04-02T06:03:18Z
transaction,e40d6fec-d9f4-4139-a645-be05cc61880b,posted,Bookstore Purchase,-1554.99,684ce4cf-d671-4829-860c-694159464619,-4041.05,debit,payment,AU00000,2023-12-23T12:28:40Z
transaction,dfe4751c-9bc5-4d30-9c8b-bc866df76eb3,posted,Wdl ATM WESTPAC IGA BALGOWLAH BALGOWL AU,-2625.34,9f109055-9b9a-4156-b154-e53189e35f50,-6666.39,debit,bank-fee,AU00000,2024-01-21T17:12:26Z
transaction,3c6573d4-12e0-4979-aebb-d54596de2f8e,posted,Hair Salon Appointment,-1278.39,f8828c90-b7b3-4da1-ab6e-99567b682a24,17347.73,debit,cash-withdrawal,AU00000,2023-12-30T07:16:39Z
transaction,b5e2fbd9-5164-4252-b445-76dbdfe02ee5,posted,Manly Maths Tutor Wages,-3065.48,b53fbeef-9053-410e-bef0-576696898c04,14282.25,debit,bank-fee,AU00000,2023-10-11T01:47:29Z
transaction,f4432e6f-d2fd-4b28-abeb-292dda9cfc94,posted,Public Transport Fare,-1757.6,6d22b99a-c496-46ad-bb5c-54c0fe1cbc5c,12524.65,debit,cash-withdrawal,AU00000,2023-07-09T03:21:07Z
transaction,71c4b9cf-3177-4f5b-9b99-9df5b7972dab,posted,TFR Acc14000 TO 12389,-2408.1,8c1a50d3-4081-450c-8fa9-3a58bcd85b4d,10116.55,debit,cash-withdrawal,AU00000,2023-11-14T21:58:44Z
transaction,15ebd0b3-04c2-40e4-b2a4-03d151b80d96,posted,Travel Agency Booking,-3538.28,41819d39-12cf-4275-b35b-21567063f202,6578.27,debit,payment,AU00000,2023-12-03T05:02:14Z
transaction,3d828b69-1d55-455d-b655-91306fbd9a1c,posted,Wdl ATM WESTPAC IGA BALGOWLAH BALGOWL AU,-4832.78,31948401-9968-49f1-b859-05759060c295,1745.49,debit,payment,AU00000,2024-03-22T23:07:51Z
transaction,cdef7073-c2dc-4bda-adfe-05d577968392,posted,Mobile Phone Bill Payment,-828.63,201056ef-69c0-4f1d-9912-d94f1529c032,916.86,debit,payment,AU00000,2023-05-20T08:19:48Z
transaction,9d1c994b-5cad-49e7-8880-39425b9120be,posted,Coffee Shop Purchase,-3778.5,aefb415c-3dd8-4490-b34d-7373eb16f5fc,-2861.64,debit,payment,AU00000,2023-11-28T09:12:01Z
transaction,09190797-cb0d-4702-8f59-8d41c242f4aa,posted,Netflix Subscription,-3220.57,523f36f8-d1b4-4ef2-a076-0ec762d6242a,-6082.21,debit,payment,AU00000,2024-03-17T15:14:03Z
transaction,2bfed241-613d-4c27-b734-7c28934b4fce,posted,Hair Salon Appointment,-945.41,5b69f6f3-e2fb-4671-83d4-c6400b983979,-7027.62,debit,payment,AU00000,2023-07-19T17:26:40Z
transaction,23451dbb-bf55-4963-beea-91fe8f3a309f,posted,Public Transport Fare,-1934.71,cfb77a85-aaa0-4d75-9a6f-80f2c34c80c7,10774.67,debit,cash-withdrawal,AU00000,2024-01-15T13:26:38Z
transaction,bfcb336f-27d2-4020-ac47-35bc6835570b,posted,Uber Ride,-3428.51,71606ab9-45a0-4f78-9ad8-a4febacdbc4a,7346.16,debit,bank-fee,AU00000,2023-07-17T21:38:37Z
transaction,d671cfbe-89c9-4a66-b33f-5a50ad695842,posted,Car Maintenance Expense,-4945.19,563d2a77-0a3b-4920-91cd-08bf769f229e,2400.97,debit,bank-fee,AU00000,2024-02-28T19:24:47Z
transaction,66380abc-1417-472e-8d74-722ccff07f99,posted,Movie Ticket Purchase,-2939.47,b08ec434-15d5-4d14-b89b-37ad6a4c014a,-538.5,debit,payment,AU00000,2024-03-28T16:54:55Z
transaction,bb0d30dd-d1e5-4de5-bcf1-51e7a77fb98b,posted,TFR Acc14000 TO 12389,-2769.23,008ed886-5fbc-4b30-a4c6-98adcddd77eb,-3307.73,debit,cash-withdrawal,AU00000,2023-12-24T20:39:11Z
transaction,2d5853d4-f34c-4cf4-a3b2-031cdcb52e59,posted,Hair Salon Appointment,-1091.88,e045f6b9-c215-43b2-a866-72a4bb959bed,-4399.61,debit,cash-withdrawal,AU00000,2023-10-11T18:07:56Z
transaction,596fc1b9-bdd1-4cdb-93f4-01b993371da3,posted,TRANSFER TO JOANNA SMITH CAMPING,-4559.12,f8b784e6-d497-4925-b3d7-674e11690de2,-8958.73,debit,payment,AU00000,2024-04-24T01:25:24Z
transaction,bbb93cb0-1c91-43ee-b88a-9eae94770ee8,posted,TRANSFER TO JOANNA SMITH CAMPING,-894.5,6021590c-b543-4bf4-8133-a64886ce1da7,-9853.23,debit,bank-fee,AU00000,2023-06-19T11:47:10Z
transaction,4fb09b9c-d6b0-4a37-95ae-4ea02726f212,posted,Hair Salon Appointment,-50.83,e16ef75e-0589-4c2a-ba3b-cf3a7c47e1c4,-9904.06,debit,bank-fee,AU00000,2023-09-20T07:31:30Z
transaction,13da1601-d456-4afb-a14d-e16bc40f0e02,posted,Netflix Subscription,-2653.39,d5a35084-9319-485e-bd7e-7d04a274d907,-12557.45,debit,cash-withdrawal,AU00000,2024-02-02T00:19:47Z
transaction,32163efa-1cbf-4fd2-9bc9-687464bebdf7,posted,Electricity Bill Payment,-1750.7,e6f6d890-70e2-4799-89e8-4e93a806fbd8,15594.09,debit,cash-withdrawal,AU00000,2023-06-13T15:35:36Z
transaction,da2b8d57-d14a-4d68-a3d2-67be106112eb,posted,Amazon Online Shopping,-2580.36,e515e4df-83a2-4a0c-8370-4a9026fd3435,13013.73,debit,payment,AU00000,2024-03-22T10:20:08Z
transaction,77e2f630-fbd9-48a0-bd76-5a59d8fbef05,posted,TFR Acc14000 TO 12389,-4109.83,5479dc57-28f2-45eb-b776-5dde9fde3791,8903.9,debit,bank-fee,AU00000,2024-04-06T01:32:07Z
transaction,7605a949-6d5e-4b91-998d-90544b66954b,posted,Wdl ATM WESTPAC IGA BALGOWLAH BALGOWL AU,-4733.32,edae475a-2073-456d-a38c-91e3af5823f1,4170.58,debit,payment,AU00000,2023-12-11T23:16:24Z
transaction,f1b17ae6-d778-4578-9412-9b4a0993b5ec,posted,Hair Salon Appointment,-1079.95,1055521b-4bd2-4c86-98e6-8fa9ab3b09d2,3090.63,debit,bank-fee,AU00000,2023-08-28T08:25:34Z
transaction,c3f620f4-1921-45e6-b6cf-f5216f25f21b,posted,TFR Acc14000 TO 12389,-2870.14,f91d7dd1-fccb-4e64-906e-3a5455ad79dd,220.49,debit,payment,AU00000,2023-06-22T08:51:48Z
transaction,89989f72-a204-481d-a63b-cac2a7178b7d,posted,Coffee Shop Purchase,-2827.99,a2e1e1aa-a9f0-47a9-a2c5-46aea3596898,-2607.5,debit,bank-fee,AU00000,2023-11-15T12:28:36Z
transaction,3080bbc4-95e8-41e9-9e4b-f592f6770d1e,posted,CTRLINK CARERS Ref: 998R6789201610974V,-3683.65,5a1e0c1b-4c33-4b6a-a401-087bf52115ad,-6291.15,debit,cash-withdrawal,AU00000,2023-08-15T04:21:03Z
transaction,a2fcf431-1256-4c41-bdf1-c4c54421b514,posted,Car Maintenance Expense,-4529.75,65d3fd2b-3fc5-4528-95a2-17c1ef09d788,-10820.9,debit,payment,AU00000,2023-12-07T08:51:05Z
transaction,6127d60b-c0cc-4cca-950b-c53f053f0a2a,posted,Amazon Online Shopping,-4319.43,50c4cf54-18bf-472e-b9f4-8cb232789c21,-15140.33,debit,bank-fee,AU00000,2023-07-12T01:23:55Z
transaction,89c6486a-4d10-45a9-b51c-49452d00b2e4,posted,Electricity Bill Payment,-406.69,64b0d88c-cf9b-4bef-aaff-6b63919b26b6,14630.77,debit,bank-fee,AU00000,2023-10-05T23:51:01Z
transaction,15f337c9-d969-4cc1-af16-c30f2c416d82,posted,Clothing Store Purchase,-2817.01,af0781fd-0ac8-4bc3-b94d-31571bfb6354,11813.76,debit,payment,AU00000,2024-02-08T04:48:03Z
transaction,9a9a7b6e-b831-4cbb-a1da-ec993ee26e2a,posted,Payroll WFRMS 15439393,10766.61,f9de6ac7-31e8-4185-b14d-f747b30d48c7,22580.37,credit,transfer,AU00000,2023-06-20T00:26:25Z
transaction,79ea4def-8bdd-4014-9c2b-907c1c14d102,posted,Clothing Store Purchase,-122.13,c8ecf69c-89b8-4851-b386-55feb4d65c80,22458.24,debit,payment,AU00000,2023-12-19T05:20:06Z
transaction,5fda25cb-1eba-4159-9ee0-6c31f97225d0,posted,Home Improvement Store Purchase,-3681.28,1f025a7c-fe38-4e4b-bd86-ff87132eaac0,18776.96,debit,cash-withdrawal,AU00000,2023-07-17T02:24:18Z
transaction,782d4c63-3889-4800-933c-ae851e255a18,posted,Wdl ATM WESTPAC IGA BALGOWLAH BALGOWL AU,-686.84,9ec6ce4c-4dfb-4028-9bed-8aaa8729e25c,18090.12,debit,bank-fee,AU00000,2024-01-14T04:48:14Z
transaction,b05bfead-d6aa-48d8-846b-611d00534745,posted,Hair Salon Appointment,-4300.01,2c2a5cd6-92c6-447e-868e-ddacde47045c,13790.11,debit,cash-withdrawal,AU00000,2023-07-24T18:50:36Z
transaction,cb45074a-1c85-4dca-9186-ce5aebf3f190,posted,Coffee Shop Purchase,-2041.35,9795e6cf-b29f-4edc-832c-ead778ccffe5,11748.76,debit,cash-withdrawal,AU00000,2023-12-29T06:22:12Z
transaction,6ebb01d3-9784-44c4-a297-de20925da664,posted,Travel Agency Booking,-1791.66,31c2831d-5031-4933-8383-0637183aeace,9957.1,debit,payment,AU00000,2023-09-24T04:04:46Z
transaction,98b34ea6-9bed-4d18-b03f-331b95fd015e,posted,Amazon Online Shopping,-3736.34,9dd26451-d262-4686-bb21-f1727023d69b,6220.76,debit,cash-withdrawal,AU00000,2023-09-14T08:26:15Z
transaction,b4b03841-5406-42df-8c06-4177c7e4ec27,posted,Electricity Bill Payment,-1261.11,be9d495f-f8e8-4f96-a13b-11046bf8b98b,15816.41,debit,bank-fee,AU00000,2023-10-04T16:15:29Z
transaction,5ad8bdec-6c8a-42b7-94c1-ae4fe2bbda61,posted,Transfer Platnm Homeloan 346454,-1737.97,955a3603-1084-4637-8324-073c69e3df4d,14078.44,debit,payment,AU00000,2024-05-04T18:30:24Z
transaction,6931e947-f826-4984-aea9-2228909aafc3,posted,Non Hooli ATM Withdrawal Fee,-3283.64,e1cbe7ef-246e-43ad-b957-1d840866fc1e,10794.8,debit,bank-fee,AU00000,2023-07-14T08:47:41Z
transaction,ed696a34-cf6c-467d-8a58-018b0246374c,posted,Travel Agency Booking,-753.39,65ccff80-6358-4b77-a6fd-527b7f4ec42d,10041.41,debit,cash-withdrawal,AU00000,2023-11-15T22:52:22Z
transaction,fec3c45d-777d-4dd8-b447-17a56aa4b1e8,posted,Electricity Bill Payment,-3895.44,e9e6363e-29f0-493c-9b72-db3880c58b2d,6145.97,debit,bank-fee,AU00000,2023-09-04T22:51:26Z
transaction,d2d024aa-90fe-41a5-ae6f-5835e42cd62b,posted,Movie Ticket Purchase,-404.37,350226c0-628c-4331-a3f7-c9a6666db9d3,5741.6,debit,cash-withdrawal,AU00000,2024-02-08T12:51:15Z
transaction,e8d1301a-5cf6-4c91-8ca0-295f92f07094,posted,Electricity Bill Payment,-2830.92,ad48a15a-a376-4494-b1e4-7bc8a11005d6,2910.68,debit,payment,AU00000,2023-07-27T15:43:58Z
transaction,0b6e8f14-584b-4320-b9a4-971ef6f2b0db,posted,Home Improvement Store Purchase,-1199.64,66802c1e-b822-4b36-b834-023153d4c2aa,1711.04,debit,payment,AU00000,2023-12-14T06:36:54Z
transaction,06ebdc51-2358-4783-8b97-64fab7805eba,posted,Manly Maths Tutor Wages,-2966.15,5e2c0e98-5efa-4281-900b-34651ed94c62,-1255.11,debit,bank-fee,AU00000,2024-04-25T07:58:15Z
transaction,3265b58b-3731-424b-9750-0c853e077993,posted,Transfer Platnm Homeloan 346454,-1528.79,b4b80e12-6ce7-4256-9a72-3aa1a8a2ed22,-2783.9,debit,cash-withdrawal,AU00000,2023-10-26T15:21:44Z
transaction,03625c63-9e2c-47d0-bd0f-75caa79a6127,posted,Electricity Bill Payment,-1050.65,4364b738-1a0a-4a4e-bd00-78b0017c8cf9,15204.86,debit,cash-withdrawal,AU00000,2024-05-06T12:13:58Z
transaction,db859a19-6307-4c78-b417-de3a216076d8,posted,Car Maintenance Expense,-4039.07,8070da93-91a2-4884-a988-5a2a76ae607a,11165.79,debit,cash-withdrawal,AU00000,2023-12-22T11:58:05Z
transaction,006eca71-6a31-43d7-b047-fc5d79ad8721,posted,Mobile Phone Bill Payment,-3446.18,888c60b6-189d-42b0-9181-4e7e5644d8f9,7719.61,debit,cash-withdrawal,AU00000,2024-02-19T04:12:15Z
transaction,40bf869b-3942-4742-a85e-7780238dd9fa,posted,Gasoline Purchase,-1334.92,a23986ab-e974-4965-958f-cbb13efdccb6,6384.69,debit,bank-fee,AU00000,2024-03-23T02:07:28Z
transaction,69bdf278-14ff-4373-8d99-3bab07f5d175,posted,Amazon Online Shopping,-1840.74,38567d53-aa0c-46e6-942a-de6645cdc854,4543.95,debit,payment,AU00000,2023-12-20T19:42:36Z
transaction,3a3666ee-a4b5-4a5d-831c-dfbc0b89d010,posted,Amazon Online Shopping,-3502.66,204895d2-850b-4772-b6de-24a81ea659fd,1041.29,debit,payment,AU00000,2023-11-27T11:28:21Z
transaction,4788a00f-8247-42e7-9114-b168e34eecc6,posted,Movie Ticket Purchase,-442.5,9d69b9c4-bbd9-4a56-8deb-b9c4c2af92c4,598.79,debit,bank-fee,AU00000,2024-02-15T18:14:25Z
transaction,854557ca-b8f7-4d1e-8f2b-3d26c19dbf75,posted,Hair Salon Appointment,-3614.88,ef55c2a0-af3b-4674-aec2-edcc344fb5dc,-3016.09,debit,payment,AU00000,2023-10-01T11:03:19Z
transaction,e21bad5a-af43-40c1-9bbe-82f2d975d3ed,posted,Bookstore Purchase,-1270.28,b6da8fdc-afd8-421d-a7e8-b2efff660699,-4286.37,debit,payment,AU00000,2023-12-13T13:17:58Z
transaction,98896070-7691-4e09-8220-7f5fe07c598f,posted,Music Streaming Subscription,-1962.25,868cff5d-8577-4725-9d14-9530a59bff1d,-6248.62,debit,payment,AU00000,2023-12-22T17:35:48Z
transaction,1ef26f8f-0fcc-4a0d-a35d-78947ab87a20,posted,Clothing Store Purchase,-366.87,ee4d6a63-a9a8-4bea-8a1c-5f8e256de7e3,16887.6,debit,payment,AU00000,2024-04-08T16:38:19Z
transaction,03f1b6a2-373e-496f-8e3c-8c409c0f40dd,posted,TRANSFER TO JOANNA SMITH CAMPING,-3319.43,e590e1f2-f79c-44ea-8616-0d862693f2d7,13568.17,debit,cash-withdrawal,AU00000,2023-06-06T17:55:33Z
transaction,5ed362a1-14ff-4ea6-97b7-7bc96b9b2d37,posted,Netflix Subscription,-9.28,e2e050ff-44be-4e09-99b1-e7d11b906aa4,13558.89,debit,bank-fee,AU00000,2023-12-28T18:54:32Z
transaction,4dae7b77-1def-4937-beb9-d2969e2c8327,posted,Wdl ATM WESTPAC IGA BALGOWLAH BALGOWL AU,-599.62,33e7a37f-9244-4bc0-ac89-2b80a48c6503,12959.27,debit,cash-withdrawal,AU00000,2024-04-11T00:31:03Z
transaction,03be0144-2e8a-435c-b333-9e42fd901b23,posted,Non Hooli ATM Withdrawal Fee,-2784.42,3ecbf4fc-c74e-4dbb-8555-24eaa89d2af0,10174.85,debit,cash-withdrawal,AU00000,2023-10-23T17:34:16Z
transaction,83c64bf7-c7f5-4407-8220-4f5fd7d70e4c,posted,Movie Ticket Purchase,-3387.65,c2c1861c-33bd-473d-a977-aa5847519b6f,6787.2,debit,bank-fee,AU00000,2024-02-12T21:09:53Z
transaction,8e500d21-8420-4732-af3f-f5c5414032d1,posted,Bookstore Purchase,-330.81,7f0fe2a9-8936-4698-8cb9-de03bef533ad,6456.39,debit,payment,AU00000,2024-01-18T18:01:38Z
transaction,9b850d23-3093-4745-95af-e6cc4d40d89b,posted,Travel Agency Booking,-4528.31,14ac3e5c-3f83-473f-800d-1c09f5ba8804,1928.08,debit,cash-withdrawal,AU00000,2024-01-08T07:30:31Z
transaction,8d9b60aa-d2d4-4599-a0b9-c0380c32cb31,posted,Car Maintenance Expense,-998.4,f9e7fa3a-1b9e-4776-a97f-97c3e8494083,929.68,debit,payment,AU00000,2023-10-14T13:58:31Z
transaction,8843da25-14dd-4771-8361-64454eef3fd7,posted,Amazon Online Shopping,-3437.35,879eb823-0ab2-4ab8-9a73-caee24692d3b,-2507.67,debit,bank-fee,AU00000,2023-12-21T00:22:57Z
transaction,d79220d0-93f7-43a6-bc78-6d388d44731b,posted,Clothing Store Purchase,-2530.45,e7557859-437c-469f-9dd9-33c6355a791d,11576.77,debit,bank-fee,AU00000,2023-09-21T19:07:39Z
transaction,417a6ec4-1caa-42db-b598-85d433867972,posted,Electricity Bill Payment,-5.24,fdffb88a-5731-407d-8b9f-b3b9b65ec8ed,11571.53,debit,bank-fee,AU00000,2023-12-13T23:49:29Z
transaction,60d82dd4-a70c-42c2-8b92-8e4f9c234264,posted,Non Hooli ATM Withdrawal Fee,-4524.75,37f112b7-9b34-4d15-9a89-b6a4e63c9b9a,7046.78,debit,cash-withdrawal,AU00000,2023-09-05T17:13:29Z
transaction,a32bbaad-1ed4-462a-bfef-382834815fc1,posted,Coffee Shop Purchase,-1034.63,5eef5227-eca6-4736-b5d5-1138b3488fe5,6012.15,debit,payment,AU00000,2024-04-12T12:29:59Z
transaction,cad66402-51a7-4dbb-a8e3-fdab78e01fd0,posted,Pharmacy Purchase,-1559.47,b68ed26a-2ad2-4b73-931a-5fdcd487ca4a,4452.68,debit,cash-withdrawal,AU00000,2024-04-20T15:52:41Z
transaction,f2c9a297-e131-4d4f-985f-d9d65a1f5b94,posted,Home Improvement Store Purchase,-3235.57,0ae11e2a-5749-47ba-92b7-b6ba11d6b04c,1217.11,debit,payment,AU00000,2023-12-12T21:19:31Z
transaction,f24e0868-6839-42e0-978d-d9eb3ff751ef,posted,Electricity Bill Payment,-2039.05,c050ecb1-4a84-4b24-bccb-0c1ce8b101c5,-821.94,debit,payment,AU00000,2023-09-01T01:09:40Z
transaction,917cdce5-f86b-4202-b1ef-6b4c336412ac,posted,Manly Maths Tutor Wages,-3146.17,6d7e554a-657a-480e-a4af-6e4b147fb14a,-3968.11,debit,cash-withdrawal,AU00000,2024-05-02T11:57:42Z
transaction,e4dc4bdf-ec77-4472-a85f-4bf6b6883e2a,posted,Home Improvement Store Purchase,-2045.54,23f44917-76ac-4983-aae0-aba3f7f636db,-6013.65,debit,bank-fee,AU00000,2023-07-04T16:23:58Z
transaction,64f414a7-095f-4927-ae1d-590dde551fb5,posted,Gym Membership Fee,-2999.71,72657d42-86f0-40eb-8883-06a3d31f85da,-9013.36,debit,bank-fee,AU00000,2023-06-21T09:12:37Z
transaction,325be072-5c0a-4db7-83df-834b3961655c,posted,Gym Membership Fee,-713.68,f50ca2e4-b014-481f-9425-2dbdf68a9131,7513.85,debit,payment,AU00000,2023-12-22T10:15:18Z
transaction,c2d3baf2-ecdf-4aef-8c10-82d2e396d858,posted,Wdl ATM WESTPAC IGA BALGOWLAH BALGOWL AU,-1585.43,a0fc9a76-5e63-4469-85fa-7b84223d26f6,5928.42,debit,payment,AU00000,2023-08-10T22:00:15Z
transaction,df756422-6a44-4b6f-b719-dd84c1bfba61,posted,Restaurant Dinner,-2077.92,02548ccc-3ebb-4500-a06e-24e92073d1ce,3850.5,debit,cash-withdrawal,AU00000,2023-09-26T07:53:57Z
transaction,328fccdd-eb5d-4e8c-995b-01e3cec04089,posted,CTRLINK CARERS Ref: 998R6789201610974V,-503.91,a9fc8302-47cc-4ba4-bbd7-3fa78358a7ad,3346.59,debit,payment,AU00000,2023-12-21T23:11:46Z
transaction,dffbd8c6-11e5-4cf7-8698-b317d25cf76b,posted,TRANSFER TO JOANNA SMITH CAMPING,-3015.17,b0160ed9-ec1b-4edb-9c33-3fe7a14ad18d,331.42,debit,payment,AU00000,2023-07-06T00:00:22Z
transaction,e1b39b32-1b8d-4451-9bc7-723979d2c73e,posted,Clothing Store Purchase,-4348.76,6d274e97-968a-44a5-bb0f-fd1a77788573,-4017.34,debit,payment,AU00000,2023-11-02T20:23:35Z
transaction,599fe8bb-5192-4da7-b084-e8a0e78d68eb,posted,Gym Membership Fee,-3285.54,557c5693-8287-4cd2-b959-7d605982ed77,-7302.88,debit,cash-withdrawal,AU00000,2024-02-02T04:21:58Z
transaction,97e7e91a-198c-450b-b52e-0b014feaab82,posted,Bookstore Purchase,-2622.0,c889f691-b32d-4816-96f5-f5da1ce1f277,-9924.88,debit,bank-fee,AU00000,2023-11-16T15:16:54Z
transaction,1b43aa6d-4981-4876-acb4-2b19b7f97721,posted,AGL RETAIL ENERGY LTD (GAS),-1423.16,11fe6251-7709-4ec5-a931-86c01786287f,-11348.04,debit,bank-fee,AU00000,2023-06-01T11:27:47Z
transaction,7f04df5c-6cac-424d-b6cc-6995734d22f8,posted,Electricity Bill Payment,-1220.41,9a475efd-7201-4c40-9599-98e8b90c61a6,-12568.45,debit,payment,AU00000,2023-12-29T09:45:10Z
transaction,5a82eb36-156c-45f8-b53d-db7874cebaf0,posted,Mobile Phone Bill Payment,-4854.3,f6742072-d984-44a3-98f7-a67f7a6ccf13,13193.08,debit,cash-withdrawal,AU00000,2023-09-06T21:56:54Z
transaction,6c2263f9-0ad6-4725-bd3c-34183c9cf27a,posted,Car Maintenance Expense,-3198.66,6ac549be-92e0-4b42-a4e4-f6ee2dd1777f,9994.42,debit,cash-withdrawal,AU00000,2024-03-09T05:29:39Z
transaction,06d19561-f09c-426f-8918-e00f74234c0b,posted,Uber Ride,-4359.81,1dd738ac-b79a-40d2-96fd-faa1d7303a6d,5634.61,debit,payment,AU00000,2024-03-12T16:37:48Z
transaction,f57fbfdf-270b-4905-b453-af567d4d3718,posted,Music Streaming Subscription,-3042.34,70003cea-6508-47e1-9a3a-9703e5fff78c,2592.27,debit,bank-fee,AU00000,2024-03-31T11:26:27Z
transaction,ef936b73-b7f3-4908-b5d6-0676dfb44bfd,posted,Coffee Shop Purchase,-4608.99,24efd294-1a2a-449d-b1fe-8f9577f16987,-2016.72,debit,payment,AU00000,2023-05-13T07:14:41Z
transaction,4b557ebd-1f9d-4c16-9dbd-0bfc3a2ba37e,posted,Clothing Store Purchase,-1558.87,61caf81f-e719-48a3-8e00-a4a8a2fef40e,-3575.59,debit,payment,AU00000,2023-06-18T14:19:19Z
transaction,b1e0196a-68ea-4f7f-91ec-0e5f53e4b5d4,posted,Electricity Bill Payment,-2436.88,64af34a8-d792-4d87-90a0-05750f7d3b51,-6012.47,debit,payment,AU00000,2023-11-18T21:20:11Z
transaction,d96c1545-d988-4415-bada-1b828d2bf287,posted,Online Gaming Purchase,-1426.25,906bfcd8-d48d-48c6-be6d-3bc37acdf116,-7438.72,debit,bank-fee,AU00000,2024-05-09T20:30:04Z
transaction,a7174204-ff5f-4ae9-840b-3ab4860931be,posted,Electricity Bill Payment,-1806.2,15a19fef-8045-4bed-877a-7b7f3138815d,-9244.92,debit,payment,AU00000,2023-12-07T08:07:21Z
transaction,8d479bae-b79b-4143-bbb9-fe6887314a37,posted,Netflix Subscription,-3778.74,26f89a90-5785-446b-b8c3-f2301b317acd,-13023.66,debit,cash-withdrawal,AU00000,2023-11-26T18:38:37Z
transaction,c0a04a21-2630-4715-9dae-4e8984ec09e9,posted,Restaurant Dinner,-1017.92,496342cd-0e86-4234-939a-bf4e3a1cf285,8386.07,debit,payment,AU00000,2023-08-29T03:43:34Z
transaction,053801c5-f00b-403f-9c44-945b9d132d45,posted,Pharmacy Purchase,-4149.34,bc0f3063-ba33-4547-8f48-6731913392a3,4236.73,debit,payment,AU00000,2023-10-03T12:14:29Z
transaction,a9e63b57-47d9-4e4f-87e4-a307fce3aa23,posted,Uber Ride,-2365.23,5600dadf-2347-42a8-9e50-f3ef0e360ba5,1871.5,debit,cash-withdrawal,AU00000,2024-02-25T00:44:23Z
transaction,888eb4c7-6e24-4fea-a0c6-a9c78cf24b58,posted,Pharmacy Purchase,-3523.32,211a9f4c-b57c-42f7-a9fa-586fd5f04bc9,-1651.82,debit,bank-fee,AU00000,2024-01-03T18:14:50Z
transaction,d331db20-d13c-43dd-ac1a-d88e7792bf6b,posted,Electricity Bill Payment,-4005.89,8504d0b9-5b1d-4f59-93d3-bfbcb3b4dab2,-5657.71,debit,cash-withdrawal,AU00000,2023-11-29T15:35:39Z
transaction,f03e436f-4686-4a4d-8a17-b4db197fd77f,posted,Home Improvement Store Purchase,-4647.07,6d95727a-2551-4cb9-a5ab-33eef44e44fc,-10304.78,debit,cash-withdrawal,AU00000,2023-08-31T22:44:05Z
transaction,784a2360-424c-4666-80bc-6d10e42b1514,posted,Amazon Online Shopping,-748.5,57b7fb34-9128-44b7-ab28-ce5c631e9962,-11053.28,debit,payment,AU00000,2023-09-04T22:35:52Z
transaction,05f049b2-2df2-4743-9a19-15df70e76167,posted,Gasoline Purchase,-1338.91,fb4f31bc-3161-4b75-b4d7-a87a49fe8df6,-12392.19,debit,payment,AU00000,2023-08-22T03:27:52Z
transaction,e262584f-3bef-4876-bbd6-578f2c9655c8,posted,Manly Maths Tutor Wages,-930.24,24c3a23f-2a86-454c-b337-03426e1a833b,-13322.43,debit,cash-withdrawal,AU00000,2023-07-19T15:39:12Z
transaction,eee20a51-e7f7-49d4-b944-eed2c0d31d28,posted,Mobile Phone Bill Payment,-597.56,cb5961d4-a26e-4c25-b0ff-10c59e8c2a25,-13919.99,debit,cash-withdrawal,AU00000,2023-08-31T18:05:35Z
transaction,8be84b09-f1f8-47e8-840c-316d667d2e52,posted,Bookstore Purchase,-208.37,0e95abcb-7827-4189-b1e4-eb9df55ada79,18790.74,debit,cash-withdrawal,AU00000,2023-10-24T05:29:39Z
transaction,b11426d4-d149-4be1-b356-5a2936adf98f,posted,Payroll WFRMS 15439393,11550.34,647bca4a-9774-434c-96d8-f12974b331fe,30341.08,credit,transfer,AU00000,2023-10-11T06:29:12Z
transaction,62b1b36d-6026-46e1-b545-b58bf5b17a2d,posted,TFR Acc14000 TO 12389,-3424.95,15518aca-ad55-4b8e-80f1-4f6602258634,26916.13,debit,payment,AU00000,2024-03-23T09:33:57Z
transaction,4e1457c6-e9dc-476b-ab44-e3d95a4e4a91,posted,Manly Maths Tutor Wages,-1730.27,0f2e6151-da5c-4d7e-acef-6cf4ed3d8945,25185.86,debit,payment,AU00000,2023-07-09T08:00:05Z
transaction,a5567556-9696-4bc8-9452-f6441df2bedd,posted,Public Transport Fare,-4048.46,ed5b7bf9-3b29-4df7-9765-f7f2e1b95df7,21137.4,debit,bank-fee,AU00000,2024-04-27T13:17:50Z
transaction,d2de1232-cdba-40aa-9f92-8d8a7a7b9a73,posted,Public Transport Fare,-4230.34,455fbbbe-a4d8-46e2-9aa5-9242241deceb,16907.06,debit,cash-withdrawal,AU00000,2023-11-08T13:41:04Z
transaction,4546524a-3ff0-41fe-a7c6-1f367a286483,posted,Music Streaming Subscription,-3783.43,635f5960-f299-4aef-8a42-baa7964bf68f,13123.63,debit,payment,AU00000,2024-04-12T11:08:18Z
transaction,c2d29cb9-05af-43d0-9673-14aa2579c521,posted,Online Gaming Purchase,-1606.73,6e1df179-9640-407a-8b63-dc031032602f,11516.9,debit,payment,AU00000,2024-02-11T08:22:17Z
transaction,9972d93e-3172-4775-86ac-596562fa57d0,posted,Mobile Phone Bill Payment,-3669.67,e35dea27-8ad4-4caf-b4c0-138bc5fb0045,7847.23,debit,cash-withdrawal,AU00000,2023-07-31T06:50:54Z
transaction,b5c38e1e-4d25-4608-9099-1e385c924ca8,posted,Amazon Online Shopping,-963.73,b952f990-5d73-4a74-b2c3-3c6cb045564a,6883.5,debit,bank-fee,AU00000,2023-12-11T20:06:48Z
transaction,353975b4-6b57-4b3b-b749-67ea0f5f3f73,posted,Car Maintenance Expense,-2382.08,c7143e42-1d98-4f80-97f5-d74dbe345d0f,4877.66,debit,payment,AU00000,2023-05-29T16:22:04Z
transaction,9b3c9c9f-f402-4151-9edb-1d63cdf4f34e,posted,Hair Salon Appointment,-3903.44,a9dc5d84-8be2-4632-a13c-29d449d8db80,974.22,debit,payment,AU00000,2023-11-02T00:28:57Z
transaction,c05de7a8-6da3-4bfb-9a47-b25878eac557,posted,Payroll WFRMS 15439393,10859.43,8bed4e3e-98c7-48b1-a288-666147662a5d,11833.65,credit,transfer,AU00000,2023-08-18T20:49:53Z
transaction,f7ce2774-f000-4baa-863e-2ff40c1662c3,posted,Clothing Store Purchase,-1239.14,400dfc3b-685f-48f7-aa5a-6d962872f1a5,10594.51,debit,payment,AU00000,2023-05-27T13:15:34Z
transaction,895c30d0-0ebf-4642-a195-b17dc04c08e4,posted,Payroll WFRMS 15439393,10121.49,59c9e9fa-8800-4731-a2e6-7cc3b17cbe59,20716.0,credit,transfer,AU00000,2023-09-23T17:14:49Z
transaction,ccc13e0a-e50e-4a54-ae22-46417f6c48fd,posted,Car Maintenance Expense,-1975.77,18629cbb-c378-4f81-b805-67b124509a04,18740.23,debit,cash-withdrawal,AU00000,2024-05-01T23:18:29Z
transaction,79dbb1d3-dba5-4946-b8eb-0d11ee47939a,posted,Restaurant Dinner,-3800.02,ecae049b-bd19-4584-b4c0-1df602fa5c43,14940.21,debit,payment,AU00000,2023-12-13T16:48:50Z
transaction,a421a9f5-c5f2-4d9a-a7b1-00706228ff9a,posted,TRANSFER TO JOANNA SMITH CAMPING,-1849.22,f6fdabbf-0563-4c40-bc50-a2829a53253d,13090.99,debit,payment,AU00000,2023-11-15T01:54:05Z
transaction,7ee82384-fc33-450e-8708-0c2a98761bae,posted,Mobile Phone Bill Payment,-2192.15,8903203f-5b36-43cf-94ac-73536e88884b,10898.84,debit,cash-withdrawal,AU00000,2024-03-03T19:02:56Z
transaction,4996dbc7-80d4-4d97-b9db-65bcf6459b8b,posted,Manly Maths Tutor Wages,-1792.74,abf5ab7a-7826-4c54-a086-de2b453e07db,9106.1,debit,payment,AU00000,2024-04-21T00:59:26Z
transaction,fc747bb9-1df6-4845-8526-a06ae97e5920,posted,Gasoline Purchase,-2466.88,1655a0a5-d123-4466-8c09-0c1e90fbff59,14328.63,debit,payment,AU00000,2024-05-06T03:47:26Z
transaction,e77eae48-6c6e-4045-8923-b638909a0a1f,posted,Uber Ride,-2670.14,45411c37-270a-4136-a650-acf0243d80f1,11658.49,debit,cash-withdrawal,AU00000,2024-03-28T14:03:37Z
transaction,9eb02ea4-ed20-4340-8f61-dfd6c79737a3,posted,Restaurant Dinner,-4759.35,e5b76fb3-af3c-4af7-ada6-5ecea1c2e7e7,6899.14,debit,bank-fee,AU00000,2023-11-16T05:25:58Z
transaction,91bd538b-1f66-470d-88e4-390777de8062,posted,Mobile Phone Bill Payment,-26.61,9af6f416-6761-4a7e-a3e5-30e7437ec5f0,6872.53,debit,cash-withdrawal,AU00000,2024-02-09T04:30:54Z
transaction,642f041d-980b-4f6c-8e37-47a127db895c,posted,Payroll WFRMS 15439393,10074.58,e0ab4c5a-43dd-4130-957f-c2872d94a221,16947.11,credit,transfer,AU00000,2023-05-28T11:52:56Z
transaction,a936daa3-588d-4700-80d9-d64b5ecd0346,posted,Bookstore Purchase,-1579.55,8c5f0917-fb7c-4a33-a4ff-5cdc33b1f016,15367.56,debit,bank-fee,AU00000,2023-06-11T23:15:37Z
transaction,e3c12ee1-f9b3-41da-a617-27f94fd826bb,posted,Coffee Shop Purchase,-1054.17,bfca9135-5744-4252-a615-dbe4df08191f,14313.39,debit,bank-fee,AU00000,2024-03-08T04:34:20Z
transaction,e81261f4-0c2a-41d8-bcb7-433ccfe3290b,posted,Transfer Platnm Homeloan 346454,-2392.72,f2083ac8-cfe8-43b3-9325-56f185fe82cb,11920.67,debit,payment,AU00000,2024-02-26T23:11:57Z
transaction,7263fffa-c0b0-43be-90d4-c54b3293d6ef,posted,Clothing Store Purchase,-3404.31,1bbf1a7b-2ce9-4add-9d54-1c323ec5ccef,8516.36,debit,bank-fee,AU00000,2023-10-20T19:03:13Z
transaction,0ae740ea-613f-44b5-8a62-c681f4346a2c,posted,Restaurant Dinner,-4086.38,26daede4-5bbc-40c3-94a8-32d00d7a2fc5,4429.98,debit,payment,AU00000,2023-07-27T21:33:37Z
transaction,356d6148-cd92-4894-a124-0c4716534e0f,posted,Mobile Phone Bill Payment,-4853.82,0a446b80-c2fb-4436-b5a1-7beb3e3675ea,10540.47,debit,bank-fee,AU00000,2024-04-14T07:12:46Z
transaction,5f474198-ba10-4de4-8288-d2871d4b9457,posted,Uber Ride,-2794.67,9673114f-e21d-4d39-acc8-97d2cf6f591f,7745.8,debit,cash-withdrawal,AU00000,2023-10-06T21:19:00Z
transaction,1761c220-d682-4f0b-be13-83b0cb7f608a,posted,Music Streaming Subscription,-3681.98,f787b094-c8e0-4cbf-b4ed-e2331057342c,4063.82,debit,payment,AU00000,2024-03-17T11:18:37Z
transaction,ed435511-d6cb-4213-b097-d9f29f6df3a4,posted,Coffee Shop Purchase,-3244.1,bd46a0aa-d7d3-4416-bf17-ce1d4e49e478,819.72,debit,bank-fee,AU00000,2024-04-17T11:53:22Z
transaction,90ee6cbc-d44d-4139-874f-9810d2890c61,posted,Transfer Platnm Homeloan 346454,-4377.96,7c63f04a-4987-41fb-b894-ff989439b0ca,-3558.24,debit,bank-fee,AU00000,2024-05-06T19:24:28Z
transaction,fd46e30d-a810-4c5c-a3c0-72ecc6122e1a,posted,Manly Maths Tutor Wages,-4605.71,fd8781f5-0e39-4203-9732-ccefdaad175c,-8163.95,debit,bank-fee,AU00000,2023-11-24T01:03:52Z
transaction,3bc07ea8-2cea-46e4-8378-9d59a0dc200a,posted,Hair Salon Appointment,-1677.85,ae565538-cdc8-492b-81e0-4f8a2dd9acb7,-9841.8,debit,payment,AU00000,2023-09-15T17:01:30Z
transaction,812dd6fe-176c-4b45-91c5-aa4e16196c26,posted,Wdl ATM WESTPAC IGA BALGOWLAH BALGOWL AU,-1281.29,1b5a4f41-7d14-4bce-97b1-06dea0046d94,-11123.09,debit,payment,AU00000,2023-10-05T13:41:29Z
transaction,8e6b9efc-e507-4941-bc19-4587533becff,posted,Netflix Subscription,-4576.95,6753609d-07ec-4811-b18d-11fa78480489,-15700.04,debit,bank-fee,AU00000,2024-04-21T08:47:23Z
transaction,060e98cc-0eef-4e89-88ca-60b202ba1380,posted,Non Hooli ATM Withdrawal Fee,-497.79,da2e0881-abd4-4b1c-ad78-77d725db0ff8,-16197.83,debit,payment,AU00000,2023-09-26T23:51:29Z
transaction,549c4cf7-9015-4aa6-80f9-77b5c3216be0,posted,Music Streaming Subscription,-243.95,b8f48152-2036-486f-a6b7-3ccd366348d0,7356.7,debit,cash-withdrawal,AU00000,2023-08-12T16:48:23Z
transaction,984eb67b-0699-441a-bda9-6304438a2b28,posted,Hair Salon Appointment,-1511.95,437a4fe6-c8b9-4e35-a9d1-e7d1b111f62a,5844.75,debit,bank-fee,AU00000,2023-12-03T05:32:00Z
transaction,21d145f0-9eaf-4867-82e8-69eac4061b32,posted,Manly Maths Tutor Wages,-776.35,82962e1c-2b4c-403b-a580-8447cebd99d0,5068.4,debit,bank-fee,AU00000,2023-12-30T07:26:21Z
transaction,66cc19ad-bd1d-45dd-8bb5-2e616e9378f7,posted,Uber Ride,-4592.37,10219c5f-cf6b-4bf4-ae36-024b324d5a5d,476.03,debit,payment,AU00000,2024-05-09T03:00:09Z
transaction,0751deb0-8579-490b-af29-08b028c0c044,posted,Gym Membership Fee,-2345.57,036a3818-a470-42b6-9425-51028f6053ea,-1869.54,debit,cash-withdrawal,AU00000,2023-05-21T09:13:07Z
transaction,5f75eeae-5358-48d1-9255-db7ba8d96605,posted,Hair Salon Appointment,-482.34,db0dee81-2f50-485f-93f4-0400d823ef07,-2351.88,debit,bank-fee,AU00000,2024-02-22T14:41:12Z
transaction,69ec29e6-4977-4936-93a3-d7531e5e483a,posted,AGL RETAIL ENERGY LTD (GAS),-4341.7,ea349a06-ba38-4ca2-8e26-428e88a643ce,-6693.58,debit,cash-withdrawal,AU00000,2023-05-12T01:29:44Z
transaction,99c97fde-a5d9-4cce-88c8-502a5f0bb3f4,posted,Uber Ride,-1154.61,2a0d4bdc-2cf4-4c8b-a2d7-2f30f7ff3058,-7848.19,debit,cash-withdrawal,AU00000,2023-12-04T12:19:41Z
transaction,6d47029d-c886-4ea5-84e9-690835e6dbf6,posted,Wdl ATM WESTPAC IGA BALGOWLAH BALGOWL AU,-1727.78,44b1229c-45f1-476d-b5e4-7d56a7707c0d,-9575.97,debit,payment,AU00000,2023-10-14T16:39:12Z
transaction,308d7119-7735-49ff-b1ff-abf072cdbfa3,posted,Public Transport Fare,-458.04,a269fe72-1aea-4663-ac96-963d07ab39a0,-10034.01,debit,cash-withdrawal,AU00000,2023-11-25T06:45:49Z
transaction,4c36f1c7-2583-4b03-a23b-37ed1909a729,posted,Bookstore Purchase,-610.71,2c1f4be8-4632-45e8-a407-a50f7a2cd703,7984.11,debit,bank-fee,AU00000,2023-09-17T20:07:26Z
transaction,631c48db-54be-4501-a05c-405e08637968,posted,Non Hooli ATM Withdrawal Fee,-3135.48,903f786d-3295-4d27-ae78-acf7c339bfca,4848.63,debit,bank-fee,AU00000,2023-07-06T11:02:32Z
transaction,ffa16c3f-b701-4c55-8813-b60094c39e48,posted,Online Gaming Purchase,-4034.64,2ef69286-368f-47d0-80b4-60f18495585d,813.99,debit,cash-withdrawal,AU00000,2023-08-13T08:51:37Z
transaction,9e206705-78ba-482f-81df-8403d15b154c,posted,Amazon Online Shopping,-607.83,9303e3e3-1db5-49c4-b752-0f32a8b3c091,206.16,debit,bank-fee,AU00000,2024-04-03T06:18:51Z
transaction,b002a90b-d63f-4f1f-a4c5-569113086b23,posted,Coffee Shop Purchase,-3162.45,c0b3596d-f95a-4e6e-aadd-c946dcc6c413,-2956.29,debit,payment,AU00000,2024-01-15T15:57:53Z
transaction,1acddea7-b05b-4ef8-afdb-99132a0e993d,posted,Electricity Bill Payment,-3717.59,e24c0576-1d38-42e1-8dfd-04348c779a66,-6673.88,debit,payment,AU00000,2024-03-16T21:29:05Z
transaction,de49d1f8-2c03-4b03-829c-19e3fdbf89b9,posted,Home Improvement Store Purchase,-2431.02,643c624e-66ca-4d02-ba47-53f628b0a4c5,-9104.9,debit,payment,AU00000,2024-04-08T10:02:53Z
transaction,a485222c-770a-4df0-bfd3-80229400f59a,posted,Bookstore Purchase,-4378.95,538fadd9-256e-4f84-bb92-d25dd424094f,-13483.85,debit,cash-withdrawal,AU00000,2023-08-17T12:29:35Z
transaction,0f9e903a-6d36-4233-b6cd-0eae4a9ed6e3,posted,Netflix Subscription,-4396.64,af1fb02e-3b82-4a04-b5c3-e3df86c965a0,-17880.49,debit,payment,AU00000,2023-12-02T01:12:14Z
transaction,e7b1dac2-42ef-483e-90d5-85def4a11f0d,posted,TFR Acc14000 TO 12389,-1118.26,ceb30c03-cd5f-47ac-8d3f-5255c7601824,-18998.75,debit,cash-withdrawal,AU00000,2023-10-31T01:37:55Z
transaction,6a9c5d50-7277-45ac-8e44-418ff105d93e,posted,Online Gaming Purchase,-641.34,f17d720d-0049-42b7-a453-88b5e219ee1f,14923.83,debit,payment,AU00000,2023-10-19T19:20:47Z
transaction,bc008f36-21d9-41d5-95f3-5ee7db8c431c,posted,Manly Maths Tutor Wages,-412.11,663a74b0-50f9-48b4-974d-55e5368e68fa,14511.72,debit,cash-withdrawal,AU00000,2023-08-16T00:51:16Z
transaction,b0452bf4-3f99-4d0e-9654-3780219ab791,posted,Pharmacy Purchase,-2701.54,1f3fdb14-bb91-4cb6-a370-b429e325ff4b,11810.18,debit,payment,AU00000,2024-02-29T11:01:48Z
transaction,5100d7a2-b4e1-472b-986e-91ad02279a7e,posted,Gasoline Purchase,-517.65,5970a119-97f0-4599-a480-00187b07f5d6,11292.53,debit,payment,AU00000,2023-12-09T22:10:59Z
transaction,4b87d0a4-d58e-4266-8517-f5ac285bad25,posted,Electricity Bill Payment,-2177.05,8bea10a1-f7e9-4c09-935a-65fbca167cdd,9115.48,debit,cash-withdrawal,AU00000,2024-01-21T08:33:56Z
transaction,6c14cc40-3172-4ab3-8ec5-38f835364c70,posted,TRANSFER TO JOANNA SMITH CAMPING,-2437.37,84ed3f22-38a0-4aa4-b625-1e146bdc5ddb,6678.11,debit,bank-fee,AU00000,2023-07-29T16:15:12Z
transaction,209dbd1f-8734-4c80-b03b-fee9c4d2c3bf,posted,Coffee Shop Purchase,-3046.31,209f7515-710b-4706-83c1-7269d4cb01a5,3631.8,debit,cash-withdrawal,AU00000,2024-01-02T11:29:05Z
transaction,366e4467-5d0f-463e-a225-0b20b530bb90,posted,Electricity Bill Payment,-3049.46,0c10b4be-60be-447c-8180-6c9a6f6fac66,582.34,debit,bank-fee,AU00000,2023-09-26T06:11:36Z
transaction,b90dfb1c-dcfe-4f8e-94b1-e8346aedf6e9,posted,Mobile Phone Bill Payment,-735.77,c7d1823b-553e-455e-a20b-cad98e62820c,-153.43,debit,bank-fee,AU00000,2023-12-06T00:21:52Z
transaction,c6dad72b-78b8-42a9-87de-9e1f266f121c,posted,Pharmacy Purchase,-1511.48,1ac8f539-599e-4261-bcae-88990c24d2e5,-1664.91,debit,bank-fee,AU00000,2023-10-07T16:26:39Z
transaction,3b703997-6e5f-4937-9616-082db663cdec,posted,Wdl ATM WESTPAC IGA BALGOWLAH BALGOWL AU,-1948.57,a903dc29-cb2f-428d-9252-c51f5790b974,11381.76,debit,cash-withdrawal,AU00000,2024-04-15T23:04:12Z
transaction,e0c8abe2-36a6-4ce3-b3e4-a4e248b1364d,posted,Public Transport Fare,-4513.83,50985911-9933-4ba9-aecf-277c457a7d18,6867.93,debit,cash-withdrawal,AU00000,2023-07-28T02:46:54Z
transaction,e7173a72-294a-4a39-ba89-447a007be73b,posted,Electricity Bill Payment,-4565.19,1a38d414-a7b6-4793-9902-ac7385015cf4,2302.74,debit,bank-fee,AU00000,2023-11-02T20:42:35Z
transaction,68eb3de8-3257-4c38-a60a-be387ff232c1,posted,Manly Maths Tutor Wages,-3063.24,7548d84f-6e57-47a2-96d0-337d29a362b5,-760.5,debit,payment,AU00000,2024-01-18T17:39:22Z
transaction,f224b1b6-6e96-4051-9795-c308c8268b33,posted,Transfer Platnm Homeloan 346454,-1394.43,5c7346ee-f6ff-4b46-b49c-f4c1fae39bf8,-2154.93,debit,payment,AU00000,2023-11-17T11:12:40Z
transaction,2b424056-e0ea-4912-a8b4-bc93a3bb148d,posted,Electricity Bill Payment,-500.2,4515dd00-592a-48b1-baab-200504e75f9b,-2655.13,debit,bank-fee,AU00000,2024-02-18T18:57:07Z
transaction,ae6b5abc-b62f-41c2-bbe6-c7494a49bbe1,posted,Car Maintenance Expense,-1814.58,17fc5c05-33d3-472b-abc7-c5dead658209,-4469.71,debit,payment,AU00000,2023-12-30T00:21:14Z
transaction,bbca64df-2ea5-4dbd-bb96-b0cd41718060,posted,TRANSFER TO JOANNA SMITH CAMPING,-4853.86,6f6a6c2c-ebd2-4d52-8926-c15bb23ae2d1,-9323.57,debit,cash-withdrawal,AU00000,2024-01-23T09:27:00Z
transaction,5d12bce2-e77a-4987-908b-1f83d1f86e2e,posted,Bookstore Purchase,-3557.96,66eb2798-0a3e-4827-9f26-9c89605d0de2,-12881.53,debit,payment,AU00000,2024-02-03T01:02:40Z
transaction,fd286d45-ab6f-476b-bfad-3a66d61f4146,posted,Uber Ride,-3650.34,687eafb9-fecb-49cf-b03d-ff2de7c08346,-16531.87,debit,bank-fee,AU00000,2023-10-22T02:44:34Z
transaction,c0dd377b-746d-4ea1-ab76-46fef09e743d,posted,Online Gaming Purchase,-662.91,dd3a05a9-7393-4190-9154-954fad7d8dd7,15958.76,debit,cash-withdrawal,AU00000,2023-11-18T13:39:02Z
transaction,f98f0c5a-fa8c-4f20-a9f7-ddf9f0532243,posted,Bookstore Purchase,-4508.98,cf0685d4-e793-40d9-a5de-19d2336336f4,11449.78,debit,cash-withdrawal,AU00000,2023-08-25T16:47:26Z
transaction,3d1c2a1c-b3c7-4ba0-9caa-79c5fc996fbd,posted,Bookstore Purchase,-3289.45,d75997d9-4fd3-4dca-b384-e6f0a2f836b0,8160.33,debit,bank-fee,AU00000,2024-01-29T11:48:27Z
transaction,4e0bdf5f-576d-4278-b2a5-3653d77f8c8b,posted,Gasoline Purchase,-2160.26,73bf3801-b721-4679-bb01-9a09919774ee,6000.07,debit,payment,AU00000,2023-10-28T16:40:51Z
transaction,d2b7cb2f-9aec-4ddc-8dd4-f61b21ebb2fa,posted,Payroll WFRMS 15439393,10932.8,d278b966-8e4a-4359-b0aa-27d694713b4f,16932.87,credit,transfer,AU00000,2023-11-02T14:06:17Z
transaction,44f34283-9b74-4efc-a3c6-96e64e3f7e5e,posted,Transfer Platnm Homeloan 346454,-3868.22,7c903a8e-3498-4871-9fa7-0dda755e9d1a,13064.65,debit,cash-withdrawal,AU00000,2023-10-20T08:43:11Z
transaction,c63e4a6e-d51f-4279-a707-4c94a5cbafa1,posted,Pharmacy Purchase,-560.33,40cab5c7-142c-49fd-b665-ade38f5a1f60,12504.32,debit,bank-fee,AU00000,2023-09-25T02:19:46Z
transaction,c9275924-15da-41b1-b8c0-9d2d64ffb98e,posted,Public Transport Fare,-532.33,a8ccb04b-0db5-4ceb-b41c-4ecad44bacc1,11971.99,debit,bank-fee,AU00000,2023-10-22T16:51:32Z
transaction,19da71fe-2016-4634-b9b1-54b27470f63f,posted,Payroll WFRMS 15439393,11576.28,edb365e3-aac3-4da2-8b54-615cbe6c9ff7,23548.27,credit,transfer,AU00000,2023-07-24T11:10:32Z
transaction,fd588e37-3b79-453a-a8b4-bc29c4588818,posted,Bookstore Purchase,-4703.91,9c647be8-0790-439f-955e-1265104bebbb,18844.36,debit,payment,AU00000,2024-03-10T20:47:44Z
transaction,a4edd6f1-fb7d-4be4-b70b-a817dcd75e40,posted,Manly Maths Tutor Wages,-468.07,8d75a412-7d9b-4fcd-9695-589324b53068,10750.22,debit,payment,AU00000,2024-04-14T22:29:52Z
transaction,648e69de-d98b-4922-93fa-6ddfc4ac07a9,posted,Manly Maths Tutor Wages,-4528.43,a731c1c5-8296-4cc5-a427-0d3730fe0d06,6221.79,debit,cash-withdrawal,AU00000,2023-05-12T07:19:35Z
transaction,9eafeb7e-7d00-4227-983b-dc26b626d06c,posted,TRANSFER TO JOANNA SMITH CAMPING,-2770.88,b148aa7a-679b-408d-9e46-37528c2ee7f4,3450.91,debit,payment,AU00000,2023-09-10T06:46:33Z
transaction,fc3ed24e-905f-4165-8b8a-8772679efa26,posted,Electricity Bill Payment,-1022.08,ac8389a2-fff2-47bd-a117-47c5f9a33dad,2428.83,debit,bank-fee,AU00000,2023-09-22T11:29:15Z
transaction,c218e2cf-e085-4b7a-b3ac-c767bda444f1,posted,Bookstore Purchase,-4201.11,ed662416-ad60-4d56-83d4-1c5a2cd5cb76,-1772.28,debit,cash-withdrawal,AU00000,2023-10-03T17:50:28Z
transaction,7775d29d-b4d4-4256-8836-331f166fbdbf,posted,Wdl ATM WESTPAC IGA BALGOWLAH BALGOWL AU,-2321.83,d14f084a-dd95-4df4-9f09-cc88a92e1b6e,-4094.11,debit,payment,AU00000,2024-01-29T07:05:50Z
transaction,6780f3a3-147c-4f72-a80f-7fb0df577c60,posted,Non Hooli ATM Withdrawal Fee,-2136.18,aa1379b2-2d10-43ec-b445-d996b8e9e8e0,-6230.29,debit,bank-fee,AU00000,2023-07-21T01:39:23Z
transaction,d3d8dc21-f024-4dc1-9773-126efc1262e1,posted,Restaurant Dinner,-989.52,0287b410-69dc-4e7d-ae1d-37f276e58482,-7219.81,debit,bank-fee,AU00000,2024-03-13T22:24:59Z
transaction,ee78f2a4-5cb9-4151-9ceb-453c4431952a,posted,TFR Acc14000 TO 12389,-4159.85,10d63827-e874-427e-98c6-8fcd5df9b6a2,-11379.66,debit,bank-fee,AU00000,2023-08-24T03:28:50Z
transaction,76021862-7971-4299-84ed-7408761917ba,posted,Hair Salon Appointment,-1239.49,434a12ff-2782-411a-8641-7559904104ed,-12619.15,debit,cash-withdrawal,AU00000,2024-04-17T14:06:31Z
transaction,10ee7aca-1ac4-4bca-bb59-83ba1e8f9613,posted,Movie Ticket Purchase,-607.11,2a19f52d-9318-458c-a717-00c071da4e4f,18748.79,debit,payment,AU00000,2023-07-25T14:06:01Z
transaction,11597106-bd1a-42ed-a441-03922bd98e1a,posted,Travel Agency Booking,-2116.0,d5c29304-3eb2-45d8-821c-51d08d57d604,16632.79,debit,bank-fee,AU00000,2024-04-01T07:40:18Z
transaction,9e0e5b6a-c543-4ae9-b1ed-3c0318d40b69,posted,Online Gaming Purchase,-3462.65,fea94b3f-11a6-427a-9d61-bc0b5104547f,13170.14,debit,bank-fee,AU00000,2024-05-07T01:47:13Z
transaction,1eafc6b8-d0f2-4191-87fe-a6ae4c159cfc,posted,Non Hooli ATM Withdrawal Fee,-2701.12,c372db88-9780-43f0-964b-280e70bfdbe9,10469.02,debit,bank-fee,AU00000,2023-12-01T22:19:40Z
transaction,2d839c43-3107-411a-b436-a1adaabde6a9,posted,Coffee Shop Purchase,-2543.68,942e515e-eb3d-43af-8941-a378ec6fdcf4,7925.34,debit,payment,AU00000,2024-03-03T14:28:42Z
transaction,85ae7660-45f1-49af-a914-326a43c95556,posted,Public Transport Fare,-4590.2,030d17f5-1332-4c1f-b9c0-d3c7166bc2de,3335.14,debit,bank-fee,AU00000,2024-04-23T03:46:08Z
transaction,105c366c-aa5a-4645-aef5-48132f7bab68,posted,Mobile Phone Bill Payment,-2903.69,5439d4da-2eb2-4183-b3b8-18c6df20d75e,431.45,debit,payment,AU00000,2023-11-19T18:25:19Z
transaction,c82bab66-bb72-49ba-b925-9a411d2aff4f,posted,Gasoline Purchase,-221.36,9c8c2b86-0bf2-48c7-a05f-e4f51c57ede4,210.09,debit,bank-fee,AU00000,2023-05-15T17:45:58Z
transaction,dea029c8-10b3-4ffd-81d9-d5bdcfa15bda,posted,CTRLINK CARERS Ref: 998R6789201610974V,-1508.28,97370675-4243-4947-82fb-d7310d408a0d,-1298.19,debit,bank-fee,AU00000,2023-05-27T17:30:00Z
transaction,352705e0-d7a1-49f0-aca7-1a163c32532f,posted,Movie Ticket Purchase,-2486.1,d2e927f5-9ca7-4f80-b7e0-2ad8abc85f31,-3784.29,debit,cash-withdrawal,AU00000,2024-05-06T12:23:57Z
transaction,dac257c2-a3d7-4691-93eb-ac8631380400,posted,Coffee Shop Purchase,-788.27,68ea9cd6-3ad1-4cca-89c3-d82ea4f57680,17768.44,debit,payment,AU00000,2023-11-02T10:56:59Z
transaction,0ca11006-5280-44d0-830c-caad27db5f35,posted,Manly Maths Tutor Wages,-4383.03,a65962c8-4ff4-45d3-bf8a-b968f1984a71,13385.41,debit,cash-withdrawal,AU00000,2024-03-27T06:15:53Z
transaction,0e7d166c-963e-46c7-8dbf-f121263f3ece,posted,Mobile Phone Bill Payment,-4448.19,c6c2718b-f3b4-4f5e-a8b5-d793e9115f17,8937.22,debit,payment,AU00000,2023-12-27T16:49:43Z
transaction,d34e9596-00b4-459c-a7bd-1f1f89742db2,posted,CTRLINK CARERS Ref: 998R6789201610974V,-3580.04,b0ae2460-3f35-415d-a809-b083ca6eb5cf,5357.18,debit,payment,AU00000,2023-09-02T10:05:23Z
transaction,d2a50ef5-b1dd-466a-a568-ecd805b95c0e,posted,Wdl ATM WESTPAC IGA BALGOWLAH BALGOWL AU,-4719.32,7d869671-f6c4-4d54-a2f0-815299ea0902,637.86,debit,payment,AU00000,2024-04-30T02:18:57Z
transaction,4d36f46a-a0f0-4c1e-a296-f4737a1b4576,posted,Uber Ride,-1931.07,253f1e58-155f-4ee5-9900-b635f2c1d547,-1293.21,debit,bank-fee,AU00000,2024-02-19T13:24:12Z
transaction,9bd81fcc-1c35-421a-a783-2f5780193eaf,posted,Music Streaming Subscription,-2049.73,7581ca35-5de6-4fe0-8041-f902cd4873b4,-3342.94,debit,cash-withdrawal,AU00000,2024-02-19T05:31:36Z
transaction,c457a2e2-ae74-4786-aae3-65894aa7bc0d,posted,Restaurant Dinner,-947.55,0ac39cb7-b0f3-4c69-af3b-08131d4a3ece,-4290.49,debit,bank-fee,AU00000,2024-02-03T14:44:13Z
transaction,6e734760-5f51-4185-996a-8aad47dc8e06,posted,Netflix Subscription,-4866.23,8515ad0f-46c3-4089-9910-3aabe4ac61a9,-9156.72,debit,cash-withdrawal,AU00000,2023-11-28T13:58:11Z
transaction,24bbd4d1-d18f-4951-a6b6-f2eb61560753,posted,Car Maintenance Expense,-1935.77,07cfd968-33e6-45b7-a4ea-0a3179fe0308,-11092.49,debit,payment,AU00000,2023-06-14T06:18:28Z
transaction,afd33851-2c57-48c0-961a-a359b5ac2c0e,posted,Hair Salon Appointment,-35.14,3a0546ff-1a4b-4cc8-b663-f6c82ab9fb81,17144.41,debit,cash-withdrawal,AU00000,2023-07-05T23:20:41Z
transaction,942c3add-0d7f-4ef0-aef2-617ee4b86c54,posted,Movie Ticket Purchase,-778.74,c1e58c5b-90d1-4487-a942-d63ab4ca55b3,16365.67,debit,cash-withdrawal,AU00000,2023-05-20T15:44:02Z
transaction,69b69352-672d-4fdf-bb5c-b7eefa2bc9c9,posted,Non Hooli ATM Withdrawal Fee,-4092.84,3a866209-83e9-46b0-b3ec-eb36d087efe5,12272.83,debit,payment,AU00000,2023-06-19T19:55:56Z
transaction,1eab0cb1-f176-4efb-93ed-9c4c2a877c5c,posted,Mobile Phone Bill Payment,-23.76,98f457fe-30c4-40f1-ab2b-5ca296f67933,12249.07,debit,payment,AU00000,2023-06-18T15:55:06Z
transaction,306fcef5-c798-4133-a721-c4abcef1062a,posted,CTRLINK CARERS Ref: 998R6789201610974V,-3644.58,e1ce375d-896e-433d-b981-823fc6584506,8604.49,debit,cash-withdrawal,AU00000,2024-03-07T12:22:06Z
transaction,c387bc7a-6cca-45c4-979a-c4ef89cff419,posted,Gym Membership Fee,-4204.67,e5353f97-ef80-4528-810d-93e589e34506,4399.82,debit,cash-withdrawal,AU00000,2023-11-24T23:18:12Z
transaction,2a6b4371-f998-4035-a9e5-d4d40f3607eb,posted,Pharmacy Purchase,-154.22,1122cffb-7712-40c9-96ae-46b601663768,4245.6,debit,payment,AU00000,2023-10-30T01:43:58Z
transaction,146f767a-892a-4606-a44a-233adcbd9a9a,posted,Payroll WFRMS 15439393,10406.46,41c939c8-1cbe-4db5-9bde-f9c6603ddbf2,14652.06,credit,transfer,AU00000,2023-12-12T06:15:01Z
transaction,08ee7b17-6c1b-45b2-9571-70bb0152a786,posted,TFR Acc14000 TO 12389,-3478.28,6e876529-05f9-4dfd-91e9-13497a4663ef,11173.78,debit,payment,AU00000,2023-11-02T23:27:32Z
transaction,411d4a86-c635-485d-8d0c-507547042f1c,posted,Music Streaming Subscription,-678.88,ed3ad468-7da4-4242-b5e6-71bd35a51560,10494.9,debit,payment,AU00000,2024-04-06T03:20:19Z
transaction,63f1cb4c-6bc8-4090-b934-31e12b02902b,posted,Netflix Subscription,-3474.49,a066a9a4-326c-4217-a74a-6da39b6252a4,1741.48,debit,payment,AU00000,2024-03-02T22:42:08Z
transaction,08ea8d5c-2f5b-4944-b873-e92796b8f965,posted,Home Improvement Store Purchase,-3819.36,f8bd046b-dbc9-4e80-af1d-526eecf527d7,-2077.88,debit,cash-withdrawal,AU00000,2024-04-11T15:37:18Z
transaction,9c656296-d861-4883-9595-76b6791f8fcb,posted,Music Streaming Subscription,-533.48,4f200d16-ed14-4ec4-a4c3-567853784c90,-2611.36,debit,bank-fee,AU00000,2024-02-08T13:29:31Z
transaction,b4973a10-58e2-45e9-ba67-d9db2a310597,posted,Coffee Shop Purchase,-3136.84,22291a9e-cea5-4aa9-ab98-14c23f525d67,-5748.2,debit,bank-fee,AU00000,2024-02-20T23:45:30Z
transaction,f20303cc-0763-411c-96fe-ebe69fee8ab6,posted,Gym Membership Fee,-2245.63,4bf7005d-a4a5-4b71-a041-d3ba86167f04,-7993.83,debit,payment,AU00000,2023-09-25T20:37:15Z
transaction,5dcb9fbe-df41-477d-9549-85d74c04729f,posted,Gasoline Purchase,-3241.05,96b7fe66-a505-4577-9dd6-ee82e074f2c7,-11234.88,debit,bank-fee,AU00000,2024-03-26T02:33:36Z
transaction,ee882744-3177-45ce-8836-631b82c46c52,posted,Music Streaming Subscription,-3510.76,93ae562a-1365-49a1-b096-b99e828a1fd4,-14745.64,debit,bank-fee,AU00000,2023-08-08T10:10:06Z
transaction,d5eab9bb-7a6b-4f54-a4a2-17808785630e,posted,Gasoline Purchase,-2974.01,19768630-d905-4bff-9ad7-1b3058807a8a,-17719.65,debit,cash-withdrawal,AU00000,2023-10-01T23:21:11Z
transaction,aced7a95-b135-45bc-8d21-205a9e098a9b,posted,Online Gaming Purchase,-2766.7,713acd24-b6f3-425b-a36e-24dddde14f49,-20486.35,debit,bank-fee,AU00000,2023-12-09T04:29:48Z
transaction,0697d7ed-7975-47e4-8e92-2e1c072f5717,posted,Hair Salon Appointment,-536.95,e5ab4043-771c-424d-9c43-aaa993ea1dd4,-21023.3,debit,cash-withdrawal,AU00000,2023-07-02T14:20:59Z
transaction,58417088-161e-4445-8cc5-b3fe1da08de1,posted,Car Maintenance Expense,-3179.98,b5e1291c-60f7-48bf-a651-ee30a063893a,14471.45,debit,cash-withdrawal,AU00000,2023-11-18T12:02:00Z
transaction,3c30870e-0672-403e-937b-116ecb48069c,posted,Coffee Shop Purchase,-1205.81,9c7e1496-08fa-4107-b27e-255c95d22440,13265.64,debit,bank-fee,AU00000,2024-05-04T15:28:34Z
transaction,7d0370f9-dc4b-48b0-8556-69166401bafe,posted,Travel Agency Booking,-3992.19,7bd0f046-4435-4e2d-8c36-db577af211f5,9273.45,debit,payment,AU00000,2024-04-24T06:16:46Z
transaction,b09efc9f-f54f-4915-9b31-947aa7b40090,posted,Electricity Bill Payment,-4390.93,3e3b8ecd-ea75-486a-980c-ca6c45309a85,4882.52,debit,payment,AU00000,2023-12-24T23:37:33Z
transaction,7e6a5284-b29d-45bc-a6c3-ef05c4e7a237,posted,Music Streaming Subscription,-231.53,5b6de916-8af7-4810-abce-ddc6393a3a4b,4650.99,debit,payment,AU00000,2023-08-25T02:08:18Z
transaction,208a88ce-f0c7-429c-8ecc-5b8996ffe1fc,posted,Home Improvement Store Purchase,-3871.6,5227facf-97ba-4da5-8c88-c31d3a78396e,779.39,debit,payment,AU00000,2023-05-20T05:15:18Z
transaction,1732ce18-612a-4f8a-9960-2ea93027ce70,posted,CTRLINK CARERS Ref: 998R6789201610974V,-1388.51,320302bf-f8ef-4629-a28e-0185b26f98d2,-609.12,debit,cash-withdrawal,AU00000,2023-08-12T14:58:23Z
transaction,5190559e-1223-4e1c-b5e3-15a7d2e41eb4,posted,Netflix Subscription,-1478.25,f9dff763-fc1e-4d31-b370-1dfa1565fb7a,-2087.37,debit,bank-fee,AU00000,2023-05-18T04:11:39Z
transaction,c1e766b5-f37e-4975-903e-42a799af5cf4,posted,Gym Membership Fee,-4717.4,6db1d0cc-98fd-4966-af02-30e34a24c359,-6804.77,debit,payment,AU00000,2023-10-22T16:15:03Z
transaction,8a5f5867-8fb9-4cbb-a59e-8777bec13162,posted,Mobile Phone Bill Payment,-2162.16,2ac4bf53-606c-46da-ba49-3062256307ab,-8966.93,debit,payment,AU00000,2023-06-26T16:52:27Z
transaction,50ec4844-c3b9-4811-823b-60ad6872b068,posted,Electricity Bill Payment,-3547.64,7d49bcef-1bcf-4ede-87b4-39ad9dd023f7,8034.61,debit,bank-fee,AU00000,2023-12-09T06:59:45Z
transaction,3bd70a3d-eb2a-4e26-8d30-ec26f6485fb5,posted,Wdl ATM WESTPAC IGA BALGOWLAH BALGOWL AU,-2767.38,cd60635d-8f37-4c47-a822-3d0df3b55632,5267.23,debit,cash-withdrawal,AU00000,2024-02-26T00:17:48Z
transaction,31d11b24-fe7f-4755-9992-6a15125b9093,posted,Electricity Bill Payment,-3349.83,de859f4f-168e-4698-9e50-69ccf7b26473,1917.4,debit,bank-fee,AU00000,2023-06-20T17:45:38Z
transaction,a1fe1842-6249-43be-b24c-61127b9497ff,posted,Movie Ticket Purchase,-2401.84,a7ca92f0-07a4-460b-a8ea-b2c1a2612e6f,-484.44,debit,cash-withdrawal,AU00000,2024-02-24T06:15:57Z
transaction,34810f20-97d7-41a7-bc4c-2f5d565e2c8e,posted,Gym Membership Fee,-803.64,d10f42aa-7bbd-4fb3-b920-e75936554976,-1288.08,debit,bank-fee,AU00000,2023-11-05T23:51:05Z
transaction,8c96258a-d429-4c34-bd28-cbea34ddc3c2,posted,Mobile Phone Bill Payment,-1662.81,b7960fc7-487e-4204-a521-1370eca9fb48,-2950.89,debit,cash-withdrawal,AU00000,2024-01-27T16:05:09Z
transaction,ded19367-94aa-4174-95c3-f10505aba836,posted,Electricity Bill Payment,-2027.14,74731aa5-1513-4d65-a1cb-8b2dfe45f88c,-4978.03,debit,bank-fee,AU00000,2024-02-22T10:20:51Z
transaction,93986968-0ad2-46eb-b070-4e447b113ecf,posted,Gym Membership Fee,-1999.2,f8840998-0fa7-47e6-a272-21850834599a,-6977.23,debit,bank-fee,AU00000,2023-06-29T01:46:52Z
transaction,c31ca626-42e8-4734-b2b9-6092ab9cf8b5,posted,Transfer Platnm Homeloan 346454,-3785.85,f97fffce-7cbd-42d2-b6de-27dee3fbc08b,-10763.08,debit,cash-withdrawal,AU00000,2024-01-14T12:54:05Z
transaction,d81e14f6-c90c-4572-ac86-c3c85580e74c,posted,TFR Acc14000 TO 12389,-635.36,7df4c868-78e9-48a4-bbbd-71d51bc613a2,-11398.44,debit,payment,AU00000,2023-12-31T18:00:33Z
transaction,e68eff68-9c92-405d-b33c-dcca3435dcab,posted,Bookstore Purchase,-4036.29,87c3be4d-7aa9-4e85-a946-3ad716654eac,3532.35,debit,bank-fee,AU00000,2023-10-15T05:18:20Z
transaction,e567fbc5-0382-48e4-89f2-6ca453bfa6bc,posted,Music Streaming Subscription,-2743.69,bb337eaf-d36a-478b-9129-951ccdca4f42,788.66,debit,cash-withdrawal,AU00000,2024-05-04T21:26:18Z
transaction,6c32c8fb-7805-4f69-9903-24d693c47c9b,posted,Hair Salon Appointment,-4807.68,a71d99ca-b2a8-47ba-928f-bcf76295d495,-4019.02,debit,cash-withdrawal,AU00000,2023-08-12T20:30:47Z
transaction,1a26af61-3931-4f87-9223-b1b5eefff3d5,posted,Pharmacy Purchase,-2252.11,1ad1ca52-23cf-4172-bda0-c2acc9d2fb9a,-6271.13,debit,bank-fee,AU00000,2023-11-05T10:43:10Z
transaction,2d1dc55e-2169-4e7d-9848-1f201860cf88,posted,Transfer Platnm Homeloan 346454,-758.3,afe9566b-ccbd-4ac1-a60a-82d22042d983,-7029.43,debit,cash-withdrawal,AU00000,2023-11-30T18:10:15Z
transaction,dcd6fb05-9cfe-43fe-a8a7-6e4bbf27fe64,posted,Mobile Phone Bill Payment,-3387.81,0a9e9e02-d175-4279-9a0e-cc577af64da7,-10417.24,debit,cash-withdrawal,AU00000,2023-08-22T04:52:47Z
transaction,261c20a3-e404-489b-a5b2-d11569c8795a,posted,Non Hooli ATM Withdrawal Fee,-3540.96,0355af30-5041-49b8-8408-2e79706799b3,-13958.2,debit,bank-fee,AU00000,2023-08-07T02:41:10Z
transaction,8640bce4-d659-46d4-8a03-de21b51fa208,posted,AGL RETAIL ENERGY LTD (GAS),-961.15,b12510ea-5119-4e95-836d-b8fcc6393ef8,-14919.35,debit,payment,AU00000,2023-06-12T21:31:54Z
transaction,0e769e44-f902-4e39-993d-1d5ac7cbf031,posted,Clothing Store Purchase,-2619.49,eb4c5cef-e458-4404-9ab3-e9d0f0003ee7,-17538.84,debit,bank-fee,AU00000,2023-10-29T03:58:21Z
transaction,8a86a79d-e010-4e3f-9c9b-7831e0210662,posted,AGL RETAIL ENERGY LTD (GAS),-4033.93,77094232-72eb-4f9d-bb52-c53152e8cd5a,-21572.77,debit,bank-fee,AU00000,2023-06-26T00:31:01Z
transaction,357a1722-db4b-40b8-a5af-3797fc622f49,posted,Payroll WFRMS 15439393,10463.04,f2c6a28f-2b73-4b3e-b3ed-574122029e5d,27769.95,credit,transfer,AU00000,2023-08-13T04:05:31Z
transaction,9a62f3e7-049e-4af0-9241-455d7386b269,posted,Home Improvement Store Purchase,-4380.4,0c092d98-0f7a-4f35-bea9-7c7f95e9f214,23389.55,debit,payment,AU00000,2023-09-19T19:46:53Z
transaction,052eb74c-eed2-47f7-bc30-d3c6f87d72ad,posted,Payroll WFRMS 15439393,11903.4,4e9d35e1-aee2-4d8d-9491-ba1fe63da9c0,35292.95,credit,transfer,AU00000,2024-02-16T00:52:36Z
transaction,1a35c8cc-fd01-4494-8d30-ca3ad7109259,posted,Car Maintenance Expense,-1910.49,5cc15e6a-0ac6-4e64-8e87-7c8febf0b551,33382.46,debit,cash-withdrawal,AU00000,2023-12-21T04:31:02Z
transaction,8234d5d3-1412-4958-afd4-fabf3f3a2ce6,posted,Wdl ATM WESTPAC IGA BALGOWLAH BALGOWL AU,-4254.5,68d0eae9-07c5-4972-b66d-7fd5aaaf172b,29127.96,debit,payment,AU00000,2023-06-12T03:14:26Z
transaction,ac49b168-3dd1-4ca5-a5cd-a979c14eb8aa,posted,Netflix Subscription,-1260.65,05b46c57-772d-461e-9383-405bc7d97520,27867.31,debit,cash-withdrawal,AU00000,2023-06-18T12:57:22Z
transaction,02dfec44-eacd-4fa7-80b2-2d5164a01b1e,posted,Movie Ticket Purchase,-2632.07,1bbb3e5d-47c5-472f-a436-9f6df39825dd,25235.24,debit,bank-fee,AU00000,2024-04-27T15:09:45Z
transaction,3189c3a0-754f-47ee-ba4a-729c2d0953f7,posted,Clothing Store Purchase,-2018.45,464d7312-615b-485a-8d86-f5db54aa82c9,23216.79,debit,bank-fee,AU00000,2023-06-10T16:13:43Z
transaction,c711d332-6ddc-4b2d-911e-8ef262993a88,posted,Gasoline Purchase,-1236.93,23273c86-548a-4127-8565-df1125723675,21979.86,debit,bank-fee,AU00000,2023-10-11T15:56:47Z
transaction,90f02711-1fcd-4b12-9c03-8306409f57f7,posted,Gasoline Purchase,-65.7,43ac0f17-d7e4-450c-b5f5-0f5cd5ef858e,21914.16,debit,payment,AU00000,2023-10-04T23:22:19Z
transaction,456b3421-03ed-4ff9-a597-180b0139498d,posted,Gasoline Purchase,-2233.46,1cc90f97-1154-485e-826b-99c4c5a80dd3,9013.85,debit,bank-fee,AU00000,2024-05-03T11:39:19Z
transaction,ba4acede-2bc8-4d77-b485-a0876980d4e9,posted,Home Improvement Store Purchase,-105.88,e4c20bf3-2854-4297-8454-b003b0be912b,8907.97,debit,payment,AU00000,2023-11-07T01:57:05Z
transaction,552fd23a-1e4b-4d7c-b46a-66a0298ac270,posted,Transfer Platnm Homeloan 346454,-822.27,e70abfb8-15c5-4e0a-a358-03a3606d7d8e,8085.7,debit,cash-withdrawal,AU00000,2024-03-19T04:51:45Z
transaction,9972aa99-be62-4d28-b701-6d5e8d623dfa,posted,Payroll WFRMS 15439393,11117.89,0e1d47ce-e49f-4f9a-8f74-280bfd5b2232,19203.59,credit,transfer,AU00000,2023-07-19T09:51:04Z
transaction,27145659-fdc1-4ebe-8819-038d87d3842d,posted,TFR Acc14000 TO 12389,-2816.37,feb7771b-c6a0-4963-aa02-3730d82b70fc,16387.22,debit,bank-fee,AU00000,2023-11-23T20:47:38Z
transaction,dd4ca270-615a-4b1c-9b4c-e840e7977832,posted,Transfer Platnm Homeloan 346454,-1398.23,fc98bf0f-77af-4e8a-9f9f-3b7245cb3349,14988.99,debit,payment,AU00000,2023-07-02T15:56:22Z
transaction,09b797c5-5f43-4d4c-874b-c7cd5e163f7f,posted,CTRLINK CARERS Ref: 998R6789201610974V,-3012.01,8733ca56-37b7-45fd-9268-7ac06bcd6a3b,11976.98,debit,bank-fee,AU00000,2024-01-09T15:12:56Z
transaction,9d4127d8-7135-4ef2-af06-0ea46cb6a3fa,posted,CTRLINK CARERS Ref: 998R6789201610974V,-1299.62,3e38da97-6a8b-4f43-b27b-788ad55daa1f,10677.36,debit,payment,AU00000,2023-05-22T01:37:39Z
transaction,a206ebd4-82d2-4909-9e90-8e614e7303b9,posted,Restaurant Dinner,-4575.08,22df96c0-d43f-4537-bc35-16a875a00d7c,6102.28,debit,bank-fee,AU00000,2024-02-29T00:15:24Z
transaction,851f8272-a9e1-4817-85f0-51a4be6a16dc,posted,Manly Maths Tutor Wages,-3336.24,06303050-7eb2-41c1-827d-e3759fc61211,2766.04,debit,payment,AU00000,2023-08-27T14:59:03Z
transaction,ae66885c-7bef-4167-8a5c-a03407aa0056,posted,Non Hooli ATM Withdrawal Fee,-1003.78,bda0a72e-f046-41af-bc31-1a2457e00006,8459.21,debit,payment,AU00000,2024-01-25T08:07:55Z
transaction,469f459e-8992-402f-b392-865b12f7536a,posted,Payroll WFRMS 15439393,11791.43,f3c60538-feef-48ef-967c-9aae9fb4d7f6,20250.64,credit,transfer,AU00000,2024-01-19T20:18:11Z
transaction,b439db2b-bd4b-4114-8636-999367f40029,posted,Coffee Shop Purchase,-3612.37,4f90c7bf-f9bc-451b-a9db-dbe788e95c9b,16638.27,debit,payment,AU00000,2023-05-25T20:36:42Z
transaction,c972e2f2-e64e-4370-95c7-11df4a9d508f,posted,Electricity Bill Payment,-4232.43,6dee7e9c-3055-419d-b56c-2073fc1897a5,12405.84,debit,bank-fee,AU00000,2024-01-26T01:31:52Z
transaction,d8c8d75f-1afc-42f9-a8d0-50a344d172ab,posted,Wdl ATM WESTPAC IGA BALGOWLAH BALGOWL AU,-4194.0,6c35fbaf-4d54-4f41-8e3c-f64d4889c763,8211.84,debit,cash-withdrawal,AU00000,2023-10-24T08:05:23Z
transaction,548e730c-a6d0-4f60-9b1d-794332f695db,posted,Travel Agency Booking,-2631.99,3efd790c-23ee-4a50-b5fa-a481a44128a4,5579.85,debit,bank-fee,AU00000,2024-02-28T17:45:42Z
transaction,aaaeecd5-dbcd-4296-8ed6-68a969fc6616,posted,Electricity Bill Payment,-4525.51,f6185214-a9d9-4259-8bf2-1edde8dac061,1054.34,debit,cash-withdrawal,AU00000,2024-02-26T06:05:04Z
transaction,36017e88-cf36-480a-82ed-e1ad27763ba9,posted,Netflix Subscription,-488.92,32e86a73-86b9-4dc4-ad12-2bd83cc6f573,565.42,debit,payment,AU00000,2023-12-15T14:38:59Z
transaction,a1e2328b-e808-4901-9b92-cdb882a27197,posted,Bookstore Purchase,-1559.84,b32e26b3-04f7-4be1-b9d8-4192590b8896,-994.42,debit,cash-withdrawal,AU00000,2024-01-14T13:20:44Z
transaction,9b569be8-3714-4454-8685-3f1b804ea077,posted,Electricity Bill Payment,-1732.04,356b0b88-b1c3-4ec4-b13e-e14822fe310b,-2726.46,debit,cash-withdrawal,AU00000,2023-11-16T20:07:46Z
transaction,8266c953-c764-437a-a87d-486a382ac984,posted,Online Gaming Purchase,-4786.79,5a713dd2-3895-4fd5-99ab-c4ec604d07b5,14242.65,debit,bank-fee,AU00000,2024-02-05T06:30:30Z
transaction,df9dbdc0-6992-42c5-84be-f1ef3a690225,posted,Uber Ride,-687.06,833ae873-b22d-4f01-8486-167e330a141c,13555.59,debit,payment,AU00000,2023-05-20T14:16:59Z
transaction,20282454-adac-423b-95a3-f8f1e7be9428,posted,Public Transport Fare,-234.51,c89c965f-4582-4bf9-ac61-5d5f763f9e91,13321.08,debit,bank-fee,AU00000,2023-05-27T01:51:50Z
transaction,a11f0e18-a5c4-477e-914a-8c6ab3cffc9b,posted,TRANSFER TO JOANNA SMITH CAMPING,-3711.4,f32d97b5-f8ae-4997-8a1f-0e5b01c357c2,9609.68,debit,cash-withdrawal,AU00000,2023-05-31T03:23:39Z
transaction,bc8be8e7-a2f2-4685-9f96-5a3315382768,posted,Movie Ticket Purchase,-1866.5,0da56bab-8f01-4269-92b3-504f27faaf99,7743.18,debit,bank-fee,AU00000,2023-06-07T16:53:32Z
transaction,cc77114a-84d9-46fb-bb8b-4885c995f7b4,posted,Manly Maths Tutor Wages,-1150.4,70d1cf66-884d-4fd4-bf5a-bda58ac18260,6592.78,debit,payment,AU00000,2023-11-08T11:56:20Z
transaction,e847a3f7-784c-47c9-8892-7fa6b68602b7,posted,Pharmacy Purchase,-4843.21,4979a6fb-5b8f-460e-b1e5-672a1cd19479,1749.57,debit,payment,AU00000,2023-06-29T14:15:12Z
transaction,eca71fd6-46b9-449a-b9b3-cb3c021108c0,posted,Music Streaming Subscription,-1600.99,91a3e8e1-1e8b-44e2-9a1e-376b644af83f,148.58,debit,cash-withdrawal,AU00000,2023-10-22T02:10:45Z
transaction,f1433c8a-459f-4417-b5e8-422657380765,posted,Coffee Shop Purchase,-3757.46,efcafd3b-9538-413d-b2d4-2a77502582fc,-3608.88,debit,payment,AU00000,2024-01-09T19:56:37Z
transaction,dd96d094-3221-4b08-85ca-34afea86ce62,posted,Wdl ATM WESTPAC IGA BALGOWLAH BALGOWL AU,-3623.68,71477da9-3c31-439e-a43a-2a160da7c3c4,-7232.56,debit,bank-fee,AU00000,2024-04-05T05:33:43Z
transaction,30833820-69a8-40ad-ba64-19546697be9f,posted,Online Gaming Purchase,-1329.16,e56c6061-1aa2-4079-95a9-eb0e6611200d,12369.63,debit,bank-fee,AU00000,2024-04-19T20:52:21Z
transaction,c1c52332-319c-498f-a6b7-6ab35fd8ded7,posted,Hair Salon Appointment,-2906.53,f235d7be-0582-4ff9-8e6e-40968b5ecfe9,9463.1,debit,payment,AU00000,2023-09-27T18:41:25Z
transaction,cf3e6c36-c791-46e7-a01e-6e0cd68597d9,posted,Wdl ATM WESTPAC IGA BALGOWLAH BALGOWL AU,-3233.64,744df4db-6edd-499d-8788-f786017a7257,6229.46,debit,payment,AU00000,2024-01-15T10:32:51Z
transaction,3519ab1f-e4cc-4147-b0e8-b3acc460c66a,posted,Coffee Shop Purchase,-2808.55,18f95412-a5dc-427b-9808-2b23ffcac798,3420.91,debit,bank-fee,AU00000,2023-05-23T05:31:38Z
transaction,534fdecf-fa40-4a14-bed0-7db14782984f,posted,Wdl ATM WESTPAC IGA BALGOWLAH BALGOWL AU,-2977.71,4f63b239-722f-4f94-890f-3f773889d35f,443.2,debit,cash-withdrawal,AU00000,2023-10-27T13:11:14Z
transaction,39d71a2c-7376-4a99-8174-34c6e1cb0404,posted,Wdl ATM WESTPAC IGA BALGOWLAH BALGOWL AU,-2195.23,e93fde65-a193-4358-aef3-e004ca6d64c9,-1752.03,debit,bank-fee,AU00000,2024-05-08T18:42:27Z
transaction,318eca09-08e5-4e2c-8f45-558c3d73ec69,posted,Gym Membership Fee,-530.09,3f567906-f43f-4e81-b009-4ab4a82e1e34,-2282.12,debit,cash-withdrawal,AU00000,2023-05-26T19:43:36Z
transaction,7f09bfcd-6a1d-4ef9-94dd-3eb66ad156d1,posted,Gasoline Purchase,-2949.36,0e901d0c-6370-409f-a010-3746ee9a0ae4,-5231.48,debit,cash-withdrawal,AU00000,2024-01-27T13:13:15Z
transaction,1aea194a-ba69-4714-9eed-59c6f1621cc0,posted,Restaurant Dinner,-3538.96,831a4b37-20cc-4e76-806d-12f53d3dee06,-8770.44,debit,bank-fee,AU00000,2023-08-23T09:29:07Z
transaction,4d8d3a11-21a4-4c77-8b91-0567a989bf19,posted,Manly Maths Tutor Wages,-880.82,1927d5f4-4135-4f6d-b223-e9b4deb58c48,-9651.26,debit,cash-withdrawal,AU00000,2023-08-18T21:43:40Z
transaction,021b7a8c-54e7-45c2-b514-90966b115f5b,posted,Public Transport Fare,-1168.1,ab76bf7d-e43a-4bae-b2d0-844776375081,9072.02,debit,cash-withdrawal,AU00000,2024-04-11T06:27:16Z
transaction,3fc61d1a-13ce-4f3d-8e57-71baf6f971c0,posted,Non Hooli ATM Withdrawal Fee,-215.99,3707e267-3be8-4f91-8558-b69429a707ef,8856.03,debit,cash-withdrawal,AU00000,2023-05-18T20:16:27Z
transaction,b6e2ab16-16bd-4eff-bb7a-1d1516ff46bf,posted,Public Transport Fare,-779.0,1ab548fa-4567-4af6-a533-050ef42723d9,8077.03,debit,bank-fee,AU00000,2023-12-27T23:36:03Z
transaction,c1b3681a-40bd-4347-a349-198495c0d275,posted,AGL RETAIL ENERGY LTD (GAS),-2418.32,fb4c623a-8166-49a8-b855-24abed5e130a,5658.71,debit,payment,AU00000,2024-03-27T12:21:06Z
transaction,c4271baa-8e8b-4cc2-861b-b57fcb1a690c,posted,Online Gaming Purchase,-3647.02,0281d188-5f4d-478e-8ee9-1c34cdcc65db,2011.69,debit,cash-withdrawal,AU00000,2023-11-05T01:09:40Z
transaction,45da0b1a-9a8f-4f40-a5d3-0a3ee3f818e9,posted,Manly Maths Tutor Wages,-881.51,fec8b999-882a-4e9a-9d52-4d9c0e6043c5,1130.18,debit,bank-fee,AU00000,2023-06-19T05:47:34Z
transaction,a9c9a289-fce2-4a29-9387-70d6eb320786,posted,Manly Maths Tutor Wages,-3970.78,71a077b2-688d-456e-a63e-e1777f5245a3,-2840.6,debit,bank-fee,AU00000,2023-11-30T09:53:33Z
transaction,4cc9656b-c88a-41d0-9470-b304b2ca1422,posted,Gasoline Purchase,-2423.1,d62ed6a0-d550-4253-9f1b-8f4664694706,-5263.7,debit,bank-fee,AU00000,2023-06-08T16:38:25Z
transaction,5e50959b-a59a-479b-b38b-c72d7ccf30a2,posted,Netflix Subscription,-3227.94,df301865-1b02-42b0-ba88-3515e7286062,-8491.64,debit,cash-withdrawal,AU00000,2023-06-10T21:30:59Z
transaction,f0ceb2e4-90b4-47b0-ae3f-2767852a3449,posted,Bookstore Purchase,-2288.47,297cd144-bfad-4810-b275-101f216f0f77,-10780.11,debit,payment,AU00000,2023-07-10T02:25:54Z
transaction,f66272a3-645c-4209-8954-f195882583c1,posted,Wdl ATM WESTPAC IGA BALGOWLAH BALGOWL AU,-3418.19,4cc38eab-69bf-4f27-ae7a-cf21e8ef9303,7087.11,debit,payment,AU00000,2023-08-16T09:31:21Z
transaction,d2d28daa-8c2d-415c-bd41-dfc50a55d146,posted,Online Gaming Purchase,-2699.76,a7de3878-325c-42e4-9e33-4a7ebedf14ba,4387.35,debit,payment,AU00000,2024-01-05T18:57:19Z
transaction,8d698ae5-79a5-4481-8e22-4b99074c740d,posted,Bookstore Purchase,-2791.11,35d38dff-8354-48f3-822e-8a7151b5d3c1,1596.24,debit,cash-withdrawal,AU00000,2024-01-20T01:35:40Z
transaction,d8d339b7-4cb6-464a-9ec2-770b8b07db08,posted,Public Transport Fare,-1049.86,907c59bf-a2bb-458f-a294-7d840eda6b60,546.38,debit,bank-fee,AU00000,2024-03-22T11:46:29Z
transaction,d4d3ea38-9196-4e8a-80be-7d0d9e5f8c85,posted,Movie Ticket Purchase,-3683.21,a22d0c47-acfe-48e4-85e7-1f29be1af80e,-3136.83,debit,cash-withdrawal,AU00000,2023-09-01T04:53:38Z
transaction,fcf8efbf-7e38-437d-a5d4-d3de4df623b9,posted,Uber Ride,-478.52,065392ca-4f98-4b76-84b1-01c3b66d2972,-3615.35,debit,cash-withdrawal,AU00000,2023-09-21T13:14:47Z
transaction,ad7ffb5e-ca56-4ab7-a478-f53678af7e53,posted,Hair Salon Appointment,-1508.03,9693ef26-7772-4575-9d2b-256c2fa18690,-5123.38,debit,payment,AU00000,2024-02-03T20:08:15Z
transaction,4a8831d6-5f06-4bd7-8684-161e5113d2c2,posted,Manly Maths Tutor Wages,-3002.23,a6040c31-ccc1-4d65-a58b-aae29e59b66f,-8125.61,debit,payment,AU00000,2023-06-18T11:00:40Z
transaction,cd464ae7-59a0-4a4c-834a-99f76d71b059,posted,Restaurant Dinner,-418.09,8ac37251-2609-41e5-8911-0da9cb0b18f9,-8543.7,debit,bank-fee,AU00000,2024-05-03T07:51:35Z
transaction,e4ecf3d0-52d0-437b-80bf-ea9b26cbd840,posted,TFR Acc14000 TO 12389,-3726.71,2d18638b-785b-4ad1-85c0-3edde492fb7b,-12270.41,debit,bank-fee,AU00000,2023-07-26T13:02:17Z
transaction,4af54fd2-8088-4a45-9abb-35fa9968f848,posted,TFR Acc14000 TO 12389,-3781.54,8c7ae01c-bf7b-4590-a742-a6168bdcd5ad,7348.82,debit,cash-withdrawal,AU00000,2023-09-18T17:56:09Z
transaction,9dc5f435-8292-4bb5-aa2d-4adf08de5548,posted,Movie Ticket Purchase,-4557.17,069b2e83-6707-4b81-a328-f528bb54e5ad,2791.65,debit,cash-withdrawal,AU00000,2023-07-05T11:37:52Z
transaction,822107f1-1bca-4d4e-b08c-e15742b3d844,posted,Movie Ticket Purchase,-4553.0,f773cc7f-8a59-4461-aa7d-bee9461cc779,-1761.35,debit,bank-fee,AU00000,2023-11-04T04:09:01Z
transaction,8583fa36-1dc4-475f-a0a7-922af0b6404a,posted,Manly Maths Tutor Wages,-668.76,6755d47e-9cc2-41ac-adf1-0aa561856a11,-2430.11,debit,payment,AU00000,2024-01-27T15:47:33Z
transaction,23d826b7-109a-4d07-aa6e-7c139910bfe2,posted,Online Gaming Purchase,-1955.59,9b84e245-69a5-4f05-9452-a135f0dbbed6,-4385.7,debit,payment,AU00000,2024-01-01T17:57:27Z
transaction,5912a39f-a918-4734-82b0-4be60312d39f,posted,Bookstore Purchase,-948.85,158ae26b-6bc6-49b0-8ef4-3303bbaca68c,-5334.55,debit,payment,AU00000,2023-08-22T08:01:20Z
transaction,bb79483d-1886-461a-ac65-1dea62594ebb,posted,AGL RETAIL ENERGY LTD (GAS),-1852.24,1dcd12b2-5108-4505-ad54-1130a912a26d,-7186.79,debit,payment,AU00000,2024-01-03T08:43:23Z
transaction,2f9eba83-6a78-4be1-9f18-6b58d96f2fa1,posted,Coffee Shop Purchase,-4901.7,ca6bf90d-0cdc-4a51-acf2-3b84f09a8cb0,-12088.49,debit,cash-withdrawal,AU00000,2024-02-07T02:44:09Z
transaction,4af64b99-7e07-490f-ba2d-da3fd85fb99d,posted,Bookstore Purchase,-407.99,e3daf4ae-f4ae-4bc2-ab80-46785f33659c,-12496.48,debit,payment,AU00000,2023-12-04T16:49:02Z
transaction,e0c6858d-0a33-4a37-ba30-e78d1b6c9807,posted,TRANSFER TO JOANNA SMITH CAMPING,-3000.66,3ee9d1b5-9860-48dc-8fee-ada8c74543aa,-15497.14,debit,payment,AU00000,2023-09-24T10:46:40Z
transaction,ccade7a5-c7e5-4901-8a8f-c5ee527fab22,posted,Electricity Bill Payment,-637.08,a8dafa0b-a73e-4963-88dc-ac4e3cb47b31,12286.71,debit,bank-fee,AU00000,2023-07-03T22:31:06Z
transaction,94e8c29c-ab73-4fb8-b9c3-a87ebd974539,posted,Hair Salon Appointment,-1015.91,f0346f29-aaeb-43ee-9864-8c62b9fcd9f1,11270.8,debit,cash-withdrawal,AU00000,2023-12-19T07:35:29Z
transaction,58e43f43-3a59-4901-820e-480f586d5448,posted,Bookstore Purchase,-1761.8,6a8eaadd-1512-4062-ae6f-6939e0a48e13,9509.0,debit,payment,AU00000,2023-08-01T06:36:55Z
transaction,76134a3b-2f89-4bb9-a7f0-ffde64b3d4c5,posted,Online Gaming Purchase,-1475.61,cb105a93-2902-4b0e-b21a-6aba406c3925,8033.39,debit,payment,AU00000,2023-11-24T21:36:52Z
transaction,e21fb3a7-8496-4693-84d5-7ae2a908d257,posted,Movie Ticket Purchase,-4121.21,4d39f04d-6c52-4dcd-a228-21421b207808,3912.18,debit,cash-withdrawal,AU00000,2023-11-16T18:17:59Z
transaction,4c11c24a-7f68-49b1-ada9-0957090ae1f5,posted,TFR Acc14000 TO 12389,-598.6,69853dcb-424b-4f7a-9998-1e730fe4bed5,3313.58,debit,cash-withdrawal,AU00000,2023-10-28T10:18:34Z
transaction,9b62a099-caa3-4442-a8dc-be23af2b496e,posted,AGL RETAIL ENERGY LTD (GAS),-109.75,bfeba1d7-98eb-448e-bbf1-5b4929b46020,3203.83,debit,cash-withdrawal,AU00000,2023-09-13T19:40:30Z
transaction,5a493b88-0836-48a3-8b4f-4cd0be003183,posted,Netflix Subscription,-3664.61,75e3d992-61d3-47cb-aaa9-0cc041461ee4,-460.78,debit,cash-withdrawal,AU00000,2024-04-01T23:44:05Z
transaction,17a739d2-ac50-4818-8906-c3d42faaecea,posted,Car Maintenance Expense,-2145.78,76d3b04d-01ad-4231-b214-d3ebd03e7944,-2606.56,debit,payment,AU00000,2024-05-08T05:16:24Z
transaction,2238f16f-47e4-4fe4-b78c-3d68854c9b49,posted,Hair Salon Appointment,-279.55,e3117880-edd9-4636-8549-44fbb115ad9a,-2886.11,debit,bank-fee,AU00000,2023-11-15T14:13:41Z
transaction,151371d4-47a4-4e5f-ac1d-024a7f6f4678,posted,Gasoline Purchase,-2551.52,eb382daf-8e11-4916-a29c-5a37a994fda1,7818.26,debit,cash-withdrawal,AU00000,2023-07-03T22:00:32Z
transaction,c29516e3-deb2-46ba-8e2c-8366b46e7061,posted,Restaurant Dinner,-2415.88,4b0c9770-3018-49cc-8a10-4665de07afbd,5402.38,debit,bank-fee,AU00000,2024-04-05T08:45:30Z
transaction,7602968b-9299-4b80-995f-dbbd435305c7,posted,CTRLINK CARERS Ref: 998R6789201610974V,-2592.94,b09699ed-1831-4eed-aec3-b50c41b1488d,2809.44,debit,bank-fee,AU00000,2023-09-26T01:05:25Z
transaction,19816fc2-e221-42d2-ad88-eeb1bc1b09c9,posted,Movie Ticket Purchase,-578.71,452c4c41-a77e-49f2-9c8d-258765e74c4b,2230.73,debit,payment,AU00000,2024-05-07T23:37:59Z
transaction,1e6606dc-72f8-4ff7-a588-659abb9cfdf8,posted,Uber Ride,-1158.75,bd2b0041-c270-4666-94b2-52ca8725eee5,1071.98,debit,cash-withdrawal,AU00000,2024-03-23T07:40:50Z
transaction,b416f38c-7d6d-4b02-a355-2257140d596c,posted,Gym Membership Fee,-3392.54,e8991c08-9202-449b-96c3-e85b20ab27fe,-2320.56,debit,payment,AU00000,2023-06-20T15:38:36Z
transaction,61e058a7-70fd-41fe-9bf2-95fd4ee26292,posted,Non Hooli ATM Withdrawal Fee,-3154.57,1a134c70-8bc4-458d-b5e3-efcb96e5afa6,-5475.13,debit,cash-withdrawal,AU00000,2023-12-22T23:24:28Z
transaction,bf6a3603-6d2b-4666-9d93-1f26415ac8ea,posted,Movie Ticket Purchase,-2316.95,a2c58a7e-b14c-4486-8aab-39197cf00c9d,-7792.08,debit,cash-withdrawal,AU00000,2023-08-17T23:09:39Z
transaction,a8903b7c-b472-4352-936e-fdc666c737ac,posted,Hair Salon Appointment,-4328.4,f1c0186f-5d0b-4126-8be4-e943f18340db,-12120.48,debit,bank-fee,AU00000,2023-12-06T14:55:12Z
transaction,7fc69d7a-4249-4fdd-8a1c-021099861c05,posted,Hair Salon Appointment,-981.19,c8191c81-d252-4d92-80a5-7150ee926696,-13101.67,debit,cash-withdrawal,AU00000,2023-12-03T12:15:45Z
transaction,d09339b0-1ee6-4172-9f96-c364a394e1f8,posted,AGL RETAIL ENERGY LTD (GAS),-4073.01,991759e7-85f3-430a-9be7-67e69190922c,5063.82,debit,payment,AU00000,2024-04-10T09:32:44Z
transaction,4ef3a775-e588-4363-870c-740da48e1712,posted,Clothing Store Purchase,-4319.19,3762f061-3743-4048-aa37-64180b8c7851,744.63,debit,cash-withdrawal,AU00000,2024-03-10T17:13:35Z
transaction,5a48011e-1d5f-4e49-852b-a9d14a41e9ce,posted,Amazon Online Shopping,-1208.56,4429d13c-c09e-47a7-bf8b-84ae2b5fe9cf,-463.93,debit,payment,AU00000,2024-02-08T09:28:50Z
transaction,476e5c7c-843c-4d7f-a5c6-5fd390533601,posted,Music Streaming Subscription,-2845.91,5a0decb0-6da2-4de4-9ad0-8215cfec9d17,-3309.84,debit,cash-withdrawal,AU00000,2023-10-01T17:48:36Z
transaction,e3f8ffc8-ba74-4beb-adb5-b39eede6f9a6,posted,Gasoline Purchase,-2792.78,15122352-0cdc-4de7-88c8-0f12bcc9ed51,-6102.62,debit,bank-fee,AU00000,2024-01-04T19:31:42Z
transaction,bdf7a4ec-a7a8-49f1-8e99-25598e9efa8c,posted,Netflix Subscription,-428.39,e3abf384-835a-4cd8-81cb-a91849216465,-6531.01,debit,payment,AU00000,2023-08-23T13:19:53Z
transaction,c8b9f711-e42f-41b4-97ee-be052a188db5,posted,Bookstore Purchase,-3580.7,1d4a6e89-3b0f-4ff6-b5fb-053abc3f5f4f,-10111.71,debit,cash-withdrawal,AU00000,2024-01-13T07:55:01Z
transaction,bd9d4c04-8c24-4a5e-8a0c-805730facfc3,posted,Music Streaming Subscription,-1234.14,73419462-6e5b-459b-a299-51945851e2c9,-11345.85,debit,bank-fee,AU00000,2024-02-20T16:14:27Z
transaction,50a6139a-26b8-48ef-9239-aade61a7c37e,posted,Manly Maths Tutor Wages,-2009.6,7de98c2a-40a0-4a48-b44a-674c97131499,-13355.45,debit,payment,AU00000,2023-10-14T12:46:48Z
transaction,b593440f-c349-4ca3-ae4b-d18e4af05742,posted,Transfer Platnm Homeloan 346454,-3745.03,7df1f7b4-4434-453c-8234-27fd5bf3a475,-17100.48,debit,cash-withdrawal,AU00000,2024-03-28T09:24:37Z
transaction,5dec93d8-a681-48c8-8af4-aa996646dbfa,posted,TFR Acc14000 TO 12389,-4589.7,28b3c246-f608-4480-8ffd-d160b0dec697,7731.05,debit,payment,AU00000,2023-05-27T18:39:38Z
transaction,8a468ee0-6683-473f-b29d-3769badbc823,posted,TFR Acc14000 TO 12389,-2509.01,76fb348e-dcb0-4022-8b1f-d9500c76711e,5222.04,debit,cash-withdrawal,AU00000,2024-01-21T13:05:41Z
transaction,1945da7c-3689-46f3-b42f-e41197daa1a0,posted,Music Streaming Subscription,-2168.8,6eacea91-3837-4e3d-a848-b7117c9f89a5,3053.24,debit,payment,AU00000,2023-09-26T00:33:28Z
transaction,5b2fb1ba-69cb-4629-8425-eb2b8fdecd2f,posted,Wdl ATM WESTPAC IGA BALGOWLAH BALGOWL AU,-1924.63,97d4eb50-61a8-4bab-8ec9-fe32b9e107d0,1128.61,debit,cash-withdrawal,AU00000,2023-07-29T13:09:44Z
transaction,d9827c68-1002-480e-8eef-72495475fbcc,posted,Coffee Shop Purchase,-3094.13,23968f8f-0df2-45c8-81fb-7f74f7fc4d28,-1965.52,debit,bank-fee,AU00000,2023-07-25T07:36:59Z
transaction,918986a6-de78-4cb2-ab31-f0b50c2c7d35,posted,Gasoline Purchase,-4190.54,74794250-d01b-4a2e-aa41-5a4aa5b78914,-6156.06,debit,payment,AU00000,2023-07-03T22:58:50Z
transaction,114c7ea4-c56e-4276-912a-28c5cc0fb089,posted,Pharmacy Purchase,-3654.85,5851a4f3-1ef6-431f-9196-31b7bdc16174,-9810.91,debit,cash-withdrawal,AU00000,2023-12-24T00:22:22Z
transaction,eb692ce0-24cb-4715-8264-a636f2cec0de,posted,Online Gaming Purchase,-4101.96,cf14a196-e2f6-4e6f-ab31-82c9d36b8791,-13912.87,debit,bank-fee,AU00000,2023-09-22T13:14:22Z
transaction,c38c0bab-d14e-4a98-be5a-e76f1f8f4980,posted,Travel Agency Booking,-1782.6,e873f030-68bb-4217-9519-94b91b8bea6f,-15695.47,debit,bank-fee,AU00000,2023-10-10T02:36:42Z
transaction,9025d5cc-a993-4164-949c-110586f35edb,posted,Coffee Shop Purchase,-942.23,4ccab200-8c27-4baf-b66b-4f84cfd1b2dc,-16637.7,debit,cash-withdrawal,AU00000,2024-03-03T23:13:49Z
transaction,94aefddb-dedf-4c50-96aa-f838466bb802,posted,Amazon Online Shopping,-1416.82,3f7353d0-b165-4eba-838e-d4230690ad70,16123.76,debit,cash-withdrawal,AU00000,2023-10-04T15:23:14Z
transaction,d6363108-873b-40a0-9da0-49c6a3bda1a3,posted,Movie Ticket Purchase,-3814.22,3085bf59-d17e-44bc-a96d-2892250470af,12309.54,debit,cash-withdrawal,AU00000,2023-05-26T01:30:43Z
transaction,244b0ee2-9fd4-4e39-a593-84e7e340f9c6,posted,Mobile Phone Bill Payment,-2012.14,0a8a118d-f0f7-4116-824a-c2e05ef2c9e4,10297.4,debit,payment,AU00000,2023-10-08T13:23:19Z
transaction,9a5cd208-433a-481a-9b2c-c17eb2bf163d,posted,Music Streaming Subscription,-4535.79,15683fe4-3760-4446-aa7c-ecfd3cefcab1,5761.61,debit,cash-withdrawal,AU00000,2023-06-01T13:02:22Z
transaction,93e6227a-88a3-4d11-860c-e3c68b1040ca,posted,Transfer Platnm Homeloan 346454,-2788.95,c1615864-3939-4851-bad7-a0a98c867168,2972.66,debit,payment,AU00000,2023-06-05T09:50:26Z
transaction,89c96f2a-9036-4214-97a3-17b86bc752a6,posted,Hair Salon Appointment,-1911.27,d9603ac9-6bb3-42d1-a954-a46c7086a8c9,1061.39,debit,cash-withdrawal,AU00000,2023-08-25T13:04:29Z
transaction,9c965a61-c03b-49a1-8b8b-cf464a56f3c4,posted,Wdl ATM WESTPAC IGA BALGOWLAH BALGOWL AU,-3260.6,7ef0a833-2b68-4139-b497-1fe71e0f634c,-2199.21,debit,payment,AU00000,2024-04-13T05:10:59Z
transaction,16bed59b-d2d8-4270-80da-842176f0ae88,posted,Coffee Shop Purchase,-1552.79,7b60e8b8-39a9-4735-8779-67c877cbfea2,-3752.0,debit,payment,AU00000,2024-01-21T07:00:40Z
transaction,f9a678c4-226b-4c1c-b734-63a6dd1e9d1a,posted,Clothing Store Purchase,-1876.53,9f652483-cc32-4148-b798-5a0d7b0a50f3,-5628.53,debit,cash-withdrawal,AU00000,2023-08-05T22:51:23Z
transaction,210ed968-19d6-4b0a-a647-6dad96cb7b16,posted,Netflix Subscription,-1053.29,7e0dbb8d-4eaf-47f2-887e-b7c2122ce48a,-6681.82,debit,payment,AU00000,2023-11-23T05:20:43Z
transaction,9c2ce008-bb0f-4d9c-998d-39af6665b1e4,posted,Public Transport Fare,-4542.54,e63686a3-95f2-4a74-92a7-ac1e510b041f,5495.33,debit,cash-withdrawal,AU00000,2024-01-02T10:51:41Z
transaction,4d3c6b36-0aee-4257-bf33-4e33a4167139,posted,Movie Ticket Purchase,-1266.81,ff1f5d2b-96e5-4444-a9d3-ff654676a206,4228.52,debit,bank-fee,AU00000,2023-07-02T09:42:28Z
transaction,fd629e0d-0829-4cef-9a90-0001a5087882,posted,Coffee Shop Purchase,-3298.47,9862e01f-c1fb-4827-a882-1b44cabb687c,930.05,debit,payment,AU00000,2024-01-12T21:26:18Z
transaction,12707d7d-cd58-4629-a790-608b4f6b162e,posted,Amazon Online Shopping,-4982.79,35a9f423-080f-442c-a507-86ed884e7c22,-4052.74,debit,cash-withdrawal,AU00000,2023-07-01T00:42:40Z
transaction,780ae58c-f892-4429-8dc2-630ccdcafbfb,posted,Manly Maths Tutor Wages,-2406.18,31f6aee2-1ac6-4560-a16b-35a01fe998c8,-6458.92,debit,bank-fee,AU00000,2023-06-26T21:11:45Z
transaction,ce75d3d5-93c5-4b91-b9dc-36e5bc30cd92,posted,TRANSFER TO JOANNA SMITH CAMPING,-1791.36,22cb40d1-58cd-4356-8848-922b5d0b498b,-8250.28,debit,payment,AU00000,2023-07-06T01:07:40Z
transaction,eee13886-ada2-48bc-a72d-71b11f78340e,posted,Bookstore Purchase,-2785.18,d3ddb03c-415a-49b1-8f73-d9e0db6b5ac0,-11035.46,debit,cash-withdrawal,AU00000,2024-04-12T21:15:29Z
transaction,1c901b2a-8d36-4834-be35-0e9ce5a77175,posted,AGL RETAIL ENERGY LTD (GAS),-2577.12,ab427174-8b51-4147-99da-6f3646533248,-13612.58,debit,bank-fee,AU00000,2023-06-25T23:41:26Z
transaction,712566cc-da89-442d-9134-ad62899ac4d1,posted,Travel Agency Booking,-1811.66,d398bcaf-f535-4adc-8d95-4b52a4169135,-15424.24,debit,payment,AU00000,2023-12-22T17:12:49Z
transaction,b3424a7f-36aa-4ca0-bfb8-1ad0998e6ea0,posted,Electricity Bill Payment,-3832.64,cfe85705-8660-4c9e-a5a9-3bab7997676e,-19256.88,debit,bank-fee,AU00000,2024-05-04T18:40:42Z
transaction,e24b7ead-81f9-4c25-a8c4-b8fd4341d852,posted,Netflix Subscription,-1386.45,7938c90a-6299-463a-b43d-5171d4d86b9d,8906.75,debit,payment,AU00000,2023-09-17T09:34:09Z
transaction,24571213-69d9-43d3-92a6-3c7e7368e0b5,posted,Wdl ATM WESTPAC IGA BALGOWLAH BALGOWL AU,-2697.78,f1a3f04c-ee90-4277-b50e-231f0d295291,6208.97,debit,payment,AU00000,2023-08-24T11:35:50Z
transaction,d02d0528-0f9b-4149-b26d-1467f4e094ce,posted,Gasoline Purchase,-3021.74,0849f215-9063-415a-8b95-7eecd574881b,3187.23,debit,payment,AU00000,2024-04-15T04:57:34Z
transaction,5f22bc13-e248-42a8-8283-9ba7b6a83a01,posted,Non Hooli ATM Withdrawal Fee,-2752.57,f745462d-c71c-46f7-bde9-29e8278d1c95,434.66,debit,payment,AU00000,2024-04-28T04:38:14Z
transaction,bd907419-2e16-411e-94cb-3cde7d3b908e,posted,Gasoline Purchase,-1080.41,4459c1f7-c8e9-4e9b-8d0a-d60dc8a05377,-645.75,debit,bank-fee,AU00000,2024-05-05T11:25:57Z
transaction,5ff3e646-e2a9-4f7d-ad26-969b171a58b8,posted,Home Improvement Store Purchase,-432.17,5d68c34a-9c3b-4abb-a04d-60794e4016fa,-1077.92,debit,cash-withdrawal,AU00000,2024-01-23T05:33:46Z
transaction,9830a2e1-d1aa-4ab1-959e-03740089094d,posted,CTRLINK CARERS Ref: 998R6789201610974V,-3809.02,e2a576fa-797e-442d-9f05-84299a9f44b8,-4886.94,debit,cash-withdrawal,AU00000,2023-05-19T19:49:25Z
transaction,8765c7bd-8d92-4234-8379-1b9d855e9f4c,posted,Coffee Shop Purchase,-4203.1,cabd4dc1-da14-4770-910c-1e326452fed9,-9090.04,debit,cash-withdrawal,AU00000,2023-08-24T18:54:40Z
transaction,1907e1f3-750a-4f7d-bbcc-ab178550f1d3,posted,Coffee Shop Purchase,-4114.2,2f92ef91-192c-44f4-9b15-c09716fd2b54,-13204.24,debit,payment,AU00000,2024-02-02T15:18:16Z
transaction,fb482e0a-1a7a-4b37-a1c9-5a7b4005f2b1,posted,Mobile Phone Bill Payment,-4105.26,c1857441-7805-492b-ba76-2c233b740e73,-17309.5,debit,bank-fee,AU00000,2023-09-25T12:40:43Z
transaction,456d495e-685f-4c47-8f2a-affa8004ec4f,posted,Travel Agency Booking,-2287.87,02f2731c-6478-447b-a648-ffdf0b7fe20a,13297.92,debit,bank-fee,AU00000,2023-12-06T06:59:53Z
transaction,fae9125d-097e-47e7-89cd-6ba91d8e71d7,posted,Coffee Shop Purchase,-2270.57,39121f7c-4dfd-4e14-81c6-666e435f4495,11027.35,debit,cash-withdrawal,AU00000,2024-02-27T05:11:17Z
transaction,f059787c-65ae-49e5-b557-91a37657351d,posted,TFR Acc14000 TO 12389,-3659.73,fff4aac4-0be4-4d1a-93f9-1f3415c04fa4,7367.62,debit,payment,AU00000,2023-09-22T03:18:07Z
transaction,cae5aeed-674e-4536-b618-9c6011854951,posted,Clothing Store Purchase,-4157.5,4ad69278-fa7f-4558-a9e0-0b14a7c52ebf,3210.12,debit,bank-fee,AU00000,2023-09-30T12:11:45Z
transaction,f1417221-5743-40d2-9971-9d9eb8ae7984,posted,Transfer Platnm Homeloan 346454,-3110.67,c4e3d4dc-ade8-45b1-beb3-70383171b63f,99.45,debit,payment,AU00000,2023-08-01T14:07:11Z
transaction,5194b802-9e44-4b05-8143-d8cf641ee2f2,posted,Car Maintenance Expense,-2551.93,95ee8771-d51d-4c77-8c6c-612c3826cb91,-2452.48,debit,payment,AU00000,2023-05-30T10:25:43Z
transaction,0321fa5a-7eee-4ab2-8b57-dd4315b11133,posted,Hair Salon Appointment,-2137.59,ba6d78ac-f965-44fb-ad58-038d06fb03d2,-4590.07,debit,bank-fee,AU00000,2024-04-22T09:51:33Z
transaction,03834dfa-5da7-4198-93fa-a27c2bdbb8cd,posted,Netflix Subscription,-2473.24,025d76f9-a251-4abd-b194-f8b9e7711bfa,-7063.31,debit,cash-withdrawal,AU00000,2024-04-28T17:37:37Z
transaction,2e17a8ca-9ad8-4f30-80e6-53f9c92d21d3,posted,Non Hooli ATM Withdrawal Fee,-3809.96,a2aeb742-8049-477f-b082-d0155a9072e7,-10873.27,debit,bank-fee,AU00000,2023-12-17T17:09:18Z
transaction,b2f057df-dcdd-49bd-93d9-eaef5fbb92e4,posted,Online Gaming Purchase,-2379.98,91111db8-272f-4b34-ad3e-502479adc330,-13253.25,debit,payment,AU00000,2023-10-15T06:16:51Z
transaction,8d0e458a-2031-4c73-9dfc-1d5d05306956,posted,TRANSFER TO JOANNA SMITH CAMPING,-1466.33,6d65d57d-710d-46b3-aeb0-e28c0aeab1ad,7407.86,debit,bank-fee,AU00000,2023-12-07T16:18:49Z
transaction,5976c07f-40ba-44a2-b426-4472fb17233d,posted,Netflix Subscription,-1806.96,d5ee3fe9-36be-47cf-8437-6d366d15ab75,5600.9,debit,bank-fee,AU00000,2023-07-10T05:43:57Z
transaction,67d981dd-570b-4613-ac34-ba5b128d76df,posted,AGL RETAIL ENERGY LTD (GAS),-2925.08,4e09d568-7cbd-4dcd-86c7-db0fdcc3348e,2675.82,debit,bank-fee,AU00000,2023-08-10T19:19:29Z
transaction,5afc1160-2874-4916-87b5-0711070adc2d,posted,Travel Agency Booking,-4946.77,f53c538e-7770-4642-9e11-b50e09890afb,-2270.95,debit,cash-withdrawal,AU00000,2023-06-23T22:49:12Z
transaction,2e681282-5e57-4ea4-b003-80465c825853,posted,Car Maintenance Expense,-3722.58,84ccdda0-706b-4a44-8702-30bc8137dec3,-5993.53,debit,cash-withdrawal,AU00000,2024-03-17T22:18:14Z
transaction,28dac9c7-8519-4b4e-856b-700247bf0e9a,posted,Mobile Phone Bill Payment,-1401.88,ab1edd02-b0f1-43d8-ad97-e9bf5c90810a,-7395.41,debit,cash-withdrawal,AU00000,2023-12-13T01:33:26Z
transaction,0574f684-0bdc-4083-b160-e5815b64be9b,posted,TRANSFER TO JOANNA SMITH CAMPING,-2650.8,a76cb524-36ae-4423-952a-4e22716758a5,-10046.21,debit,cash-withdrawal,AU00000,2023-11-29T18:17:33Z
transaction,8c16bc61-36b0-4127-96c7-618348a8c578,posted,Car Maintenance Expense,-53.96,2b1ed108-4949-458d-83b3-555ce0193367,-10100.17,debit,payment,AU00000,2023-05-16T04:08:16Z
transaction,0f0c5f4a-09dc-45d2-8cae-af62e2bf1908,posted,Wdl ATM WESTPAC IGA BALGOWLAH BALGOWL AU,-3522.71,c6d510b0-ff01-468c-b053-3ade3e12201d,-13622.88,debit,cash-withdrawal,AU00000,2023-06-11T19:52:19Z
transaction,cca3d8cb-7ac7-435d-8722-a565f1bee7cd,posted,CTRLINK CARERS Ref: 998R6789201610974V,-2973.09,15ca4478-e8a9-42ed-b00c-7d6ef1777066,-16595.97,debit,cash-withdrawal,AU00000,2023-11-17T05:18:40Z
transaction,3f3fb8d5-7aa0-4398-ac00-30b0e12a6e20,posted,Music Streaming Subscription,-1969.44,f796d3a5-ad1f-4d5b-a5d4-6120dbb5e8c9,16291.52,debit,cash-withdrawal,AU00000,2023-12-17T23:15:04Z
transaction,f239333a-daef-48dd-ad52-c7a9f17973e8,posted,TFR Acc14000 TO 12389,-4176.06,aa77e18a-bbda-4a44-9d4f-30bd4c3180db,12115.46,debit,payment,AU00000,2024-01-08T00:37:30Z
transaction,65f25426-4892-483c-8477-c3743ed0055e,posted,Home Improvement Store Purchase,-2043.45,830944f4-66fd-4f69-83ed-55f5c53a884e,10072.01,debit,bank-fee,AU00000,2023-06-25T00:52:21Z
transaction,436577f6-6b9a-40ca-8a86-2a020cb011de,posted,Clothing Store Purchase,-973.38,272af33a-d760-430e-a26f-a1459ef0672a,9098.63,debit,bank-fee,AU00000,2023-12-07T12:54:02Z
transaction,456e8829-19a6-4489-a04c-dffe4a7c37e3,posted,Payroll WFRMS 15439393,11622.54,64c1a763-52b8-4cbe-8e52-878dd992ff43,20721.17,credit,transfer,AU00000,2024-03-14T19:48:05Z
transaction,d78f03a2-01d3-480c-b81a-e14ff6dcc5bb,posted,Public Transport Fare,-2524.15,7997afcc-5e65-464e-94ad-7cf21569beb7,18197.02,debit,cash-withdrawal,AU00000,2024-04-24T09:22:06Z
transaction,c12ee308-1a95-4668-b08b-2413965cb09a,posted,Payroll WFRMS 15439393,11859.05,4c4783ae-65c4-4fcf-b71c-41d0e9a21104,30056.07,credit,transfer,AU00000,2023-09-11T12:12:06Z
transaction,97fa5d18-b0c9-4694-8a8d-6ab69d4b8b36,posted,Wdl ATM WESTPAC IGA BALGOWLAH BALGOWL AU,-2126.1,440cbbe6-eeb4-43d5-9e8a-9d7facb60042,27929.97,debit,cash-withdrawal,AU00000,2024-02-24T02:08:39Z
transaction,1925dc2f-9b88-454f-b879-8523d16c088f,posted,Coffee Shop Purchase,-4970.51,a19ecf5e-f14f-4a89-ace0-e51279c61397,22959.46,debit,cash-withdrawal,AU00000,2024-03-11T14:12:06Z
transaction,7528ca8f-4934-469a-9be1-2616617031d7,posted,Bookstore Purchase,-4740.07,9c61a750-c231-4036-b0a7-597b31e6dbbd,18219.39,debit,payment,AU00000,2024-04-04T12:04:12Z
transaction,55f66f52-2703-434a-9e44-d1a983c1e56b,posted,Coffee Shop Purchase,-4902.43,103b4218-cfe9-45dc-ba6f-bbb2ed13b8d8,6901.41,debit,payment,AU00000,2023-07-29T08:59:55Z
transaction,20a09c5f-5646-44a9-be8c-43a3c3009b96,posted,Public Transport Fare,-1543.79,92a759d5-d485-4795-9b6c-684a73b8ba1b,5357.62,debit,payment,AU00000,2024-01-20T01:15:04Z
transaction,55127fa1-2c94-4e0f-aa30-e6da3060a738,posted,Public Transport Fare,-4341.43,06e1bfae-b35b-49e8-a96c-5e7f424f07f1,1016.19,debit,bank-fee,AU00000,2023-10-02T22:39:21Z
transaction,eca199c4-b0d4-42ae-b975-70b18a6338c0,posted,Netflix Subscription,-122.75,6760d8fa-1d1e-4231-b018-13c92ca9d812,893.44,debit,payment,AU00000,2023-05-24T01:46:00Z
transaction,9ad8b665-1b44-4ba1-b04d-120885cbd4a9,posted,CTRLINK CARERS Ref: 998R6789201610974V,-528.1,88f6a915-c1a2-4502-be1b-6b7665539c35,365.34,debit,cash-withdrawal,AU00000,2023-11-25T04:20:26Z
transaction,c0741ffd-41aa-4508-bcff-81c5f18a4ebd,posted,Uber Ride,-2758.19,9cc1041a-f2d3-43c0-b825-03ff3c0862b3,-2392.85,debit,cash-withdrawal,AU00000,2024-01-31T22:14:28Z
transaction,f51d8a56-1f79-4e91-884e-762f2eab15b2,posted,Payroll WFRMS 15439393,11190.93,0653462f-1d1e-4a79-8b1c-54769c8cc9f2,8798.08,credit,transfer,AU00000,2024-03-29T20:02:13Z
transaction,de59a4f4-10c0-484e-a4d9-0461c802e331,posted,CTRLINK CARERS Ref: 998R6789201610974V,-4155.13,e92236e6-e701-49c3-94af-66c1656e7eb4,4642.95,debit,payment,AU00000,2023-09-09T09:14:34Z
transaction,c646c7c2-418b-4cf3-9f6b-5b2b528e8934,posted,Electricity Bill Payment,-1494.09,7636092f-0323-4ba5-a9fd-4f306cb5f341,3148.86,debit,cash-withdrawal,AU00000,2023-10-29T00:06:45Z
transaction,e6d73974-53e9-4b84-91ec-7d83380bf398,posted,Mobile Phone Bill Payment,-3959.91,fce72c0b-6377-4c46-a628-2a898784dd22,-811.05,debit,payment,AU00000,2024-03-19T14:41:18Z
transaction,cdd9285c-e75c-4bc9-b38c-e832f5dd2b0d,posted,Amazon Online Shopping,-3413.66,a7390e6a-99a8-4746-95bf-0e14a498d441,10105.33,debit,payment,AU00000,2023-07-03T04:07:21Z
transaction,461cd042-1123-444f-9735-de1e1d191cd7,posted,Transfer Platnm Homeloan 346454,-3695.4,9b7d0529-9a9d-4f49-a9c4-6074924288bc,6409.93,debit,cash-withdrawal,AU00000,2023-12-17T11:39:55Z
transaction,8a615294-753f-4d64-8d33-d71129f4f5c6,posted,TRANSFER TO JOANNA SMITH CAMPING,-2888.97,d3341d61-bc5b-46e3-a750-e491c1641ecb,3520.96,debit,payment,AU00000,2024-01-12T22:32:37Z
transaction,b355f252-da5e-45a9-a25b-6b6ed3276f86,posted,Movie Ticket Purchase,-2553.35,970a5d4b-da23-430f-98b5-e415ec6fce88,967.61,debit,cash-withdrawal,AU00000,2023-10-25T17:03:15Z
transaction,f166585f-de66-4656-a9b4-89ce9509ca3e,posted,Netflix Subscription,-3791.01,3e109e90-7c40-4605-9bb3-977b1ae2829d,-2823.4,debit,bank-fee,AU00000,2024-01-29T01:32:24Z
transaction,c0a1d789-1c36-45e2-8519-f3a083e94df2,posted,Electricity Bill Payment,-2104.7,fe9e9367-36c5-469b-8492-5d0d7cc4b153,-4928.1,debit,cash-withdrawal,AU00000,2023-12-08T20:14:24Z
transaction,c685fe3b-c62d-4bc3-9791-5577e3ec3483,posted,TFR Acc14000 TO 12389,-3964.94,426fa94a-9b17-4f47-93bb-a9ed5e5496ab,-8893.04,debit,payment,AU00000,2024-05-05T17:36:04Z
transaction,fd13a592-0605-48aa-98da-6429b15d977e,posted,Public Transport Fare,-4146.67,093fc61d-0001-42ce-8a14-2cdcf21035e1,-13039.71,debit,bank-fee,AU00000,2023-05-31T06:54:51Z
transaction,d3f34971-f274-4c2b-9fb8-d87ca24ae001,posted,Gym Membership Fee,-4569.83,8dd755fa-ee3f-451f-b7fa-db164ad4a40e,-17609.54,debit,bank-fee,AU00000,2023-07-13T23:51:14Z
transaction,c6af83d7-2055-4d5f-bb64-baca3a88d460,posted,Electricity Bill Payment,-3592.41,68c67f08-477c-4ed1-a8e4-dcd573725775,-21201.95,debit,bank-fee,AU00000,2023-11-19T15:53:55Z
transaction,ba192d6a-1ab1-4308-b759-238788a54c76,posted,Coffee Shop Purchase,-1183.34,3e2a5f8d-e9af-4210-ad28-282fdcd92e88,10286.22,debit,bank-fee,AU00000,2024-03-10T09:35:35Z
transaction,a73b892b-44a2-47b4-bbec-0f7c4f8bac58,posted,Hair Salon Appointment,-2654.58,e3844f24-4c12-4f2f-9343-be34c66d5fd0,7631.64,debit,payment,AU00000,2023-05-23T23:27:26Z
transaction,46078cf9-70a8-4fbd-894a-ad01b9a7fa7d,posted,Uber Ride,-3705.28,e5a3f6de-34ec-4360-a2d7-de07d0958a6d,3926.36,debit,bank-fee,AU00000,2023-08-17T07:24:17Z
transaction,e1411491-102c-4e22-a680-b1bcfd0ea425,posted,Uber Ride,-2127.96,22f93f16-08a8-4f64-88d8-0e9cc12c543c,1798.4,debit,bank-fee,AU00000,2023-11-18T14:06:52Z
transaction,2135ca26-4b47-40dd-9baa-fe4624418b82,posted,Car Maintenance Expense,-4995.98,65fb6c2c-3f1d-4e15-a3bf-3662ce793856,-3197.58,debit,bank-fee,AU00000,2023-08-30T16:03:11Z
transaction,36d1bbf7-b370-46b0-9b81-236df6d45c9d,posted,Non Hooli ATM Withdrawal Fee,-4372.89,a4d73861-bb8c-49dc-9be5-ccbcbf9cd7fe,-7570.47,debit,payment,AU00000,2023-12-21T12:12:50Z
transaction,d87640e8-2021-464d-a95f-52c73c30b63a,posted,CTRLINK CARERS Ref: 998R6789201610974V,-2831.34,cfdaa0a2-1324-4760-85af-afee41debcbb,-10401.81,debit,cash-withdrawal,AU00000,2024-01-11T22:39:12Z
transaction,dd9a5e1f-425e-45c1-b2ae-b630d4abea2c,posted,Pharmacy Purchase,-1739.43,ee4ca233-fc6d-4bed-88f3-6c82a6e3a092,-12141.24,debit,payment,AU00000,2024-04-10T09:10:27Z
transaction,b3aff33a-5688-4d3e-bdf1-5e3deba2f588,posted,Payroll WFRMS 15439393,11273.53,788a651b-42cf-43bd-8a98-e502ac036f9a,-867.71,credit,transfer,AU00000,2024-01-14T20:44:38Z
transaction,588c2818-c3dd-4f79-b245-8792b8d8f955,posted,Transfer Platnm Homeloan 346454,-3682.84,9a106685-0701-4541-af5f-50645cda6005,-4550.55,debit,bank-fee,AU00000,2024-02-19T10:50:18Z
transaction,4da212ac-f83b-41f9-a5bd-9b99e029c529,posted,Non Hooli ATM Withdrawal Fee,-4027.4,39eafc20-b431-424c-80e2-f98fe31ccc48,2029.23,debit,payment,AU00000,2023-11-17T08:23:12Z
transaction,7a328d68-6953-44f8-9b17-a723d3c0fe2d,posted,Payroll WFRMS 15439393,11043.47,c6f6acce-93b5-4fad-85e7-437e49e307ec,13072.7,credit,transfer,AU00000,2024-04-14T15:39:39Z
transaction,eadb07b9-75f5-4466-af0f-18fa3c76a5c9,posted,Uber Ride,-3549.63,44b2869c-e869-4c0d-bedd-943e333254ec,9523.07,debit,payment,AU00000,2024-03-31T14:46:49Z
transaction,f6ea05b2-59a1-48d0-a5ba-6d2ef4bcaf63,posted,Uber Ride,-1631.13,c9df2f81-a6c7-492e-8a6e-cb5be3009a04,7891.94,debit,cash-withdrawal,AU00000,2024-04-10T03:09:02Z
transaction,c09eb20f-621c-428c-ba3b-9c22ee83e4fc,posted,Hair Salon Appointment,-3923.16,6c60b21d-27c5-476b-b7b7-5a85414675da,3968.78,debit,bank-fee,AU00000,2023-11-21T16:29:07Z
transaction,f8096166-6386-4efd-aa11-8e2ae56d26bc,posted,Gym Membership Fee,-1928.84,9dd226db-ce7d-41ff-9de4-dc6615b86e9b,2039.94,debit,cash-withdrawal,AU00000,2023-09-28T17:04:15Z
transaction,40237ca2-c128-4d21-b195-42767ca7276c,posted,Non Hooli ATM Withdrawal Fee,-3359.02,6b648ffb-fd48-4e70-a9d2-110ee7a6d500,-1319.08,debit,cash-withdrawal,AU00000,2024-05-06T03:38:48Z
transaction,b37af8de-37d6-4ec9-b150-e4c47cd7b0f8,posted,Music Streaming Subscription,-2806.33,edf57a5e-7ff1-450a-bd6f-8ee95688da7a,-4125.41,debit,payment,AU00000,2024-02-29T12:08:35Z
transaction,71543c9d-1454-4f5b-9da1-fb49431db117,posted,Public Transport Fare,-2939.86,d6df62e5-b11d-4faa-9d85-97aab0e0441d,-7065.27,debit,bank-fee,AU00000,2023-11-20T10:29:25Z
transaction,07741b36-7998-48f0-9141-a028bdd0dd1d,posted,Travel Agency Booking,-1641.55,444957de-2b93-4ca2-8c1d-b91d6ed7f889,-8706.82,debit,payment,AU00000,2024-03-26T14:12:35Z
transaction,dd84d361-2f74-4865-b1b4-86acad5e38bc,posted,Wdl ATM WESTPAC IGA BALGOWLAH BALGOWL AU,-2966.96,e6095f17-c981-4304-a4d4-40864bdbc83e,14662.34,debit,payment,AU00000,2023-09-26T17:45:39Z
transaction,8a04e848-fef1-46c0-87a6-031071167ff4,posted,Payroll WFRMS 15439393,11720.97,7e792982-bec8-4577-886f-4c870907c531,26383.31,credit,transfer,AU00000,2023-12-30T23:47:26Z
transaction,f2adaf3b-39ca-4b4c-a31c-8df923415a3a,posted,Netflix Subscription,-3130.05,5e3665c0-231a-4eb9-9e5b-834c43d1a4d5,23253.26,debit,bank-fee,AU00000,2023-11-05T05:49:27Z
transaction,71d5588c-84b7-4e38-bed7-8838865b07b8,posted,Online Gaming Purchase,-3752.22,fffb52e0-0450-48f0-912d-8c188b243d84,19501.04,debit,payment,AU00000,2023-09-01T06:19:22Z
transaction,7813b8dd-a5ee-4ad8-b19c-55998e38b52e,posted,Transfer Platnm Homeloan 346454,-4657.55,f3196466-c7f1-40b8-8a60-71795eae238c,14843.49,debit,bank-fee,AU00000,2023-09-01T10:36:10Z
transaction,7834f46a-28bd-41e1-bd46-33f433a8e53b,posted,Non Hooli ATM Withdrawal Fee,-4726.15,e4b5c4fa-aea7-4e90-95ad-98f5c63996e3,10117.34,debit,cash-withdrawal,AU00000,2023-12-20T05:17:35Z
transaction,5f040cd8-0947-4f68-8e3f-8ec21e8bdb05,posted,Travel Agency Booking,-2365.43,cdaa2a28-7fca-4ebc-9e27-1282ba94ed90,7751.91,debit,cash-withdrawal,AU00000,2024-03-27T02:35:55Z
transaction,55e60c4b-4a7d-4097-be4a-c61201e724c2,posted,CTRLINK CARERS Ref: 998R6789201610974V,-170.19,34f5b666-91d9-42c9-9a9d-977e40be9f4b,7581.72,debit,payment,AU00000,2023-12-07T07:38:58Z
transaction,9458b8a3-c927-4a52-ab88-e9a6a41c3e61,posted,Manly Maths Tutor Wages,-4092.93,ad13a2a7-42fb-4c4a-b74d-d298f9447705,3488.79,debit,cash-withdrawal,AU00000,2024-04-26T09:13:08Z
transaction,958f52a9-606d-401d-bcd7-4b297b4e92ca,posted,Clothing Store Purchase,-4427.65,ff9b74ed-f549-4523-8492-ea464cdfed30,-938.86,debit,payment,AU00000,2023-07-06T07:09:05Z
transaction,955ee7ec-9bbe-4ccd-8a98-ea409428d390,posted,Online Gaming Purchase,-4537.54,733146c2-eb21-4c81-bd41-26b7bb7b92d2,12373.97,debit,cash-withdrawal,AU00000,2023-12-10T00:43:03Z
transaction,9dd1b308-2445-4ac4-9236-21028b380a9b,posted,Music Streaming Subscription,-108.8,505412bd-400e-45ca-ac11-a6febead28f2,12265.17,debit,cash-withdrawal,AU00000,2023-12-23T13:01:54Z
transaction,0fd58024-2d34-4e1e-a0ad-4e950e94556c,posted,Manly Maths Tutor Wages,-4637.37,660c8373-4dd8-4179-a031-7df2a118a253,7627.8,debit,cash-withdrawal,AU00000,2023-07-09T02:41:00Z
transaction,0abbaef8-99e4-4f0a-a0e2-974b84c5a466,posted,Netflix Subscription,-1434.46,c330682f-ef98-40b4-9687-91033ee20d03,6193.34,debit,cash-withdrawal,AU00000,2023-08-28T03:24:27Z
transaction,3b12d99f-b6a9-4500-b58c-5807457a603d,posted,Netflix Subscription,-4469.41,80eede63-cf47-46a7-bfd9-151b4f24badd,1723.93,debit,payment,AU00000,2023-06-16T04:39:41Z
transaction,96b6437a-1341-43f4-b8ff-7a3433585dd3,posted,Electricity Bill Payment,-456.91,86e108e3-3e3d-4d69-9335-b5e0cc975d96,1267.02,debit,cash-withdrawal,AU00000,2024-05-03T16:11:43Z
transaction,cb70a046-e3b1-468e-94b7-b374f87f42ad,posted,Gym Membership Fee,-1652.43,15bc6409-dfad-4882-a672-25a8b3414898,-385.41,debit,cash-withdrawal,AU00000,2023-11-18T04:21:04Z
transaction,bb20f75b-af84-4499-9fc9-18fd295130be,posted,CTRLINK CARERS Ref: 998R6789201610974V,-973.82,23a310f7-3280-43ec-9b4c-6d55c9911e0f,-1359.23,debit,cash-withdrawal,AU00000,2024-04-20T02:08:39Z
transaction,36c0ed7d-6909-42eb-9134-b8ed66d7acf4,posted,Travel Agency Booking,-4338.08,ede7e75b-1325-4b5a-9a90-6c3aaf12c8c9,-5697.31,debit,payment,AU00000,2023-08-05T00:27:20Z
transaction,46485f79-b892-4792-b450-9fd99fe7981d,posted,Travel Agency Booking,-3959.15,85664b0e-cb86-4cde-9598-002392d289a2,-9656.46,debit,bank-fee,AU00000,2023-12-22T13:35:48Z
transaction,e73aee5d-19ff-4d96-bfd1-e2bbbaa47fd4,posted,Wdl ATM WESTPAC IGA BALGOWLAH BALGOWL AU,-1900.74,67e4e234-be22-494c-9ce4-9763516f618c,14582.65,debit,bank-fee,AU00000,2024-02-25T13:16:28Z
transaction,04003220-865f-4720-a29e-d5ae1b62f9a9,posted,CTRLINK CARERS Ref: 998R6789201610974V,-168.1,825ddcdb-bf05-4d2d-afaa-6e08a992e6bc,14414.55,debit,payment,AU00000,2023-12-23T00:36:28Z
transaction,df52ffbd-be75-4264-8bdc-d4e1263603fc,posted,Music Streaming Subscription,-4149.63,ba9f51f2-00f8-43f6-b815-835dd5e05d84,10264.92,debit,bank-fee,AU00000,2023-09-14T18:45:33Z
transaction,8cb11971-2671-48fd-89b1-bc8fe64a5f13,posted,AGL RETAIL ENERGY LTD (GAS),-4439.27,279da98c-7d0d-4e0d-b8bd-46ac0d2f51a2,5825.65,debit,bank-fee,AU00000,2023-08-22T02:55:02Z
transaction,e0ec9e86-847d-4e70-a5ec-754d94d5bd97,posted,Public Transport Fare,-3459.48,16762790-3704-42c3-bc80-48c342e14ba9,2366.17,debit,cash-withdrawal,AU00000,2024-04-16T01:19:02Z
transaction,bda78523-3f90-4827-9630-26f45adc386b,posted,Car Maintenance Expense,-1711.02,e9bc8d00-f5e6-439a-a126-2ffb83c1f3ce,655.15,debit,cash-withdrawal,AU00000,2024-01-29T04:16:37Z
transaction,5a85e1f1-cb28-44c3-9f5a-f5f9a7861c12,posted,Amazon Online Shopping,-877.16,a5bff05f-5243-454a-bffd-e4ada85791c7,-222.01,debit,bank-fee,AU00000,2024-03-15T06:47:14Z
transaction,e40c60a6-3146-417c-8c8d-e28af5f140ea,posted,Manly Maths Tutor Wages,-4604.35,c82ae153-c1af-4355-9c14-79f099ecdd20,-4826.36,debit,cash-withdrawal,AU00000,2024-01-21T08:03:17Z
transaction,3b1e9db6-cc37-4667-aec5-6e00df01c745,posted,Home Improvement Store Purchase,-4565.9,f94a1961-5b96-4405-9c26-e0add77f4f43,-9392.26,debit,bank-fee,AU00000,2023-10-07T03:52:05Z
transaction,400a2e67-c873-459f-885c-f8381a49ab0a,posted,TFR Acc14000 TO 12389,-3289.75,683b5b71-bae0-4ba1-b302-92b9dd52a5f8,-12682.01,debit,bank-fee,AU00000,2023-12-02T15:04:28Z
transaction,1e02aa7c-2b19-411c-a4fc-cd49cf8a929d,posted,Gasoline Purchase,-499.45,b552e6f9-7fab-405a-9f7b-e07ea3165ae1,18912.38,debit,bank-fee,AU00000,2024-02-21T07:44:05Z
transaction,50a2881b-a230-465b-bdd2-001b139551ca,posted,Manly Maths Tutor Wages,-3621.45,ffdfe572-1ecb-49fc-8cc8-f444b277fe5b,15290.93,debit,cash-withdrawal,AU00000,2024-04-18T13:52:50Z
transaction,3c1e2dad-ae6e-43a7-818f-e7c2f1646f21,posted,Electricity Bill Payment,-4487.93,d81041c7-9043-4e8f-aed1-9daa4f8b8c2a,10803.0,debit,bank-fee,AU00000,2023-11-25T02:37:49Z
transaction,bf4e9377-4cfe-490d-b358-60f8d19e4268,posted,TFR Acc14000 TO 12389,-1969.54,0ff64d19-8cd9-4395-9dc9-66710da514cb,8833.46,debit,cash-withdrawal,AU00000,2024-03-21T12:26:16Z
transaction,0cfbaf7a-bf44-4ba9-979d-89a680fa8aa7,posted,Car Maintenance Expense,-1037.03,a7ba5150-343b-49e5-88c1-74d86a43b21a,7796.43,debit,bank-fee,AU00000,2024-05-01T13:07:40Z
transaction,13b540c9-ed9a-4d31-b05b-563ebd330057,posted,Home Improvement Store Purchase,-838.44,00273970-f557-42dc-ab41-cbeaddd41fec,6957.99,debit,bank-fee,AU00000,2024-04-13T13:58:41Z
transaction,d8894812-8840-4725-b7b6-99f01246702e,posted,Transfer Platnm Homeloan 346454,-1291.52,5c136161-f206-4691-b1a9-2a1a97c6ecc6,5666.47,debit,cash-withdrawal,AU00000,2023-07-21T23:21:08Z
transaction,38ecec91-4034-4abc-ba88-49304b7da717,posted,Uber Ride,-1914.12,e04b1762-aa5e-4828-a4f1-0d3e25d09331,3752.35,debit,payment,AU00000,2024-03-20T14:35:09Z
transaction,b6a86cf6-2175-43b6-b357-c6d333365b98,posted,Amazon Online Shopping,-2912.97,ea70e0de-0af8-48f3-b7fa-5cba77105b0f,839.38,debit,cash-withdrawal,AU00000,2023-11-13T18:12:19Z
transaction,1afc8f02-832c-4440-939b-0145577c54c3,posted,Amazon Online Shopping,-2158.26,ba958d81-6d73-4479-9b22-bff6e4d4b05b,-1318.88,debit,cash-withdrawal,AU00000,2023-09-20T15:20:18Z
transaction,2f8125c0-69f1-497d-98c2-217a06ff5fca,posted,Netflix Subscription,-4282.29,5ec8a415-2182-46a9-84ea-35aa5e758581,14120.34,debit,cash-withdrawal,AU00000,2023-07-21T12:29:10Z
transaction,48a9b6d8-75be-42eb-bf8e-8e6f5de8f591,posted,Car Maintenance Expense,-1772.68,67487869-8527-46ef-92ff-ad403896076f,12347.66,debit,bank-fee,AU00000,2023-08-07T21:02:52Z
transaction,ed193a5c-1f4b-4643-b647-25a34cc57182,posted,Electricity Bill Payment,-1559.82,ab444224-9be9-458f-a944-8bc6bad3bebf,10787.84,debit,bank-fee,AU00000,2023-07-09T01:28:38Z
transaction,af052428-1081-4e3e-9a70-5a737239fd0e,posted,Music Streaming Subscription,-2624.32,4b647c97-a4da-44af-abcb-43d990413d5b,8163.52,debit,payment,AU00000,2023-07-06T03:54:04Z
transaction,e4bcc034-49cb-4285-be9a-e1c94998615e,posted,CTRLINK CARERS Ref: 998R6789201610974V,-126.23,616a23b6-b943-41ce-8a26-d6416f6cf16b,8037.29,debit,payment,AU00000,2024-02-23T23:46:08Z
transaction,394c3254-f902-4df5-9c61-8b2498322405,posted,Travel Agency Booking,-632.28,522a1b55-e023-48ba-8332-12ce3050c4a3,7405.01,debit,bank-fee,AU00000,2023-08-17T01:19:22Z
transaction,3a3aac49-c65d-402d-8117-a2ed95a628a7,posted,Car Maintenance Expense,-722.76,a777c0a3-c5c3-4a19-b9f1-ce70fe5c36a0,6682.25,debit,cash-withdrawal,AU00000,2024-02-26T23:10:09Z
transaction,eeae7b19-79e1-4dbc-854b-3636daefc9b0,posted,Payroll WFRMS 15439393,10678.39,4e25bae0-cd23-4e2e-929e-5cfc8fe84936,17360.64,credit,transfer,AU00000,2024-03-02T16:47:21Z
transaction,83f529c6-0bb9-455b-9594-9e18fd6c83c7,posted,Travel Agency Booking,-1349.45,a0280766-0a9c-47fa-8f62-1796d6c36911,16011.19,debit,payment,AU00000,2023-09-07T07:34:27Z
transaction,5789707f-57ce-405a-867c-daed54e31ca2,posted,Movie Ticket Purchase,-4757.23,9e856936-ecd7-4fdb-b623-2ae8f6665a49,11253.96,debit,cash-withdrawal,AU00000,2023-06-30T02:31:29Z
transaction,bc85a073-8777-41af-8386-b01e1e61c60d,posted,Bookstore Purchase,-326.75,ad179bde-53ca-4ffa-b28c-de23bc8860a9,14974.78,debit,bank-fee,AU00000,2023-11-10T20:21:18Z
transaction,fa0e5467-29f9-4d16-8b28-aacb6de7ece5,posted,Hair Salon Appointment,-1996.85,854384a8-159e-4ee2-9843-947f38656aab,12977.93,debit,payment,AU00000,2023-06-14T13:36:08Z
transaction,9fe84b3f-1855-4b24-b18d-f7c4d6a1a471,posted,Home Improvement Store Purchase,-3801.41,a1912c48-8da6-420d-b869-b5bf0bfafefd,9176.52,debit,payment,AU00000,2024-04-27T09:30:14Z
transaction,1f5ea10e-e7da-4bf5-9847-0547648dddfe,posted,Pharmacy Purchase,-4512.3,e68e110b-5086-4e5b-9584-526bec8a772d,4664.22,debit,cash-withdrawal,AU00000,2024-01-27T12:28:11Z
transaction,7df8e344-97e8-4135-afd3-dd2f871aeaa0,posted,Public Transport Fare,-1397.65,7ac8ce76-d7c9-42e1-b203-f4a42179f8ad,3266.57,debit,cash-withdrawal,AU00000,2024-02-05T17:46:57Z
transaction,3cf1c40d-bb1c-44fd-b03e-f4ac95d35c23,posted,Electricity Bill Payment,-1224.0,0d1da3d0-4496-46a0-8bfa-ca6f9c20a8ce,2042.57,debit,cash-withdrawal,AU00000,2024-04-16T22:17:52Z
transaction,75dc1f0a-9fe9-4a2f-9407-32c7a5e84b2c,posted,Hair Salon Appointment,-2594.96,82388c38-0e5f-494a-9208-f8ad4ffc1506,-552.39,debit,cash-withdrawal,AU00000,2024-02-27T08:18:11Z
transaction,f76a94de-4f82-478f-b5c5-79a43de5ae01,posted,Payroll WFRMS 15439393,11671.42,b6c76341-ecec-4883-b56d-fc707c67f323,11119.03,credit,transfer,AU00000,2024-03-13T15:11:36Z
transaction,27ad6301-f9d5-4f1e-8235-7f1628e995da,posted,Gasoline Purchase,-1710.0,075a0241-845f-463e-af8b-200d5ea88c47,9409.03,debit,cash-withdrawal,AU00000,2023-12-26T16:11:21Z
transaction,66bf0c38-8b3c-41e2-a60d-3aaa8f42ce63,posted,Uber Ride,-98.79,a528b2e7-6501-43f8-a4b4-4cb711447ffd,9310.24,debit,payment,AU00000,2023-09-27T11:33:56Z
transaction,41ff2f9a-bc3a-48c8-82e3-ed3682adfbe9,posted,Restaurant Dinner,-4551.3,f10730d6-69d4-476e-8039-6db95b4d5346,12928.07,debit,bank-fee,AU00000,2023-07-16T09:18:30Z
transaction,5f418647-c98b-421d-9f84-186b3049fb8b,posted,Hair Salon Appointment,-1892.59,13ae5d8a-bc7b-42fe-ab3e-7c629eb08c99,11035.48,debit,cash-withdrawal,AU00000,2023-07-04T22:32:09Z
transaction,04f68ead-835f-4496-94f6-2aba31254403,posted,Travel Agency Booking,-3125.5,7a10a2bc-0fdf-451f-bbcf-af721d70eeab,7909.98,debit,cash-withdrawal,AU00000,2024-01-12T04:32:42Z
transaction,bbe8bd43-4108-4a85-ad3e-9a8d528f6e9f,posted,Car Maintenance Expense,-3339.95,d1b7dee3-7aaa-4572-a164-3e2f415c5318,4570.03,debit,bank-fee,AU00000,2023-11-24T14:56:32Z
transaction,b9af7d4d-3f5a-455a-a931-2d43f423dfe5,posted,Electricity Bill Payment,-534.56,5d586945-dc69-4184-8310-73f26a665ca8,4035.47,debit,payment,AU00000,2024-02-10T10:59:48Z
transaction,b54979db-68cc-46a3-a600-6c9d3e5ebb46,posted,Electricity Bill Payment,-2209.17,0d44965a-9f2c-4ac4-8dd5-51281bb0715e,1826.3,debit,payment,AU00000,2023-08-21T23:44:27Z
transaction,d24a56f0-2387-44a4-aeec-04140ad9d2cd,posted,Wdl ATM WESTPAC IGA BALGOWLAH BALGOWL AU,-2184.59,91f3b45a-1088-4fbe-a581-27ce4c2c2f8e,-358.29,debit,cash-withdrawal,AU00000,2024-05-04T20:32:12Z
transaction,5d099352-3eed-4cb0-b2cf-0892587f868d,posted,Amazon Online Shopping,-1631.38,8297fbec-0ee0-44c7-ae79-68c03ec3e910,-1989.67,debit,bank-fee,AU00000,2023-06-03T00:50:54Z
transaction,2f2ce4e9-4821-4ce6-aa19-c080bc311dc5,posted,Coffee Shop Purchase,-2788.2,0667d2c0-c44b-47c6-a240-9687345e6b56,-4777.87,debit,payment,AU00000,2023-08-31T18:48:18Z
transaction,77953641-3bcf-4dc1-bdd6-a8d34f0cc240,posted,Travel Agency Booking,-4396.4,ff2a8b61-d378-4fab-9759-930d7f7ca7ff,-9174.27,debit,bank-fee,AU00000,2023-11-21T03:45:00Z
transaction,7db6fcaf-801b-41c6-8ba3-de3cdaf59629,posted,Hair Salon Appointment,-4848.05,5638274e-0db1-4978-998f-5b63c31b47ec,13217.73,debit,payment,AU00000,2024-01-14T18:31:25Z
transaction,11c7dfb2-8cd0-457b-9002-5907f08bf3f0,posted,Home Improvement Store Purchase,-3372.85,8f6ef5e2-e5da-4eee-8a84-1896d59100cb,9844.88,debit,cash-withdrawal,AU00000,2023-09-13T11:23:05Z
transaction,733b7de0-27cb-4eb6-a36e-7913cccc1a19,posted,Transfer Platnm Homeloan 346454,-2832.13,9370d6fa-f51a-4991-844b-011604825e74,7012.75,debit,payment,AU00000,2024-03-18T19:34:37Z
transaction,a42ea597-c720-4729-a342-a26e733a3e7e,posted,Travel Agency Booking,-2298.5,8d007277-5353-452d-b07a-ee61323df454,4714.25,debit,payment,AU00000,2024-04-12T21:47:56Z
transaction,2ddc760b-a270-408d-81bc-805230f5d327,posted,Electricity Bill Payment,-3980.27,549b2a19-3499-43c7-843d-ded84ea74f05,733.98,debit,cash-withdrawal,AU00000,2023-07-15T01:37:06Z
transaction,759faefb-6f18-43e7-9b9d-8fa64c8fa018,posted,Amazon Online Shopping,-2935.55,3a53fe1f-2ba7-45cc-9c05-b73d1ea4c576,-2201.57,debit,cash-withdrawal,AU00000,2023-09-06T09:15:16Z
transaction,26b3bb73-a928-4a53-91c4-b1fb7ec42cd8,posted,Home Improvement Store Purchase,-1770.81,77c7dec5-7ca4-401b-9aef-3a08978f0775,-3972.38,debit,payment,AU00000,2023-06-23T08:28:37Z
transaction,9ec132f7-8b26-4623-a3fc-0540d021dde6,posted,CTRLINK CARERS Ref: 998R6789201610974V,-1505.05,51e4db6c-fb7d-4973-9007-0318bb56e7c5,-5477.43,debit,payment,AU00000,2023-06-13T00:23:56Z
transaction,3c0b7d54-616c-40ec-a04d-f9baea506390,posted,Coffee Shop Purchase,-4907.57,475c96a9-9695-4625-b2ed-ec8e432f17ab,-10385.0,debit,bank-fee,AU00000,2023-10-30T11:04:20Z
transaction,5f78cc52-b616-4ea0-bab5-33a7d57ba7bf,posted,Wdl ATM WESTPAC IGA BALGOWLAH BALGOWL AU,-1088.24,60c13a6a-53f3-4a4e-833a-d99747b55c5b,-11473.24,debit,cash-withdrawal,AU00000,2023-06-07T20:09:57Z
transaction,f265d0a1-0d75-412f-921d-ecb96104b161,posted,CTRLINK CARERS Ref: 998R6789201610974V,-1252.93,c337bee8-6044-4560-9bac-6f464214886f,5897.15,debit,payment,AU00000,2023-06-04T14:30:24Z
transaction,471baef3-5927-478c-a6d5-3b90143cf06c,posted,Non Hooli ATM Withdrawal Fee,-3523.39,8dfdae85-a840-4bc0-8fae-f200db102766,2373.76,debit,cash-withdrawal,AU00000,2024-01-09T21:05:50Z
transaction,d06f09e7-0368-4ab4-a664-ddd61573e678,posted,AGL RETAIL ENERGY LTD (GAS),-1856.65,27819607-c01e-4513-bc2a-9e558d26cb24,517.11,debit,cash-withdrawal,AU00000,2023-06-19T09:14:31Z
transaction,64bc07c7-db1c-49e4-a26e-c0e7f5b2ed8d,posted,Uber Ride,-4677.89,13cd00a2-8200-434c-97a3-4a5b0c872c3e,-4160.78,debit,payment,AU00000,2024-02-26T12:47:17Z
transaction,489bf44f-4691-4d4b-91ed-30be81e53ef5,posted,Electricity Bill Payment,-3246.58,19d802c6-2367-4a8d-a1a5-a1efa2a3d882,-7407.36,debit,bank-fee,AU00000,2023-10-05T00:51:00Z
transaction,f632cd88-9c58-4316-8746-7f4f21ce5275,posted,Coffee Shop Purchase,-3708.36,7d8ef10f-c453-4291-aeb6-9cc15b48808f,-11115.72,debit,payment,AU00000,2024-03-24T15:19:31Z
transaction,455c4563-d9a7-42f3-b1e9-8fd31ed599b4,posted,Gym Membership Fee,-3709.45,6fbcdad0-7e82-4674-a1af-2d100c9c9383,-14825.17,debit,bank-fee,AU00000,2023-06-05T02:27:42Z
transaction,84f56f2f-5f52-4a69-860f-f79f41fcf84f,posted,Car Maintenance Expense,-4996.26,04a62b4f-ba67-4842-b592-3c107a6db0f0,-19821.43,debit,cash-withdrawal,AU00000,2023-09-24T09:51:26Z
transaction,6c098b77-9605-46ce-9cf4-d649628a2fe2,posted,Netflix Subscription,-2363.63,875e9af5-be77-443f-af50-58af65437d12,-22185.06,debit,bank-fee,AU00000,2024-02-15T16:01:12Z
transaction,8771908c-cfa7-4e4d-8249-59bdce75de83,posted,Pharmacy Purchase,-4139.96,b64cd73b-d004-425c-be08-491c4a083276,-26325.02,debit,payment,AU00000,2024-03-25T22:40:28Z
transaction,35244b42-c789-47ec-8e52-4235f094d664,posted,Uber Ride,-3676.61,ad856233-b127-4890-8993-d9df163a25c5,11261.75,debit,payment,AU00000,2024-04-16T02:55:14Z
transaction,2d1cd580-9cdb-491f-8a74-a2c7065eb23c,posted,Mobile Phone Bill Payment,-383.64,4206e882-debc-4f41-9227-8acd8db722b1,10878.11,debit,cash-withdrawal,AU00000,2023-05-22T00:06:40Z
transaction,d6e20729-fd7e-464a-be35-31121c3e3080,posted,Bookstore Purchase,-3378.07,92ca4a58-a74f-4a68-8dcb-8c83022ba62e,7500.04,debit,payment,AU00000,2023-07-28T19:20:04Z
transaction,b84889ce-0bcb-4e1b-ad05-83145cbe3107,posted,CTRLINK CARERS Ref: 998R6789201610974V,-4612.63,2dd8a8e5-514a-4f00-9e17-2c615c4381f0,2887.41,debit,cash-withdrawal,AU00000,2023-07-02T04:43:54Z
transaction,286316e6-3363-4bb1-8b1a-98cde44aab51,posted,Uber Ride,-1829.44,6f2e2f6f-997e-4c54-bf11-5590ebd08778,1057.97,debit,cash-withdrawal,AU00000,2023-08-09T13:50:26Z
transaction,ec9d012d-8170-4f46-b699-88c9c192cf9a,posted,Coffee Shop Purchase,-2621.61,c7cc2f89-f4a4-4e58-b02b-f7c2777a34d3,-1563.64,debit,cash-withdrawal,AU00000,2023-05-28T14:22:31Z
transaction,30d304e4-f715-493b-b017-e75d896a1ca6,posted,Restaurant Dinner,-873.92,cee21fbc-7b88-4d25-9438-09017fffda94,-2437.56,debit,cash-withdrawal,AU00000,2024-04-27T08:11:44Z
transaction,c9814060-7f9b-42f0-b110-d74614287ef9,posted,Transfer Platnm Homeloan 346454,-176.89,e155e140-641f-402a-a4e6-a2a82633f8cd,-2614.45,debit,payment,AU00000,2024-03-28T18:13:48Z
transaction,f7c0e9f2-79e9-4913-a3b4-1a9349a46ff3,posted,Transfer Platnm Homeloan 346454,-4826.0,45f79798-8a9b-423c-8d22-f56629f4da38,-7440.45,debit,payment,AU00000,2023-07-24T18:36:47Z
transaction,e1f9e3e3-9f43-4935-b492-33e6ef9ca232,posted,Online Gaming Purchase,-911.65,59245741-0f6e-4eac-bbaa-878ea00b33b4,-8352.1,debit,bank-fee,AU00000,2024-02-15T04:10:35Z
transaction,29a9bbba-da62-44da-8393-4c4562a859c4,posted,Uber Ride,-3391.87,9191fc89-432b-49da-985a-6b451c3aba7b,14753.53,debit,payment,AU00000,2024-01-08T16:59:56Z
transaction,fa863eb2-45f2-4184-b15c-81c5f8ec2bea,posted,Home Improvement Store Purchase,-3545.01,4722c264-ffee-480c-af34-03ce567b49c4,11208.52,debit,payment,AU00000,2023-07-10T15:37:45Z
transaction,bcf1d250-84cf-45bb-9703-665a6a5a4346,posted,Pharmacy Purchase,-4224.18,46edef25-ed9f-4900-85d6-d35fd58c71a9,6984.34,debit,bank-fee,AU00000,2024-01-01T22:57:32Z
transaction,2e541421-5252-429e-9798-a933022dc246,posted,Uber Ride,-3048.78,b7ba50d0-a5f4-46f8-a290-502154f40fd6,3935.56,debit,bank-fee,AU00000,2023-12-20T09:01:09Z
transaction,df64abb7-edfd-4f24-ae4a-79a943d25b9f,posted,Bookstore Purchase,-3235.23,f465869e-0adc-4b1e-9dae-b246bad936f5,700.33,debit,bank-fee,AU00000,2024-02-28T08:45:02Z
transaction,4ef29270-9205-4416-a657-bda2e2f0b265,posted,TRANSFER TO JOANNA SMITH CAMPING,-273.97,8002cb0a-7d50-47e5-9375-ce26b4c72bd9,426.36,debit,cash-withdrawal,AU00000,2024-03-02T10:43:20Z
transaction,5d63547a-8bd0-4797-b776-9a170970ad5b,posted,Travel Agency Booking,-4853.21,1b44b74f-3e99-43e1-9c1e-1708a4a012d0,-4426.85,debit,bank-fee,AU00000,2023-08-01T16:48:45Z
transaction,c1178aec-f2eb-4dd5-9635-0a538f6b0e5c,posted,Public Transport Fare,-1582.88,7212d449-b371-4826-82d2-6c056716aeb4,-6009.73,debit,payment,AU00000,2023-11-18T23:12:53Z
transaction,490ad87d-8ed5-41a7-8ce5-02aeeaa59733,posted,Wdl ATM WESTPAC IGA BALGOWLAH BALGOWL AU,-1859.48,da84b65e-7edd-4986-b3d1-0c343c602c35,-7869.21,debit,cash-withdrawal,AU00000,2023-06-27T06:07:20Z
transaction,370afb2c-02b0-4774-b3f3-d2b806bb1a42,posted,Uber Ride,-280.88,f2ccf1d5-2cd2-4fff-aa19-a80c45e68b46,-8150.09,debit,cash-withdrawal,AU00000,2023-11-10T10:28:46Z
transaction,072ba34a-b173-4326-ac9b-5931fa0d4719,posted,Clothing Store Purchase,-3626.24,70a24537-e967-47bf-83b3-f69b2cc5788b,3434.6,debit,bank-fee,AU00000,2023-08-26T07:51:26Z
transaction,180691ef-5487-40bc-86e3-6a2926476b2b,posted,Car Maintenance Expense,-4490.98,9d0ef845-db60-4e66-baeb-ebc25348597c,-1056.38,debit,cash-withdrawal,AU00000,2023-05-28T07:29:43Z
transaction,f19cffc5-f026-494b-9729-dde52b2749f2,posted,Bookstore Purchase,-2282.21,b743d3e3-617b-4e11-9f12-508121b8d8a7,-3338.59,debit,cash-withdrawal,AU00000,2023-05-16T06:34:29Z
transaction,986836e0-da8e-4e0d-bd09-687738ae6841,posted,Public Transport Fare,-2685.74,01d1a13f-71f2-4106-99aa-854c8eb8e058,-6024.33,debit,bank-fee,AU00000,2023-07-11T12:11:58Z
transaction,9c0497f2-3ba3-4b63-87a4-d4c7f4a16048,posted,Restaurant Dinner,-2622.44,d8081674-175b-4b39-b54a-0c002eb7908a,-8646.77,debit,bank-fee,AU00000,2023-06-03T03:06:25Z
transaction,51165e62-cfa2-40f2-ac15-026288a51ea9,posted,Non Hooli ATM Withdrawal Fee,-191.89,81b9ddb8-8b25-4311-bb40-a09f71252f96,-8838.66,debit,bank-fee,AU00000,2023-06-15T12:38:13Z
transaction,444ebbf9-9ec4-4fc7-9ab2-63ca1ffa6ffd,posted,Coffee Shop Purchase,-3719.6,adc3ed3c-a95b-4f64-9574-1b484d6d6830,-12558.26,debit,payment,AU00000,2023-10-10T00:11:36Z
transaction,04c95052-660d-4b20-a61b-0725ac6f9de8,posted,AGL RETAIL ENERGY LTD (GAS),-4025.97,f60d944b-38aa-43c1-b651-bf76b3fe5d41,-16584.23,debit,cash-withdrawal,AU00000,2023-08-03T08:13:12Z
transaction,9fb7520a-1ed3-488c-a6dd-129b7b0cdc67,posted,Payroll WFRMS 15439393,11880.08,a0e73ce1-a605-4a20-a7c2-6b95dd45e55e,-4704.15,credit,transfer,AU00000,2024-03-10T18:50:52Z
transaction,0d46186a-704a-4f03-8410-c78c9de763b6,posted,CTRLINK CARERS Ref: 998R6789201610974V,-461.22,56e74168-6c51-40f7-88f3-b762ad55e8ad,-5165.37,debit,bank-fee,AU00000,2023-09-13T23:39:30Z
transaction,272942d1-9778-4638-967e-02771b444051,posted,Home Improvement Store Purchase,-2860.97,69c48209-e7dd-4687-9e8f-e6b03f1d2af3,10041.61,debit,cash-withdrawal,AU00000,2024-05-10T11:26:19Z
transaction,d1aa6b12-cd25-4403-a37c-08d5cb25b1c7,posted,Restaurant Dinner,-190.57,984de418-8099-41d2-a849-653b52b657b2,9851.04,debit,cash-withdrawal,AU00000,2023-12-07T12:38:34Z
transaction,56a09011-3bee-4551-84c9-8134e3a31fb8,posted,Payroll WFRMS 15439393,11863.51,847c0f58-0cec-4502-9a7c-4c3e77a8e811,21714.55,credit,transfer,AU00000,2023-06-24T14:11:27Z
transaction,404baa92-dce9-4bfd-9344-751b7b68165f,posted,Music Streaming Subscription,-697.82,15d83af4-244a-46eb-9fee-c843b344614f,21016.73,debit,bank-fee,AU00000,2023-06-03T09:07:23Z
transaction,bc19b6bb-6f40-4cf9-9493-92c413e1c09b,posted,Hair Salon Appointment,-1128.29,59aa7966-88b3-4b14-af08-1bc0ac99cd9b,19888.44,debit,bank-fee,AU00000,2023-07-15T15:04:45Z
transaction,9feaf734-5d9e-4600-b9e9-4d2b7bd179ce,posted,Home Improvement Store Purchase,-2425.59,62fec2b0-89ce-40a9-b11d-7ec6d99732e3,17462.85,debit,cash-withdrawal,AU00000,2023-07-22T10:56:48Z
transaction,548d5d4c-982d-4949-b3f1-320ca5c84eb5,posted,AGL RETAIL ENERGY LTD (GAS),-1223.81,9192a1be-ab47-4f49-956c-ca6400bd238c,16239.04,debit,bank-fee,AU00000,2023-07-03T22:05:20Z
transaction,e2f82f4c-52ab-4440-9c5d-e05421fdf871,posted,Netflix Subscription,-1530.61,15776bd6-646f-47b4-86c2-35b8ee3e33ea,14708.43,debit,bank-fee,AU00000,2023-06-08T09:15:37Z
transaction,5729d96e-42a6-47b7-8d5d-0a1c1a46f64b,posted,Car Maintenance Expense,-1680.0,48a1ae4b-f374-4ec9-9208-229befcc17a5,13028.43,debit,payment,AU00000,2024-03-04T02:24:17Z
transaction,e8ce2b5d-7224-4c5b-9c8d-7f36e1a0a075,posted,AGL RETAIL ENERGY LTD (GAS),-4849.95,b6f438e9-1e68-487b-aa82-45aedd5a5254,8178.48,debit,payment,AU00000,2023-05-24T17:36:56Z
transaction,46deafda-5d3f-4e9c-bc93-c38effa7e88a,posted,Transfer Platnm Homeloan 346454,-2617.42,6e897b64-e071-4672-9960-06698e0ef24f,10264.49,debit,cash-withdrawal,AU00000,2023-09-14T11:25:21Z
transaction,82395e9e-1f4d-42d6-ab7a-b8d46fe37203,posted,AGL RETAIL ENERGY LTD (GAS),-42.03,5da75555-8226-4413-b30a-b18cbc6df582,10222.46,debit,cash-withdrawal,AU00000,2024-01-13T19:51:57Z
transaction,3e463c35-9ff1-4c92-89e9-ef0422764808,posted,Wdl ATM WESTPAC IGA BALGOWLAH BALGOWL AU,-2367.92,691f5a1c-3c81-4664-986a-bafc957d83d6,7854.54,debit,bank-fee,AU00000,2024-03-20T21:56:22Z
transaction,b5701744-2dd7-46ca-b15e-5d4ac54952e6,posted,Gym Membership Fee,-3537.58,b7152030-3fa3-4267-922c-54a4ec3a70f8,4316.96,debit,payment,AU00000,2023-06-07T04:39:44Z
transaction,4757b507-ed25-4d55-b871-c2c600ae943d,posted,TFR Acc14000 TO 12389,-1981.5,45aa14d6-f73e-4c69-96f7-3b8d51219f0b,2335.46,debit,bank-fee,AU00000,2024-02-09T13:01:53Z
transaction,16f4019c-d28c-499a-bfe1-8e52ef1906c2,posted,Coffee Shop Purchase,-501.02,8da4eacf-3fa6-4dc1-8211-7cf2e8d0c9be,1834.44,debit,bank-fee,AU00000,2024-05-05T11:58:37Z
transaction,5cc938db-df18-41d5-9692-03ccb90df7ef,posted,CTRLINK CARERS Ref: 998R6789201610974V,-4582.96,9679205b-5c66-44f1-a54b-b91ce5c5a8e4,-2748.52,debit,bank-fee,AU00000,2024-01-25T01:59:36Z
transaction,216f34e2-ef92-4e08-8520-8f0325eed5ac,posted,CTRLINK CARERS Ref: 998R6789201610974V,-97.77,bdc312ae-c11f-42cf-9080-ed3b7e15253e,-2846.29,debit,payment,AU00000,2024-02-16T04:46:32Z
transaction,94b3e463-bbd0-4223-b9da-eb45f32e6cdf,posted,Amazon Online Shopping,-750.53,28953b1a-0402-4cc9-9950-9e54b1eaf3c7,-3596.82,debit,cash-withdrawal,AU00000,2024-05-10T00:01:27Z
transaction,8f167f23-6f68-4599-b21e-a8d95ff54b7f,posted,Uber Ride,-4555.6,85e9bb4e-f6ce-4155-a639-2f66e8bcccfe,-8152.42,debit,payment,AU00000,2024-04-28T04:27:36Z
transaction,274a0edf-0c55-4f26-a727-8c5aca856111,posted,Clothing Store Purchase,-669.44,a1ee1a4d-d81b-4aab-abb5-fd399769d8c8,11376.82,debit,cash-withdrawal,AU00000,2023-05-28T18:20:10Z
transaction,5937bdb9-b71b-4781-b806-37cbf62169f3,posted,Bookstore Purchase,-3492.26,817c593b-437e-417f-ad63-1f6048a27e06,7884.56,debit,cash-withdrawal,AU00000,2024-02-02T21:53:27Z
transaction,3d023c94-4027-4aef-9e43-26962cbaa68c,posted,Uber Ride,-4317.91,7a90e2ab-9764-4229-9ab1-f71d489a8e97,3566.65,debit,payment,AU00000,2024-02-27T15:05:59Z
transaction,b5337b73-70b2-4686-b2f2-01f118d94cbb,posted,Travel Agency Booking,-167.02,3bdc4732-2df6-4ba8-bb44-63cdc40ecfc5,3399.63,debit,bank-fee,AU00000,2024-02-21T11:45:03Z
transaction,8b7bbd60-6920-48b5-98bd-c9c4738d54d8,posted,Music Streaming Subscription,-1471.8,6922b06e-8d89-4442-9053-8c6a3364f0cf,1927.83,debit,bank-fee,AU00000,2024-04-21T10:16:13Z
transaction,058d8f5a-c734-4a54-bd3f-b768813fa5fe,posted,Netflix Subscription,-3337.06,f8f02b9d-398d-4620-8ca5-4ddf2b0ea07b,-1409.23,debit,bank-fee,AU00000,2023-09-07T22:42:02Z
transaction,3d728fde-460c-4dfa-8032-4bc3e8ac89a9,posted,Gym Membership Fee,-2449.22,13a44253-ea35-4f72-97af-2db9cd180343,-3858.45,debit,cash-withdrawal,AU00000,2023-09-11T12:11:15Z
transaction,e50e46e9-5078-408c-8572-eba5a9c2eb7c,posted,Manly Maths Tutor Wages,-3214.6,2df4267e-0b0a-4650-8132-094db0aa9cfc,-7073.05,debit,cash-withdrawal,AU00000,2023-12-22T04:57:01Z
transaction,2a68b6e4-2578-4eb5-85d3-8550bea349b1,posted,Wdl ATM WESTPAC IGA BALGOWLAH BALGOWL AU,-984.16,e7ecfdf7-e7a6-4413-a6fc-2a4bc940be62,-8057.21,debit,bank-fee,AU00000,2023-06-24T01:56:06Z
transaction,346dfaaa-7b0e-42f9-9a99-f8573eb9514f,posted,Transfer Platnm Homeloan 346454,-963.54,2c148e10-38d7-43e3-ae9a-478a5f3a6bd2,-9020.75,debit,bank-fee,AU00000,2023-09-15T18:28:22Z
transaction,079323ca-a6c4-4de5-ad25-651959ffbe25,posted,Clothing Store Purchase,-3130.59,ed091ce6-0c45-472e-9c2d-2e2937fd17f8,15544.57,debit,cash-withdrawal,AU00000,2024-01-06T04:33:29Z
transaction,b23e4fe3-152c-4162-ab14-3e6e5279aeb3,posted,CTRLINK CARERS Ref: 998R6789201610974V,-1050.5,825ce079-7723-469f-b517-4a269cbde30c,14494.07,debit,cash-withdrawal,AU00000,2023-08-14T05:03:56Z
transaction,14c746c8-a559-46ba-9061-18959d1100fe,posted,Online Gaming Purchase,-3023.87,d00675fb-7b28-4280-9cb9-0b4a9454cc01,11470.2,debit,bank-fee,AU00000,2023-11-18T08:08:20Z
transaction,0ec53164-7128-4211-bc4d-6036c986e2de,posted,Music Streaming Subscription,-2747.38,1ef6e5a1-7dc9-4b59-8254-cbe167b2145d,8722.82,debit,payment,AU00000,2023-10-26T07:49:37Z
transaction,7100906b-fb0b-4c4d-a2ba-9948c4478cc7,posted,Non Hooli ATM Withdrawal Fee,-2958.03,a79fdf2e-0901-4d8f-a7b5-54691ef9ac61,5764.79,debit,bank-fee,AU00000,2023-08-12T08:53:37Z
transaction,3a391c64-9643-4e42-abdf-c9fb77621189,posted,Online Gaming Purchase,-2574.28,d02715b3-992f-46a9-926a-06b808516213,3190.51,debit,payment,AU00000,2023-06-30T22:48:36Z
transaction,1ba5ba51-e3b7-43f1-aa24-16aa0331fb91,posted,Netflix Subscription,-715.64,a007b555-97c7-47d2-bd7a-4a7b0006e898,2474.87,debit,bank-fee,AU00000,2023-10-06T02:35:48Z
transaction,55b9ec67-0342-4ba8-b6d7-40e308cca637,posted,Bookstore Purchase,-2262.6,8f0deb2a-a699-4ac3-a714-0a1b4d370272,212.27,debit,cash-withdrawal,AU00000,2023-12-16T15:45:52Z
transaction,7f3d3320-8358-4bea-b57a-8fcf04be5bf5,posted,Clothing Store Purchase,-2350.13,e25310d1-f164-4c83-95cf-87e744af3901,-2137.86,debit,payment,AU00000,2023-10-21T08:28:50Z
transaction,3f20c0ca-8e88-4909-b5ad-f6776aa2ac5b,posted,AGL RETAIL ENERGY LTD (GAS),-3917.8,8a2f309a-5992-47a1-a50c-c731cc26661a,-6055.66,debit,bank-fee,AU00000,2024-01-23T20:52:18Z
transaction,9d140107-ddf2-4c5d-903b-88b143282fff,posted,Movie Ticket Purchase,-718.34,06f7eb47-729c-499e-b274-9316f84a8f78,5350.2,debit,bank-fee,AU00000,2023-11-10T00:44:40Z
transaction,1247d3b3-21bb-49d2-baa7-b52e4b17828b,posted,Music Streaming Subscription,-4021.5,5b636b7e-ed5f-49fa-86e7-8fce8c2a071c,1328.7,debit,cash-withdrawal,AU00000,2023-06-26T23:23:58Z
transaction,d7701ac2-61c6-479f-9f9b-42723d7336f1,posted,Public Transport Fare,-2191.99,20e67b7d-ccc0-4f87-8575-26be126a4633,-863.29,debit,payment,AU00000,2023-08-09T19:59:41Z
transaction,d6ca9648-2131-4b2d-b12f-1fd5ee09fec8,posted,Pharmacy Purchase,-4551.95,e83944dc-4b07-4700-863d-baef5fcc2d0c,-5415.24,debit,bank-fee,AU00000,2024-04-02T14:44:00Z
transaction,747311ab-faf8-4a71-81d3-c3a4d371df4b,posted,Public Transport Fare,-2283.95,c58a4f17-d5de-4c33-8c97-067615c4011e,-7699.19,debit,cash-withdrawal,AU00000,2024-01-10T02:45:26Z
transaction,c69b2e75-6bc5-4504-b863-262b4809abc2,posted,Amazon Online Shopping,-4669.22,89d099ca-0668-45e8-8823-22a4e06d5199,-12368.41,debit,cash-withdrawal,AU00000,2023-09-17T12:07:01Z
transaction,226e81ee-c7a3-4b52-8c7a-458532563235,posted,Electricity Bill Payment,-81.8,c28d2d78-05af-44fd-ab33-9858c87e2144,-12450.21,debit,bank-fee,AU00000,2023-07-27T03:39:49Z
transaction,1b6e9ff1-2bda-49ed-a5b8-d53dbd9b4323,posted,Uber Ride,-1441.83,aee366dc-0f26-4036-9c07-2041b2af24f5,-13892.04,debit,payment,AU00000,2023-11-25T01:24:13Z
transaction,7f764e11-a45d-4185-abf4-3d6806f59db5,posted,Gasoline Purchase,-3147.71,f4a4e7dd-8264-4e72-a6ab-164a48c61e6e,-17039.75,debit,bank-fee,AU00000,2024-01-08T01:53:17Z
transaction,6557aa3f-6626-4a5f-80a9-9193059ee38b,posted,Car Maintenance Expense,-4838.35,3d002dcb-509d-4b66-ab0f-76c33a118d22,-21878.1,debit,cash-withdrawal,AU00000,2023-10-17T09:55:18Z
transaction,2ef9d913-4952-4f4d-9245-7e30f3b755a7,posted,Online Gaming Purchase,-3081.41,d5005d55-462b-4d69-a7bf-126ff400bcd2,2179.01,debit,cash-withdrawal,AU00000,2023-07-20T14:37:43Z
transaction,6debb329-e94c-4985-9a75-853de0043eca,posted,Bookstore Purchase,-4467.33,693c71bf-b263-465c-9a87-87b5511ecc25,-2288.32,debit,bank-fee,AU00000,2023-11-30T04:50:36Z
transaction,a3432b8a-6b55-46e6-be2d-69df6721c714,posted,Electricity Bill Payment,-1252.79,fa31d0eb-d805-4b6e-94a7-1ac15f2055c2,-3541.11,debit,cash-withdrawal,AU00000,2023-10-23T13:01:15Z
transaction,648e73e4-fc52-4cca-bca3-8f96abf5a2a7,posted,Public Transport Fare,-1517.01,cc438e7a-4037-49fe-84f2-1d71563ec027,-5058.12,debit,bank-fee,AU00000,2024-04-13T02:43:21Z
transaction,fd31a9a5-99d5-4710-8d8c-0a4e70dbae7b,posted,Music Streaming Subscription,-2545.66,fd7f8aa2-18ca-489b-99d4-7c70363a8d96,-7603.78,debit,cash-withdrawal,AU00000,2024-03-09T20:48:37Z
transaction,c6ad5b13-8717-465a-8298-73fb0201d311,posted,TRANSFER TO JOANNA SMITH CAMPING,-2129.05,e72af8a6-a328-41f1-8eaf-eb09d8822ca5,-9732.83,debit,payment,AU00000,2024-04-21T15:54:35Z
transaction,05e201f7-4592-4e92-8653-6ed97979ffdf,posted,Home Improvement Store Purchase,-3290.58,5dc0cc28-0935-441b-87cb-3af78fa6e0de,-13023.41,debit,payment,AU00000,2024-01-02T23:38:48Z
transaction,dd7aa718-45b6-48d4-ab46-67ce186d7c61,posted,CTRLINK CARERS Ref: 998R6789201610974V,-4988.74,3b1e177a-5de1-4ca8-9dc7-8c5210cfc68c,-18012.15,debit,cash-withdrawal,AU00000,2024-02-08T01:18:45Z
transaction,22dca2f6-7295-4c02-9329-cc792b419f5d,posted,Payroll WFRMS 15439393,10180.07,a8b3289b-62a8-4763-bd49-d70a11002e5c,-7832.08,credit,transfer,AU00000,2024-04-03T01:29:03Z
transaction,07c47be9-2491-4523-a172-58806258c0df,posted,Bookstore Purchase,-1236.53,42ede6e9-3e34-4bf5-a19d-3fff69fcb4c0,-9068.61,debit,payment,AU00000,2024-02-06T18:45:07Z
transaction,13831828-7461-4550-ab86-10c58f6ea9b2,posted,Home Improvement Store Purchase,-730.48,e4c833e8-3960-4f26-9645-4288725544e8,8510.29,debit,cash-withdrawal,AU00000,2023-08-02T01:31:07Z
transaction,a783c250-1c7a-4375-905f-0ba3c5b69705,posted,Mobile Phone Bill Payment,-3426.37,047f441b-17c9-42ab-9960-e0d5079f7d86,5083.92,debit,bank-fee,AU00000,2024-04-02T02:00:36Z
transaction,c68beb49-7954-463c-ae49-8fa9aafb653d,posted,Restaurant Dinner,-504.36,8c3b599f-8f45-4da1-9f9a-69186df6e715,4579.56,debit,bank-fee,AU00000,2024-04-04T14:12:22Z
transaction,06b28117-bb90-41db-a714-dbf7c36f2bfb,posted,Gym Membership Fee,-4534.18,4686105e-2cc0-4d0c-a65f-859dd0dace0f,45.38,debit,bank-fee,AU00000,2024-02-15T19:31:38Z
transaction,a0a5b939-5049-4665-8aca-f7eb300a6002,posted,TFR Acc14000 TO 12389,-3254.87,a9c10135-6ffd-4ecb-bbfc-96256858c6cc,-3209.49,debit,bank-fee,AU00000,2024-01-26T21:33:04Z
transaction,6812f993-e02b-410d-a79b-c637efe15890,posted,Movie Ticket Purchase,-2664.03,a06b50ca-1a39-498e-aae7-9219d4736d86,-5873.52,debit,bank-fee,AU00000,2023-12-08T11:52:46Z
transaction,8a4ec894-3f56-4d34-89a8-5b53972c9e06,posted,Transfer Platnm Homeloan 346454,-3912.81,6242bd33-497b-415e-be93-6add607ef1e2,-9786.33,debit,cash-withdrawal,AU00000,2024-03-28T06:04:57Z
transaction,6a0816b2-983b-46da-9a05-dce0ac9e2484,posted,Music Streaming Subscription,-2845.12,3b67c231-8564-4811-958d-9549dfd8dae0,-12631.45,debit,payment,AU00000,2023-06-12T05:01:15Z
transaction,90ab51ab-6f4a-4149-9abe-18e665bf067b,posted,Manly Maths Tutor Wages,-3497.73,944554cf-0c42-4211-9f33-7a84d758b119,-16129.18,debit,payment,AU00000,2024-01-21T17:06:50Z
transaction,8ca80e6f-3f6b-439b-bf67-8f650c1c1190,posted,Wdl ATM WESTPAC IGA BALGOWLAH BALGOWL AU,-1850.46,ef194206-0491-4db0-aa46-a8f215e16927,-17979.64,debit,bank-fee,AU00000,2023-10-28T01:38:11Z
transaction,133718c5-4b12-4e72-9d1c-2522d2bf7fcf,posted,Travel Agency Booking,-2100.91,d8a3c098-ce0c-4ebf-8031-1b48a5af655b,10839.41,debit,bank-fee,AU00000,2024-03-30T13:05:08Z
transaction,27e9842b-789f-4666-a08c-969d235fc86f,posted,Bookstore Purchase,-2824.31,880a45ac-396d-4da2-8019-997401136f63,8015.1,debit,payment,AU00000,2023-08-30T21:33:12Z
transaction,767c3c6c-fcb2-47dc-adae-13c6a5c7afd4,posted,Online Gaming Purchase,-3868.07,7635a39e-b0db-43a3-81d5-56ed2802aa71,4147.03,debit,bank-fee,AU00000,2024-01-05T06:57:25Z
transaction,477f116b-f6f1-485a-a01f-d2edae5c8acf,posted,Clothing Store Purchase,-2490.67,62b5f6a0-f5c1-481c-a2e9-de66329fff45,1656.36,debit,payment,AU00000,2024-05-09T04:43:59Z
transaction,a99b4bfc-b645-4bda-a1dc-6f1c656ab0f2,posted,Clothing Store Purchase,-2822.32,c0d87390-de0b-4dce-b555-55948be82d1c,-1165.96,debit,payment,AU00000,2024-04-14T22:19:07Z
transaction,37573f6b-79a2-43a1-8d88-7b8011268743,posted,Clothing Store Purchase,-1696.02,3ba4814c-e2f8-4edf-84e7-ee0880b46b44,-2861.98,debit,cash-withdrawal,AU00000,2023-07-12T12:24:20Z
transaction,4437697a-64fe-4268-adf2-aa196bf12a8d,posted,Transfer Platnm Homeloan 346454,-798.19,feb845e1-5270-41eb-a715-22bd8425ae55,-3660.17,debit,cash-withdrawal,AU00000,2023-11-16T00:36:10Z
transaction,880e4d01-78ce-4ba8-8549-543d4c14634c,posted,Coffee Shop Purchase,-4966.44,bda2de4a-b05b-403f-8c5a-ebb4b1a8feb9,-8626.61,debit,bank-fee,AU00000,2024-01-31T15:55:39Z
transaction,3fa85ac5-f9ec-406b-9f54-32243c7ba7dc,posted,Gym Membership Fee,-1873.23,6592dd92-abf2-4c4d-bc48-0601c80aacfb,-10499.84,debit,payment,AU00000,2024-01-17T23:39:38Z
transaction,d3c328f7-6978-4a5b-b622-904cd6db95f8,posted,Coffee Shop Purchase,-3070.5,b6059214-2e8d-4e7e-afb5-1fd6ab5ac761,-13570.34,debit,cash-withdrawal,AU00000,2024-03-20T12:56:11Z
transaction,2206f4db-2786-41ba-8275-b949a9a50775,posted,Car Maintenance Expense,-896.94,6c2108d2-472e-4f16-bf8f-71b9c418109d,18053.93,debit,cash-withdrawal,AU00000,2023-12-09T02:33:54Z
transaction,1d55515a-a892-4701-a5ef-28cee5f2c3f0,posted,Restaurant Dinner,-1006.62,c32fd5a7-7fee-4b6f-9b2f-277c6cc75e7c,17047.31,debit,bank-fee,AU00000,2024-01-05T10:38:56Z
transaction,6336b5ec-19a5-4b1a-b247-a426c3d81d28,posted,Restaurant Dinner,-4510.76,a1b87203-05eb-4a79-9c31-999f62ba4e23,12536.55,debit,cash-withdrawal,AU00000,2023-10-23T17:00:03Z
transaction,64ed9557-c3d2-44aa-9f77-4852a2b75106,posted,Pharmacy Purchase,-822.68,bdfad346-b3fa-445c-995a-da56f865c374,11713.87,debit,cash-withdrawal,AU00000,2023-10-19T19:22:47Z
transaction,07b27814-d5c6-4904-9c4c-9e7afd46d81c,posted,Netflix Subscription,-3559.49,166dbb90-1100-4476-919c-6c1c0abe3fca,8154.38,debit,payment,AU00000,2023-07-13T23:19:59Z
transaction,45d5e702-1e62-45be-88fc-d515cc5fe60b,posted,Gym Membership Fee,-768.93,35146da6-c662-44b8-a494-09e836ce4a46,7385.45,debit,cash-withdrawal,AU00000,2023-10-08T05:03:45Z
transaction,654ff954-1100-432d-92a9-501e2cd0ea2f,posted,Wdl ATM WESTPAC IGA BALGOWLAH BALGOWL AU,-270.58,66d70178-8f88-487c-a9e8-1461b67d131f,7114.87,debit,payment,AU00000,2023-12-14T20:12:38Z
transaction,aa0dbe22-c832-4e86-bade-e175256e1709,posted,Electricity Bill Payment,-4074.27,3669c347-57ff-4be3-9f7c-4321f62cd1bc,3040.6,debit,cash-withdrawal,AU00000,2023-12-22T14:23:54Z
transaction,b3124cfd-cc76-44ce-993e-6a40af87dfae,posted,Netflix Subscription,-337.88,5360cf97-3cfb-4f52-ac36-958af94430d6,2702.72,debit,payment,AU00000,2024-01-22T11:43:21Z
transaction,cb11cbc1-5b90-4dab-8cba-091b295624de,posted,CTRLINK CARERS Ref: 998R6789201610974V,-1170.0,d986f46a-d4bc-42c7-b10a-ebb126413ec0,1532.72,debit,cash-withdrawal,AU00000,2024-02-02T17:25:04Z
transaction,10ca9f2b-d482-47cd-a449-67783f102b93,posted,Uber Ride,-1697.25,d19fafe2-38ee-4481-b154-2bacc3961164,5795.89,debit,cash-withdrawal,AU00000,2023-06-14T19:00:23Z
transaction,e12204fb-2caf-4d1a-9e91-1e7f3293e4db,posted,Travel Agency Booking,-1191.15,cdf11359-cd5c-46c5-93db-5eed53847c00,4604.74,debit,bank-fee,AU00000,2023-05-30T05:38:59Z
transaction,b887b649-b2db-4bcc-9ce9-bae88e2490ff,posted,Netflix Subscription,-4601.39,c16fbb3f-8e02-484e-87ed-582b772fc040,3.35,debit,payment,AU00000,2023-10-30T03:22:33Z
transaction,afcdbe1d-a77e-460a-b522-2ee8b1d204c2,posted,Movie Ticket Purchase,-4104.58,8bda1f47-7df6-4ed4-ad1c-1ddb3fe26003,-4101.23,debit,payment,AU00000,2024-03-30T20:13:39Z
transaction,d3bf78bc-5bb1-4663-bb94-a31bf1b8e35e,posted,Hair Salon Appointment,-558.53,ba530f06-44ab-4b87-a8ee-fb9417e69811,-4659.76,debit,bank-fee,AU00000,2023-06-03T02:57:43Z
transaction,9d7af721-380b-4e11-8140-9d7f31b1a0ed,posted,Uber Ride,-1380.03,8aae6aec-3b2f-4262-afe3-8288e07cadc7,-6039.79,debit,bank-fee,AU00000,2024-03-14T04:26:56Z
transaction,f1af66e0-e64c-4295-adcf-a861c18b76b0,posted,Uber Ride,-2004.61,c193a301-5087-4a8e-aa1f-b75a4a8c9b20,-8044.4,debit,cash-withdrawal,AU00000,2023-07-12T23:20:58Z
transaction,79245083-408d-4f3a-9a87-9d358b922da9,posted,Coffee Shop Purchase,-1989.81,b8143229-a716-437b-a824-d04715acb9ca,-10034.21,debit,bank-fee,AU00000,2023-11-22T03:48:05Z
transaction,95d507f5-b877-4201-b8b5-e6d72f914d6a,posted,Public Transport Fare,-1505.6,3d59d8ca-53a3-4189-a9c3-7a43a66e24c5,-11539.81,debit,bank-fee,AU00000,2024-01-03T02:43:40Z
transaction,3cc26c51-ba64-482a-a690-6c33ba0a583c,posted,Manly Maths Tutor Wages,-1163.36,a0add1f6-5251-4d57-a8c1-5afb1d32ba1d,-12703.17,debit,payment,AU00000,2024-01-06T12:45:57Z
transaction,5f2fd09c-09eb-46ec-87ce-1f8db400bbc0,posted,Public Transport Fare,-2627.8,963ca15c-023f-47ad-8ac1-f2a0ebe071a5,12503.7,debit,bank-fee,AU00000,2023-08-02T18:52:27Z
transaction,1e040b4c-c0bc-46ca-b757-aa0eeff3e3f6,posted,Home Improvement Store Purchase,-4300.62,74ae285c-bdd6-4286-ac5e-1aad16e8aa91,8203.08,debit,bank-fee,AU00000,2024-01-20T07:20:06Z
transaction,e82ad4a3-72f6-44a6-b1ad-1f0c250b2678,posted,Online Gaming Purchase,-4783.07,8f42b7be-eb01-4ef9-84a7-e70873381f04,3420.01,debit,cash-withdrawal,AU00000,2023-05-24T14:41:10Z
transaction,96272d6f-cd52-4568-ac7a-d0df03d0ea7d,posted,Coffee Shop Purchase,-3546.69,5b989be0-2a8e-4e0b-97f7-632d99ff35b7,-126.68,debit,cash-withdrawal,AU00000,2023-07-09T06:37:05Z
transaction,49f8d041-f8ab-4b79-9c9b-38d3bfd08587,posted,AGL RETAIL ENERGY LTD (GAS),-2023.42,cc51cb33-215d-4c78-8533-5e73e25c7d89,-2150.1,debit,payment,AU00000,2023-07-28T09:50:43Z
transaction,dd850b8b-50fa-4a42-9d91-835a2e0122e0,posted,Amazon Online Shopping,-2944.64,094ed3d2-a50a-491c-a21f-db423c9350e4,-5094.74,debit,bank-fee,AU00000,2023-10-02T13:27:16Z
transaction,77e1ed2d-6897-408c-9621-c76eba8d3078,posted,Amazon Online Shopping,-1697.94,6070f615-5311-4d56-a4ec-23d46376e2ba,-6792.68,debit,payment,AU00000,2024-03-27T10:04:20Z
transaction,593a0aae-2a5f-4220-97b0-17942754d214,posted,Restaurant Dinner,-4021.71,dd5e3d59-05ce-40f2-a505-b38048d7281d,-10814.39,debit,bank-fee,AU00000,2023-06-02T15:44:00Z
transaction,69353543-704b-427b-a4ae-1134e918565a,posted,Manly Maths Tutor Wages,-1666.26,0d29b37a-6693-4d01-81b3-5f50828ca005,-12480.65,debit,payment,AU00000,2023-08-27T02:04:36Z
transaction,6e018752-606d-4b78-a9b6-de50ee89bdb5,posted,Payroll WFRMS 15439393,11341.8,05a0a818-a062-4c42-82df-fe51d9b1ebb0,-1138.85,credit,transfer,AU00000,2024-03-08T17:02:57Z
transaction,8a2448b1-794b-41ae-9fbf-ae38f85345d1,posted,Uber Ride,-3176.23,50a5e0c3-951a-4e7d-8c04-305f38a201a7,12681.31,debit,cash-withdrawal,AU00000,2023-11-26T07:10:11Z
transaction,0556c656-c631-41d3-88c1-129d06519de8,posted,Amazon Online Shopping,-4617.05,86b2ebb7-5594-4448-a688-f50c4be861e8,8064.26,debit,cash-withdrawal,AU00000,2024-01-17T11:02:22Z
transaction,ee35c0c3-07a1-4016-9609-5aa650bd54d9,posted,Mobile Phone Bill Payment,-695.76,a484b30b-6dcc-4d95-a998-0cad18759995,7368.5,debit,bank-fee,AU00000,2024-03-03T06:45:34Z
transaction,154e224c-ee8e-4451-bf59-cb2b5d14e90d,posted,Home Improvement Store Purchase,-3814.33,b7490ace-ed32-45c6-bfb4-99dc383178a3,3554.17,debit,cash-withdrawal,AU00000,2024-01-25T23:50:41Z
transaction,25ec8d39-efdf-4de1-8496-225cdd6967f2,posted,Mobile Phone Bill Payment,-4470.72,3ca313fa-1748-4e28-8e65-105135196701,-916.55,debit,cash-withdrawal,AU00000,2023-08-08T03:14:14Z
transaction,af02febb-412f-415c-902c-fff9f9b00621,posted,Music Streaming Subscription,-3655.69,76ea7ced-312e-49c4-b360-2af6618a0748,-4572.24,debit,bank-fee,AU00000,2024-01-15T20:13:46Z
transaction,cfbc9208-6f89-4866-861a-708a6d144093,posted,TRANSFER TO JOANNA SMITH CAMPING,-3182.53,e411f3c5-9189-4097-9df4-9b681c3bf068,-7754.77,debit,cash-withdrawal,AU00000,2024-03-12T21:33:06Z
transaction,44a019bf-4f12-4f26-b8be-44715d80f8ce,posted,Uber Ride,-2869.1,a055a0d3-2568-4180-96d1-076529276893,-10623.87,debit,cash-withdrawal,AU00000,2023-07-26T13:06:18Z
transaction,7cfdb8fc-0058-4e75-a3bc-92020b642927,posted,Mobile Phone Bill Payment,-633.86,1bd72d56-ffdf-4bb9-aead-b86210b5c0ab,-11257.73,debit,bank-fee,AU00000,2024-04-16T03:09:01Z
transaction,d9d0584b-7ce9-4b1d-8fa8-60eeebcb12f3,posted,TRANSFER TO JOANNA SMITH CAMPING,-4347.6,54f0dc2f-2561-4322-b22c-376ee6855308,-15605.33,debit,bank-fee,AU00000,2024-03-23T16:14:17Z
transaction,50dd4354-1731-4f84-ae5f-9713c9173630,posted,Gasoline Purchase,-2662.41,5d5d2c4f-ad30-4ae9-8c6c-3f9bdb990a01,3384.82,debit,bank-fee,AU00000,2023-06-07T16:41:19Z
transaction,571b31b7-2311-4b1f-8d97-a111cf1f107a,posted,Non Hooli ATM Withdrawal Fee,-1157.62,05a65ab5-74b7-4458-94a1-0f63c1b328f8,2227.2,debit,payment,AU00000,2024-02-27T23:46:22Z
transaction,be7c1b5b-3f6a-46f9-b883-67fb757ce317,posted,Music Streaming Subscription,-4985.96,452b2697-87bd-4ec7-b3b7-36705a7e32cf,-2758.76,debit,bank-fee,AU00000,2024-04-14T21:41:50Z
transaction,43c6ec94-98a7-4c33-bf14-088394975bbc,posted,Electricity Bill Payment,-2744.2,d910b60d-7464-4fd4-9da3-6fb9ea97c424,-5502.96,debit,cash-withdrawal,AU00000,2023-12-13T21:46:31Z
transaction,f385112b-48b2-4a34-b08d-84ce6f54031e,posted,Online Gaming Purchase,-4384.95,6e100118-3d7c-4562-8333-1bdc810967fe,-9887.91,debit,bank-fee,AU00000,2024-02-01T12:35:40Z
transaction,5ef6c463-4e28-49ea-8f47-7585f1af7ae2,posted,TRANSFER TO JOANNA SMITH CAMPING,-1964.69,15d23a94-faac-421b-a828-b5e41b1bc902,-11852.6,debit,cash-withdrawal,AU00000,2024-02-25T14:33:55Z
transaction,19ce0f3f-8374-4093-b3e8-9c4841f99949,posted,Clothing Store Purchase,-4747.74,22a2be20-4231-4d37-8f10-53cebba78cac,-16600.34,debit,bank-fee,AU00000,2024-02-01T06:43:26Z
transaction,42293f20-0fc6-4b1f-85c2-cefc9e516c75,posted,Uber Ride,-3040.47,ffd6d0df-ae29-4491-8462-b329b03569c4,-19640.81,debit,payment,AU00000,2024-03-06T09:13:32Z
transaction,e1af63ab-f106-4440-9e41-99dd2129e36e,posted,Restaurant Dinner,-1755.05,ecec9395-c425-4c40-9e29-ffc7d924683b,-21395.86,debit,payment,AU00000,2024-03-25T08:00:29Z
transaction,6a492b89-8e4a-4003-a1e0-8bb729e6b74b,posted,Clothing Store Purchase,-2214.66,559339d4-86bd-4439-9233-2805f1c4d18b,-23610.52,debit,payment,AU00000,2024-02-09T18:05:23Z
transaction,d6579e0b-4af4-4bfe-9db5-e0fe7fa97c77,posted,Transfer Platnm Homeloan 346454,-4921.53,406bd9ed-4601-4a7c-a35a-9019beb32b50,3322.07,debit,bank-fee,AU00000,2023-06-16T02:42:51Z
transaction,8942aee0-e5c7-4b8e-9904-331ac85cd3c8,posted,Home Improvement Store Purchase,-4600.77,5587016b-77ae-488b-a2b3-29a1e26161cd,-1278.7,debit,payment,AU00000,2023-06-03T06:35:28Z
transaction,690de32f-61f3-4c0b-9f1f-237ebfa0b6a1,posted,Mobile Phone Bill Payment,-671.77,8db62d31-a891-47cd-a676-e4aa897c6b80,-1950.47,debit,bank-fee,AU00000,2023-10-14T06:21:56Z
transaction,19cecc94-e266-4ec5-84b6-1a79061ffce3,posted,CTRLINK CARERS Ref: 998R6789201610974V,-4981.5,50447a05-03ec-475e-9d1d-8f4b23559718,-6931.97,debit,bank-fee,AU00000,2023-08-30T08:23:17Z
transaction,5fba5ad5-f2f4-4e51-ba0e-93ec2af83455,posted,Gasoline Purchase,-1668.21,3ebd2457-3afc-42c9-8cf0-87b752371510,-8600.18,debit,payment,AU00000,2024-01-31T04:52:07Z
transaction,6abb72b7-77d2-48bd-b915-5c5e9d1f8bbc,posted,Clothing Store Purchase,-7.38,53d21b9e-9775-496e-aa33-1ff57e8c1a43,-8607.56,debit,bank-fee,AU00000,2024-05-02T03:45:40Z
transaction,3ac84c79-71eb-47b5-b57f-fc03966e7944,posted,CTRLINK CARERS Ref: 998R6789201610974V,-3339.87,0783eb58-c56b-4850-854c-4dab0f459d82,-11947.43,debit,cash-withdrawal,AU00000,2023-06-11T02:52:17Z
transaction,d195ed0b-86d1-45a9-875d-a87b41a9bf5e,posted,Electricity Bill Payment,-1889.06,53a9ff91-2dfa-4f0b-b23f-fb622b911972,-13836.49,debit,bank-fee,AU00000,2023-10-10T13:36:29Z
transaction,5616b202-a359-4ab4-9399-e80b9f17814f,posted,Restaurant Dinner,-691.12,fa92a315-0014-4892-9de7-5c23c12b0473,-14527.61,debit,cash-withdrawal,AU00000,2023-06-12T01:50:58Z
transaction,f8e8ff3e-5a38-4aab-877b-9bce31c38769,posted,Payroll WFRMS 15439393,10183.69,9ffebe8b-612c-4b8f-8a35-33ad81d5af05,-4343.92,credit,transfer,AU00000,2024-01-25T05:40:05Z
transaction,4826cb41-5ba5-492c-aa4d-a35a8bb3cd2d,posted,Bookstore Purchase,-3238.05,c9a3350a-ec8d-4aca-8af9-3510889c76b6,7702.62,debit,cash-withdrawal,AU00000,2023-10-01T18:54:53Z
transaction,caa41eb6-1c58-435f-a969-8bd6969be415,posted,Home Improvement Store Purchase,-4045.92,72132879-4b4d-4938-b5dc-eaa0702c619e,3656.7,debit,cash-withdrawal,AU00000,2024-02-07T23:56:59Z
transaction,662974a2-425b-4800-a3b4-87f4cb045fb3,posted,AGL RETAIL ENERGY LTD (GAS),-3184.66,1204c326-5f61-4bbb-975c-92c27b22b89a,472.04,debit,cash-withdrawal,AU00000,2024-01-19T08:18:49Z
transaction,0c04a50b-7315-46c4-9fe1-3ab0b6f8d5f4,posted,Music Streaming Subscription,-3655.07,4c8f4f09-80e7-46c9-8d6c-bfc95bfc8328,-3183.03,debit,bank-fee,AU00000,2023-09-09T03:18:04Z
transaction,e975afde-30e3-4978-b5c5-c42501e3918e,posted,Hair Salon Appointment,-4977.22,cd942a29-108f-45ec-8b51-3ef64872df6d,-8160.25,debit,payment,AU00000,2024-03-27T02:38:49Z
transaction,07d3085a-d8c4-4c4b-a4f5-71b868871654,posted,Public Transport Fare,-3305.78,c9b6df52-1e13-4358-a2a6-467d610b0bc5,-11466.03,debit,cash-withdrawal,AU00000,2024-04-26T17:51:52Z
transaction,c57e6726-9105-45f6-918b-4cf58ad7bedd,posted,Music Streaming Subscription,-538.97,88cc1c83-6125-401a-8266-f99156344ca0,-12005.0,debit,payment,AU00000,2023-06-27T11:48:41Z
transaction,a0f251d1-2f63-4a63-a887-790d2f2cd895,posted,Pharmacy Purchase,-2363.21,97caab82-4752-4fb0-811b-27ed219e9a29,-14368.21,debit,bank-fee,AU00000,2023-12-23T03:47:52Z
transaction,45591c22-eaba-47a5-8782-d5be0581be50,posted,Home Improvement Store Purchase,-1614.31,2110e36b-92ff-40db-a803-494d9a0ec115,-15982.52,debit,payment,AU00000,2024-03-08T01:54:26Z
transaction,46b4180a-1526-46d7-90e8-5d43b165903d,posted,TRANSFER TO JOANNA SMITH CAMPING,-3147.48,c9eb495f-de3f-49b3-858d-df4d2e59a034,-19130.0,debit,bank-fee,AU00000,2023-08-17T15:20:24Z
transaction,c50fae77-5cb0-488a-acd2-77070cbcdff7,posted,Music Streaming Subscription,-2778.68,52bd8293-2207-42bb-a3aa-74ae92a25224,2513.3,debit,cash-withdrawal,AU00000,2023-12-08T07:04:21Z
transaction,07083b04-f01d-41c8-8ca7-9c0b974916a8,posted,Bookstore Purchase,-4472.73,e076d2d4-6897-4c1b-87e9-ec3a1fb54be0,-1959.43,debit,bank-fee,AU00000,2024-02-02T05:16:56Z
transaction,228156a7-f613-4512-97c6-00278048a7bd,posted,Wdl ATM WESTPAC IGA BALGOWLAH BALGOWL AU,-450.88,48daf180-ebab-488b-aecf-d74b6a05dee8,-2410.31,debit,payment,AU00000,2024-03-11T22:18:46Z
transaction,3179848c-ab05-40b3-9db6-8c5e68c0ebf2,posted,CTRLINK CARERS Ref: 998R6789201610974V,-356.93,f3380220-de61-4272-8aed-117c4c93dd7e,-2767.24,debit,cash-withdrawal,AU00000,2023-06-12T09:23:37Z
transaction,7008a74e-cba2-44ba-b48d-700d9f0e3d73,posted,Public Transport Fare,-2728.39,6f5746a8-fef3-492c-b087-bce300bc784c,-5495.63,debit,payment,AU00000,2023-09-27T22:02:14Z
transaction,721fd040-df34-4ba2-a98b-a274e45712cb,posted,Restaurant Dinner,-4088.93,8c109169-56f2-46a7-93c0-908da3a29c91,-9584.56,debit,payment,AU00000,2024-04-22T08:05:10Z
transaction,bb21c028-cb21-49c2-91f4-2bb6f7a95be5,posted,Car Maintenance Expense,-381.58,f79bc0c5-cb7f-45a2-aae0-baf83f398f35,-9966.14,debit,cash-withdrawal,AU00000,2023-05-16T22:03:44Z
transaction,6f703053-3e5f-4d52-911c-db48f3629ae3,posted,Hair Salon Appointment,-1377.44,c4bd8460-143e-4965-80d1-8671a6c77cb1,-11343.58,debit,payment,AU00000,2023-12-03T10:52:48Z
transaction,6c6c33d0-1c05-440f-9520-27ff09b87d53,posted,Non Hooli ATM Withdrawal Fee,-2092.65,7656ce41-86de-453e-a37b-d2638ec6ad9a,-13436.23,debit,bank-fee,AU00000,2023-08-21T17:54:17Z
transaction,a8545744-7e9e-4be6-a275-9ef001bc14d7,posted,Electricity Bill Payment,-1471.87,03911e06-f706-4d5a-82d7-ee155e243482,-14908.1,debit,payment,AU00000,2024-02-15T08:43:31Z
transaction,119698fe-277b-443d-bdd6-9b44edbc8d34,posted,Bookstore Purchase,-756.49,7267b839-eb9d-4f81-982d-0527e6ee9f30,17538.34,debit,cash-withdrawal,AU00000,2023-06-18T23:16:34Z
transaction,3ba3d564-1c12-46f3-a9f2-bdc692296375,posted,Mobile Phone Bill Payment,-995.58,a9d90877-6ee0-47d3-8b88-cd3e8b4bd8c9,16542.76,debit,payment,AU00000,2023-08-31T13:03:37Z
transaction,f70a67e1-a5e8-4e51-bd2b-9e41a7857310,posted,Movie Ticket Purchase,-3573.96,d3da3f4f-52f0-47b2-99a4-bfdfdd564a5a,12968.8,debit,payment,AU00000,2023-07-30T01:29:28Z
transaction,332261c3-c23a-4f91-b007-00be661cf34d,posted,TFR Acc14000 TO 12389,-2509.54,b3740848-a5dd-49a8-bd97-98815e7a2f5d,10459.26,debit,cash-withdrawal,AU00000,2023-06-20T09:22:21Z
transaction,1711ee50-1645-40a0-96cf-cecf58ed57c0,posted,Online Gaming Purchase,-4774.76,c9014dd1-e227-417a-955d-363846a13993,5684.5,debit,payment,AU00000,2024-04-26T16:09:08Z
transaction,ca3848b2-dd11-4c07-9bf8-f4705eede849,posted,Bookstore Purchase,-3924.84,8536ec75-953a-4662-922e-49b424ffe7a1,1759.66,debit,bank-fee,AU00000,2024-03-25T20:28:04Z
transaction,43b53216-a32f-4ab2-b183-729ff544fd3b,posted,Public Transport Fare,-2958.78,0838b7a2-10e5-446b-aa83-b87e2906cd6c,-1199.12,debit,cash-withdrawal,AU00000,2023-10-28T08:32:34Z
transaction,0a6768ac-440f-4cf9-86eb-e4994afee2f7,posted,Movie Ticket Purchase,-3712.19,d5f266f8-72b7-483c-99df-aab0c79e2da1,-4911.31,debit,payment,AU00000,2024-04-28T13:58:07Z
transaction,35fc2b97-1bd6-4d95-a43f-d55c0167ec76,posted,Gasoline Purchase,-976.44,da382aa5-59cf-4147-94af-611bf428d1c8,-5887.75,debit,cash-withdrawal,AU00000,2024-02-04T23:03:14Z
transaction,5189d122-a7d1-439f-805d-629f1d527a63,posted,Payroll WFRMS 15439393,10229.35,9defef65-3d14-419a-9f1a-c16ffdb7302c,4341.6,credit,transfer,AU00000,2023-06-03T23:10:16Z
transaction,21dc2f43-8ee8-45f5-89db-2f2897740d05,posted,Home Improvement Store Purchase,-1856.3,344e21ce-0083-408f-9022-8de0b250ce0f,10484.13,debit,bank-fee,AU00000,2024-02-09T01:31:15Z
transaction,529925fe-1d93-4295-8661-d8e8e44b60ad,posted,AGL RETAIL ENERGY LTD (GAS),-4170.63,40967814-7f5a-4f10-9358-4d68d3b625cb,6313.5,debit,payment,AU00000,2024-01-13T00:58:58Z
transaction,6bc47edc-1c87-4965-ab52-67c6bc8023e2,posted,Gym Membership Fee,-334.24,b11fe98a-72f7-4e26-837d-427cae0bc49f,5979.26,debit,bank-fee,AU00000,2023-06-10T02:31:32Z
transaction,7c1c6152-3efa-492b-97d5-f25259cdca19,posted,Mobile Phone Bill Payment,-3080.67,f501b187-78c9-4a45-b4e6-d06d3ec05f3e,2898.59,debit,bank-fee,AU00000,2023-06-26T08:33:13Z
transaction,74179f41-40b6-4f83-8ad5-47755aa90f7f,posted,Wdl ATM WESTPAC IGA BALGOWLAH BALGOWL AU,-4187.6,7e3dc807-71c6-4722-a11f-0cb6d84b21a7,-1289.01,debit,payment,AU00000,2023-08-01T08:13:17Z
transaction,05064b79-fb9e-4790-aa43-d03833260e9c,posted,Bookstore Purchase,-2855.2,30f94c57-da1f-4442-993d-9f4e1c84bd06,-4144.21,debit,bank-fee,AU00000,2024-03-03T11:09:35Z
transaction,116f4151-6027-4749-8851-ea00313c1726,posted,Amazon Online Shopping,-4171.42,624b69ea-8100-48ca-b272-3c21574dc3ca,-8315.63,debit,cash-withdrawal,AU00000,2024-04-18T20:35:56Z
transaction,fd265362-8c64-4331-8c00-f553fa899f0c,posted,Gym Membership Fee,-970.85,cdd6f8b8-bb9a-4bb1-87a3-3b59efb827aa,-9286.48,debit,bank-fee,AU00000,2023-06-08T20:36:09Z
transaction,2dbd028b-b983-426b-8892-9b4dba258a84,posted,Manly Maths Tutor Wages,-2568.57,3b6df4d1-574a-4622-9c44-43affd599eea,-11855.05,debit,cash-withdrawal,AU00000,2024-01-21T14:38:31Z
transaction,e4495e53-a4c6-44c6-a0a9-56eb72f03a22,posted,Electricity Bill Payment,-3089.17,585ab54b-b327-419c-8bfd-bf0a3ea16a12,-14944.22,debit,cash-withdrawal,AU00000,2024-01-07T11:40:21Z
transaction,8c2f42aa-4032-48cc-a779-9e87017e710e,posted,CTRLINK CARERS Ref: 998R6789201610974V,-2162.17,dd2337a2-ceaa-4c07-befb-e8302eb3d2a3,10011.37,debit,cash-withdrawal,AU00000,2024-04-20T20:58:42Z
transaction,312c68e1-a949-4bb3-abb8-25df383031d5,posted,Pharmacy Purchase,-4755.5,9436bd1e-0d15-4edb-a762-cd42f564eaef,5255.87,debit,payment,AU00000,2024-05-07T11:55:49Z
transaction,aa352ca0-9535-4500-893b-9af5dc81b7ce,posted,Car Maintenance Expense,-1444.82,167ddaae-c64b-4e7e-8628-4be3c6b0f1dc,3811.05,debit,bank-fee,AU00000,2023-07-30T00:59:21Z
transaction,cb3a251f-02ae-4496-84a3-4559c9807d35,posted,Netflix Subscription,-2062.61,c3f80269-781c-4dda-aac8-5c2a191498b5,1748.44,debit,payment,AU00000,2023-08-29T06:52:19Z
transaction,2dad7ed0-f978-4ad3-b749-33cb5ccf771b,posted,Amazon Online Shopping,-22.49,1b758879-d6ae-4a65-a77b-e51e01e7af2e,1725.95,debit,payment,AU00000,2023-05-18T11:11:02Z
transaction,e520ce20-faa9-4623-88fe-4e34f5c9dafa,posted,TRANSFER TO JOANNA SMITH CAMPING,-2413.77,8359fb9b-51b7-4c2d-b6e3-30ac421823bb,-687.82,debit,payment,AU00000,2024-03-20T22:21:43Z
transaction,2a652c3a-c46f-422a-b46f-183c2f420f55,posted,Pharmacy Purchase,-4943.98,af41d163-660a-4683-b45f-43023b024f9a,-5631.8,debit,bank-fee,AU00000,2023-08-29T17:40:18Z
transaction,f80e5cc4-963f-4e0d-aa20-5ab354253be0,posted,Gym Membership Fee,-3489.76,87377783-6e8a-464a-88df-7b8e1861d85e,-9121.56,debit,bank-fee,AU00000,2023-10-11T10:23:20Z
transaction,703c40e1-b1f2-46ee-b2ec-b27dc3d9a19d,posted,Netflix Subscription,-2136.39,2e2028a9-afc7-4c91-99a9-29a26df6338c,-11257.95,debit,cash-withdrawal,AU00000,2023-07-23T05:14:31Z
transaction,3a320347-b72c-4bbf-ab3c-b759ebaf2c3e,posted,Public Transport Fare,-852.79,99bc6afe-ffeb-4ab1-9c83-bcabf4f6b08e,-12110.74,debit,cash-withdrawal,AU00000,2024-03-19T13:55:42Z
transaction,e2c5bee1-9b03-431a-aad6-a46cdc53ddeb,posted,TRANSFER TO JOANNA SMITH CAMPING,-4265.52,36029138-c177-41da-ac7d-ce5ae0645caa,13410.77,debit,bank-fee,AU00000,2023-07-16T07:40:45Z
transaction,92062ca7-ff46-429b-8796-859d6dadfb50,posted,Wdl ATM WESTPAC IGA BALGOWLAH BALGOWL AU,-3612.98,b29efaba-aabf-4f7e-919b-73ed68ee707e,9797.79,debit,payment,AU00000,2024-03-10T02:20:12Z
transaction,4676ce6c-8212-4f47-b2c7-7b5b1bda2b26,posted,Home Improvement Store Purchase,-2539.59,d2c001e2-5bc3-4164-8730-dd6606c12502,7258.2,debit,bank-fee,AU00000,2024-02-04T16:11:20Z
transaction,045ce705-7a57-452d-9f47-25cb748d1d4d,posted,Payroll WFRMS 15439393,10346.38,f9ade82d-789a-4fa9-b3a5-dc5cb013da8e,17604.58,credit,transfer,AU00000,2023-09-08T09:45:36Z
transaction,9ab1755e-96b0-46d1-a15a-daa08dba2c0a,posted,Travel Agency Booking,-582.37,1f3d6b27-6b3a-4f48-85b4-9e744cc3543e,17022.21,debit,cash-withdrawal,AU00000,2023-12-22T14:41:00Z
transaction,fe04c1c0-605e-46d2-925a-46bcb05a350b,posted,Bookstore Purchase,-2554.92,da334f9a-1adc-46e8-aba4-48284119d2fb,14467.29,debit,payment,AU00000,2024-02-09T08:40:31Z
transaction,6437343e-d832-4a88-97df-f6ca66037ce9,posted,Transfer Platnm Homeloan 346454,-2828.99,634d3a18-9700-4a66-ba20-01f24ba0f98b,11638.3,debit,payment,AU00000,2024-01-07T22:32:29Z
transaction,9e0909f5-8864-455b-aa5a-93b811b2c873,posted,Travel Agency Booking,-506.85,b60d73fd-87b1-4851-8e8b-87ebbacff952,11131.45,debit,cash-withdrawal,AU00000,2023-09-29T11:39:10Z
transaction,bc3a7fd2-a048-411c-a244-01c247c85d6e,posted,Electricity Bill Payment,-1055.6,49a65fe9-531f-43a9-8253-d81b6d57e80a,10075.85,debit,bank-fee,AU00000,2023-06-29T05:11:06Z
transaction,d9c59172-4f69-4a5e-ad8e-fa12e34bdffc,posted,Non Hooli ATM Withdrawal Fee,-1681.12,2022e528-830e-45d8-9078-97e3feba1026,8394.73,debit,cash-withdrawal,AU00000,2023-07-30T13:22:09Z
transaction,c929a601-018b-47a6-a2fe-2e4c2a5ee478,posted,Payroll WFRMS 15439393,10212.87,aa8b1b95-7bb7-40b8-820f-3172cde4999c,26131.18,credit,transfer,AU00000,2024-03-10T21:55:08Z
transaction,249c6a32-7bca-43c4-9b1a-bf4189e86209,posted,Wdl ATM WESTPAC IGA BALGOWLAH BALGOWL AU,-56.88,0493c3b2-a42c-478c-98cc-90bfbfcd325e,26074.3,debit,cash-withdrawal,AU00000,2023-10-28T15:44:43Z
transaction,81dd5a18-d029-4e60-a3f0-ec38a113d8d0,posted,Payroll WFRMS 15439393,10088.75,a46f7a49-e104-436b-89dc-a3c6112af08b,36163.05,credit,transfer,AU00000,2023-07-03T10:53:50Z
transaction,d05c1417-d9fd-43d0-a475-08e60a6f5e64,posted,Manly Maths Tutor Wages,-2485.56,0b9bd62b-bc05-4209-9b3b-89e98f98949e,33677.49,debit,cash-withdrawal,AU00000,2023-06-22T07:31:59Z
transaction,f81942d3-1794-4297-bde3-376bd7259649,posted,Non Hooli ATM Withdrawal Fee,-1058.26,9538af24-c447-43cf-8f40-b33cc48a14ca,32619.23,debit,payment,AU00000,2024-01-25T18:14:43Z
transaction,9c7193db-bf2a-4d25-9887-23eceb9022f3,posted,Hair Salon Appointment,-201.53,d2c98e83-6d28-4354-9c78-7fc4ec94ebce,32417.7,debit,payment,AU00000,2024-02-24T12:43:03Z
transaction,06eedbe3-aaf7-491d-813a-10946c004365,posted,Gasoline Purchase,-158.51,18ae7b67-e925-4fc6-8751-32f8202894a5,32259.19,debit,payment,AU00000,2023-06-04T23:45:20Z
transaction,a1b790c0-97ec-4b0b-8d46-f18d6497bcca,posted,Non Hooli ATM Withdrawal Fee,-3108.75,7abe5348-5690-42eb-9faa-a481c45aedf6,29150.44,debit,cash-withdrawal,AU00000,2023-09-13T16:03:40Z
transaction,659f1617-7a3d-47c2-901e-ef3413767cb4,posted,Non Hooli ATM Withdrawal Fee,-2186.69,86534830-76ca-4e15-8bc8-88c3f20da768,26963.75,debit,payment,AU00000,2023-08-02T19:29:00Z
transaction,bc14cd88-b607-4586-8d32-f064916adc0c,posted,TRANSFER TO JOANNA SMITH CAMPING,-1059.44,bc98e523-139c-48f2-83e8-f8783e9c5548,25904.31,debit,bank-fee,AU00000,2023-08-18T13:06:31Z
transaction,1d6100ac-ba86-4339-af05-fff5febdb69d,posted,Mobile Phone Bill Payment,-4410.53,2c177eb2-c335-4eb3-a1d1-c1d335b8b223,5386.41,debit,bank-fee,AU00000,2024-03-13T06:09:37Z
transaction,6044e456-4688-495f-abe0-9031ff023e06,posted,Amazon Online Shopping,-1607.55,a6a59042-fb04-437d-b2f7-ee5aaa4b2543,3778.86,debit,payment,AU00000,2023-06-26T11:56:01Z
transaction,1ef140e5-1389-43b0-bfde-b891bc501d98,posted,Hair Salon Appointment,-3943.12,6d0ecc6c-7ab8-427f-b2f3-cdb0d9b18f02,-164.26,debit,cash-withdrawal,AU00000,2023-11-26T04:03:52Z
transaction,8a969d1a-3e78-4aba-8269-5bda15b6ae29,posted,Travel Agency Booking,-313.78,ab16223e-e0da-4c9b-926f-38eedc9cf208,-478.04,debit,cash-withdrawal,AU00000,2023-07-20T21:28:41Z
transaction,e72746cf-9cb8-45e1-9e53-d146d49438ba,posted,Hair Salon Appointment,-4995.72,b5021265-0e5a-4b8f-a877-5f49735ec941,-5473.76,debit,payment,AU00000,2023-09-08T13:52:57Z
transaction,006cf3ba-40c4-47b2-bc3b-6dbfeb160e7c,posted,Netflix Subscription,-4938.12,1d5ab55c-b9cc-4f25-8196-65158458d0ae,-10411.88,debit,cash-withdrawal,AU00000,2024-04-02T09:28:53Z
transaction,6adb9ce6-5aa1-4c25-a407-72e4cc25c8bf,posted,Pharmacy Purchase,-1145.4,60582987-81ed-4d47-9c14-e04a3c0d1475,-11557.28,debit,cash-withdrawal,AU00000,2024-01-28T12:12:10Z
transaction,3484efe1-7352-4899-9ae4-9454e29315bf,posted,Mobile Phone Bill Payment,-4716.15,2e46fdd3-9d49-4300-9e63-b9c0f4f2a5ab,-16273.43,debit,bank-fee,AU00000,2023-07-03T04:47:59Z
transaction,8862dd4b-6f89-4582-b366-8ce8aad4c422,posted,TFR Acc14000 TO 12389,-4262.92,eb9da62b-c5fc-4c2c-a9ab-10c8f1ffd111,-20536.35,debit,payment,AU00000,2024-01-01T06:32:07Z
transaction,fcb1d429-a35a-4423-a092-2ed0e5fd5904,posted,CTRLINK CARERS Ref: 998R6789201610974V,-2885.83,3f4d8542-3891-4ba5-84e9-e07e57a651b0,-23422.18,debit,bank-fee,AU00000,2024-03-06T00:20:38Z
transaction,3f4b16ba-23ad-4335-b4e3-5a6c3321e28c,posted,Hair Salon Appointment,-4726.32,8527dc9c-73ba-4441-af12-a7d3542a74f8,10812.13,debit,cash-withdrawal,AU00000,2023-09-27T21:27:45Z
transaction,0fd51442-dd8c-4a3b-a560-74bf41e2ed0a,posted,Music Streaming Subscription,-1266.54,b591cbf2-5363-48e1-87e7-48e2de73d303,9545.59,debit,bank-fee,AU00000,2024-02-18T23:30:45Z
transaction,7ad8ae36-dc8f-462a-bb83-4f6ee52a5098,posted,Uber Ride,-2276.62,c117cbf2-3ac5-48ff-a6c0-9943160fb493,7268.97,debit,bank-fee,AU00000,2023-06-05T22:25:31Z
transaction,dc0b13d7-563e-4bd2-b8b7-866d386dab26,posted,Gasoline Purchase,-2668.73,ce493f87-c1ec-4346-9045-a55c43e83c74,4600.24,debit,cash-withdrawal,AU00000,2023-12-09T21:00:02Z
transaction,e6892b84-1e9e-4fa4-8c02-6927cb8d1d79,posted,Online Gaming Purchase,-1746.43,797eb350-d94b-4ed1-b9ff-7c9a958651ca,2853.81,debit,cash-withdrawal,AU00000,2023-12-10T22:17:49Z
transaction,929c84c3-3687-4ef8-bfd2-e44e8aac3abf,posted,AGL RETAIL ENERGY LTD (GAS),-3813.94,56cf71ce-33a5-405b-9c56-d57baa3bad08,-960.13,debit,cash-withdrawal,AU00000,2023-11-14T08:51:27Z
transaction,a369d50d-9cd7-41ec-8257-2027f51bc883,posted,Public Transport Fare,-2672.25,7bac85aa-b383-4e44-a8a1-5bbc5e23d363,-3632.38,debit,payment,AU00000,2023-08-21T09:27:07Z
transaction,f8fc0891-3376-440b-b066-a3df7d2c0226,posted,Electricity Bill Payment,-164.44,0bcb7e66-029e-4547-aea4-821ec0fab75f,-3796.82,debit,bank-fee,AU00000,2023-12-05T14:09:16Z
transaction,ea7ca47e-b671-4ead-89a1-66238effedf6,posted,Amazon Online Shopping,-894.52,6231c3db-b1c2-47c1-800c-632fc414ee70,-4691.34,debit,payment,AU00000,2023-11-20T06:49:00Z
transaction,57d7a0e2-5e79-44d1-a634-ce1181ad5189,posted,Travel Agency Booking,-4017.61,8eb74292-b8c5-4bd0-8434-a487f10ebd1d,-8708.95,debit,cash-withdrawal,AU00000,2024-04-16T06:31:30Z
transaction,0cbedef3-61f6-4022-a185-17927c367523,posted,Music Streaming Subscription,-4244.54,a7787550-060c-4b4f-b19d-19bfd39fcf5c,15310.85,debit,bank-fee,AU00000,2024-03-06T20:13:38Z
transaction,9ab41eb8-9fd5-45f1-b3aa-6114672ceb6c,posted,Gym Membership Fee,-4291.62,fbe34ca6-9228-454a-9691-6322636f5235,11019.23,debit,cash-withdrawal,AU00000,2023-05-25T11:50:48Z
transaction,896204a6-278d-49d7-91d0-b49ec8435b2c,posted,Gym Membership Fee,-2280.57,7fbf07f0-ffea-4b25-a534-cff742f474a2,8738.66,debit,cash-withdrawal,AU00000,2023-12-18T05:30:18Z
transaction,ead706b5-e6fc-44bb-b62c-3bdf36e1437d,posted,Uber Ride,-1517.9,9fa19704-cf70-4f8e-a47e-66c9ab0d9616,7220.76,debit,payment,AU00000,2024-04-30T22:51:15Z
transaction,a2f35b62-394c-40f7-9693-5e7edf2740d4,posted,Coffee Shop Purchase,-900.78,16d80eca-3a38-4ea8-8df1-2c408b37a208,6319.98,debit,bank-fee,AU00000,2023-10-08T12:19:05Z
transaction,871cd21b-cc0e-4266-8054-2eab23b6d7f5,posted,Restaurant Dinner,-4637.47,0208fe28-cdc7-4e46-86f7-3bf3b5b9e64a,1682.51,debit,payment,AU00000,2023-07-03T03:30:35Z
transaction,a96f28f4-5605-464c-89c6-9de682360b47,posted,Mobile Phone Bill Payment,-612.15,63dfb09c-f15d-4e71-a4fa-f34542155f66,1070.36,debit,bank-fee,AU00000,2023-09-05T15:23:50Z
transaction,6ccc4496-b883-4b48-882e-bf039c4ab6d1,posted,Mobile Phone Bill Payment,-3504.1,dbf0dc94-eb8a-484d-a4de-e02802e2412f,-2433.74,debit,cash-withdrawal,AU00000,2024-04-14T03:38:21Z
transaction,e478f4d9-437c-4f07-8eeb-5f9a2e65b931,posted,Mobile Phone Bill Payment,-325.85,87739050-e885-497e-a2b0-693d200a1f30,-2759.59,debit,bank-fee,AU00000,2024-03-14T00:16:06Z
transaction,c80f6bb3-4366-4bea-b7c8-1da9b743db15,posted,Non Hooli ATM Withdrawal Fee,-3776.45,3101f209-8721-4077-a619-f4862ee00081,-6536.04,debit,payment,AU00000,2023-08-31T16:21:52Z
transaction,f676aa71-4416-494e-9610-c59d4c2d82bd,posted,Gym Membership Fee,-2585.36,6a400061-4375-40c3-926a-6f80ff86164d,6471.42,debit,payment,AU00000,2024-03-12T11:43:57Z
transaction,2b874ac1-c3a5-44d2-909a-2ffbe721da6b,posted,Online Gaming Purchase,-1091.69,42f911b8-f936-46c5-94c5-060615790402,5379.73,debit,cash-withdrawal,AU00000,2023-07-11T07:12:09Z
transaction,98002a20-8869-49e0-a36e-fd25b26fd0c5,posted,Uber Ride,-1886.16,f33c1bcf-7361-4360-b6b9-97551bb5c5c0,3493.57,debit,cash-withdrawal,AU00000,2024-03-27T12:36:53Z
transaction,3d8e751f-70dc-4d65-a21e-1945157105b4,posted,Non Hooli ATM Withdrawal Fee,-1932.79,1aa087c1-e34b-4370-9371-c13484cef517,1560.78,debit,payment,AU00000,2023-10-14T07:25:25Z
transaction,a84c31d9-253d-4ed3-9d6e-9f8e78dbac3a,posted,Transfer Platnm Homeloan 346454,-3873.66,49b01883-e1f4-4c67-9069-1c8aefd03e3d,-2312.88,debit,cash-withdrawal,AU00000,2023-12-11T21:07:52Z
transaction,2890d6c0-e153-4bcc-9a9e-0cf9a9c8770c,posted,Hair Salon Appointment,-4723.09,9ca695c5-0acb-4e9c-a849-113154bb21b0,-7035.97,debit,cash-withdrawal,AU00000,2023-06-03T06:08:47Z
transaction,313e394e-412d-45bb-9560-b00cd2f63eb4,posted,Manly Maths Tutor Wages,-3544.8,9e8199db-af71-4f50-9d26-b1930464218b,-10580.77,debit,payment,AU00000,2023-11-25T23:20:06Z
transaction,758f9c51-6722-4fb0-8f4c-2a51cd70c0ca,posted,Amazon Online Shopping,-1389.88,93b30b7a-2d99-4f4b-9761-47c5b07c3019,-11970.65,debit,bank-fee,AU00000,2023-08-11T07:25:57Z
transaction,c962a5e1-a7c7-4161-a3ca-753fb95dfadf,posted,Movie Ticket Purchase,-4099.69,c6240e3b-1f3f-47da-9fdc-d5abc6e6f4c1,-16070.34,debit,bank-fee,AU00000,2023-10-11T20:42:37Z
transaction,8860cd08-5d32-4abe-b329-991478aee899,posted,Wdl ATM WESTPAC IGA BALGOWLAH BALGOWL AU,-3149.6,cad86f82-0f9d-4dc5-b779-db0ad93b8cc4,-19219.94,debit,cash-withdrawal,AU00000,2024-02-20T22:23:27Z
transaction,fd53eb6f-7080-430e-bb80-ab561edec3e0,posted,Music Streaming Subscription,-2119.27,0f16aa95-b6eb-4a1a-a1f4-7d786e89441e,15476.62,debit,cash-withdrawal,AU00000,2023-05-18T05:36:45Z
transaction,d6927f49-5add-4d9a-a74b-e8559867b903,posted,Bookstore Purchase,-1892.85,ca36faf8-f9d9-4163-8a83-536e2228151e,13583.77,debit,payment,AU00000,2024-02-28T00:56:23Z
transaction,a4d61190-a035-453e-a7bc-20c850a814e6,posted,Payroll WFRMS 15439393,10612.98,44c785e4-7078-4012-bd37-1602215b8025,24196.75,credit,transfer,AU00000,2023-05-23T03:03:48Z
transaction,3621ba8a-03d8-4bd8-8860-02e7a6a27917,posted,Amazon Online Shopping,-3006.49,e33e31e1-4f3f-4bd0-afea-a9e8233ff858,21190.26,debit,payment,AU00000,2024-02-01T00:15:56Z
transaction,d65d1f83-7423-446e-b3d5-07cc9d7e70fe,posted,Transfer Platnm Homeloan 346454,-1432.32,fe05c552-43a0-4f1b-a666-50f68970ce9a,19757.94,debit,payment,AU00000,2024-04-26T22:21:58Z
transaction,51a0367d-4c95-4fca-9ad3-e8813480e6e6,posted,Travel Agency Booking,-4352.65,4f0dceba-b688-488a-8f4a-15f9ee724523,15405.29,debit,payment,AU00000,2023-07-27T10:59:40Z
transaction,001a9680-5754-4566-bcd8-d86e96a4cdc0,posted,Netflix Subscription,-4820.47,49f3e5a8-5a15-4233-82be-fc1481724629,10584.82,debit,payment,AU00000,2023-07-30T18:21:38Z
transaction,0e441d2f-7dab-4ddc-b2ac-5cda45b83bd7,posted,Uber Ride,-163.55,610b6a24-976a-4258-be48-67f46610247c,10421.27,debit,bank-fee,AU00000,2023-08-20T10:18:15Z
transaction,8ca5cf35-0947-4b78-9b8c-5f0e7532b6a6,posted,AGL RETAIL ENERGY LTD (GAS),-721.36,eb2e884f-2d7a-4890-b17c-4e08ba58f479,9699.91,debit,bank-fee,AU00000,2023-08-12T14:15:21Z
transaction,bf740bb5-4cfe-4645-9acd-014977a23314,posted,Restaurant Dinner,-4729.72,3c79f380-9ab4-4ed6-9627-c38137f6d6bf,4970.19,debit,payment,AU00000,2024-03-31T03:45:34Z
transaction,f23c32af-5034-4c7f-9a54-2b702762f730,posted,Restaurant Dinner,-145.27,1a545c60-1cd7-4f2e-95a3-ffe8b58f6551,11446.77,debit,payment,AU00000,2024-02-04T18:25:30Z
transaction,0bde0eca-eb8f-442f-a0ee-b427abbe6613,posted,Gasoline Purchase,-3100.43,68ae4fa4-06d7-4e04-b8c1-41a231bc87a4,8346.34,debit,payment,AU00000,2023-12-17T15:19:29Z
transaction,d01851ea-85b4-4586-b3c2-4fd83be507f6,posted,Manly Maths Tutor Wages,-263.04,c3ba6a0c-e6e0-46e6-9cd3-574eb33f2c50,8083.3,debit,cash-withdrawal,AU00000,2023-11-16T03:44:38Z
transaction,93d56d65-067a-46b2-9a19-f97ebd763b24,posted,Movie Ticket Purchase,-3013.01,1d0cd0f4-59a5-46b1-8731-c9440df80a0b,5070.29,debit,cash-withdrawal,AU00000,2023-06-12T13:38:40Z
transaction,54a361e4-3814-4d42-9561-d32e8985ff8e,posted,Hair Salon Appointment,-1751.47,cf4d6975-a521-4cea-bc87-c55ed855bf8e,3318.82,debit,bank-fee,AU00000,2023-06-02T13:18:11Z
transaction,a076a96c-a1e4-43dd-ad59-5d9d23cccbd3,posted,Movie Ticket Purchase,-12.29,38e821c0-7a74-4046-9fe4-08d650a67515,3306.53,debit,cash-withdrawal,AU00000,2023-11-11T02:09:19Z
transaction,e6d9f14d-b0bd-497b-ab68-fe34acdc06dc,posted,TRANSFER TO JOANNA SMITH CAMPING,-1693.24,a890ad4d-1d02-4cc2-82b9-18746c74916d,1613.29,debit,payment,AU00000,2024-03-16T18:04:15Z
transaction,de87fda6-85be-4411-b05e-da9d17fa1300,posted,Clothing Store Purchase,-3718.94,e3735521-9edb-4643-846d-e7a77cac23e7,-2105.65,debit,cash-withdrawal,AU00000,2023-10-03T07:25:04Z
transaction,1f05d21e-7d7c-4676-88ea-806a0475d37a,posted,Non Hooli ATM Withdrawal Fee,-198.27,643bb5b8-98b5-48a8-a4ae-927b9a26254c,-2303.92,debit,cash-withdrawal,AU00000,2024-03-26T02:49:01Z
transaction,bbb72b17-8cf8-4997-99cd-98a8195350fb,posted,TFR Acc14000 TO 12389,-98.84,44a2fd4d-45b7-479a-b2f8-6df2e19ea0f7,-2402.76,debit,payment,AU00000,2023-10-29T16:35:49Z
transaction,17a218fb-c63b-4e8b-99b2-c398ebeb3542,posted,Home Improvement Store Purchase,-2928.63,e34df12c-a0ec-4834-a19a-ec721848a3d4,12863.74,debit,cash-withdrawal,AU00000,2024-01-28T17:32:48Z
transaction,3e3d1c42-8915-4c58-bcde-4f18b9a81b7f,posted,Hair Salon Appointment,-4882.65,b5ebe6e7-bae3-47a8-95d6-80544e89e795,7981.09,debit,payment,AU00000,2023-12-15T07:30:13Z
transaction,8c3e8b4d-1478-4e30-b0f9-c4825d1729b1,posted,Restaurant Dinner,-2342.05,11375dbb-d77e-408d-81f4-d614650ac7e4,5639.04,debit,cash-withdrawal,AU00000,2023-08-16T05:37:15Z
transaction,da015067-a046-4c55-9092-1997ea4f5982,posted,Manly Maths Tutor Wages,-2471.8,5d140f11-2a74-423b-9beb-d31345bfe9a1,3167.24,debit,cash-withdrawal,AU00000,2023-09-09T08:57:25Z
transaction,46803d4c-2128-430b-93e6-5f1dd099202c,posted,Amazon Online Shopping,-335.3,903b9a8b-f3c0-4ce7-be60-0afa502e1e07,2831.94,debit,payment,AU00000,2023-08-31T17:01:17Z
transaction,cf3708a7-0ad0-4ab9-b83c-da9c64c9c265,posted,Home Improvement Store Purchase,-3492.29,35808174-f132-46d6-b6d4-4c36f630d6e6,-660.35,debit,payment,AU00000,2023-08-21T09:03:42Z
transaction,eeda05b5-6276-4a48-8b6e-38c667f4f414,posted,CTRLINK CARERS Ref: 998R6789201610974V,-4126.17,af33f205-17c5-4b72-a8df-b5dba53ca819,-4786.52,debit,cash-withdrawal,AU00000,2023-07-26T01:35:37Z
transaction,d23583e8-2606-4391-8ab4-e9f96896cd82,posted,Travel Agency Booking,-262.24,c699aaef-31f8-4b76-9ec3-c8ba828bfeb4,-5048.76,debit,cash-withdrawal,AU00000,2023-09-01T19:24:29Z
transaction,b5c9e509-9235-4657-a31b-2af645fe378f,posted,Restaurant Dinner,-3438.19,6280ef35-86b2-49cf-86c3-89c71611b332,-8486.95,debit,payment,AU00000,2024-04-08T22:11:38Z
transaction,41b263b0-d2cc-4c87-ada1-6dbbbda27422,posted,Mobile Phone Bill Payment,-1825.54,83864e21-9e2b-4684-a19e-4745d2caa437,-10312.49,debit,bank-fee,AU00000,2023-07-25T09:43:40Z
transaction,c0469fb4-9de8-470e-916b-c026dd145614,posted,Restaurant Dinner,-3879.94,23b40539-87f5-467b-aa34-54eacd61f787,7215.85,debit,cash-withdrawal,AU00000,2023-11-18T09:51:09Z
transaction,79d3a458-9bb1-4334-8e7c-895e43c78ac2,posted,Movie Ticket Purchase,-3288.24,0f75bbbe-6926-4e47-831f-9418993c01c0,3927.61,debit,cash-withdrawal,AU00000,2023-06-28T18:48:33Z
transaction,db45e159-9ae7-46b8-97f9-23e213ff828b,posted,TFR Acc14000 TO 12389,-2551.73,84e8d52a-51a5-4754-a788-89b3ba3c14bb,1375.88,debit,payment,AU00000,2023-11-21T17:54:53Z
transaction,7e257619-aa89-429c-9d4c-a68c32a79c26,posted,AGL RETAIL ENERGY LTD (GAS),-3718.82,2bcb1949-21ff-4d7e-bb44-80ef8a56d7ec,-2342.94,debit,bank-fee,AU00000,2023-08-24T06:30:18Z
transaction,8b4de870-46de-4718-9d83-f982f599a2a7,posted,Hair Salon Appointment,-4449.8,ec5cde22-43bf-41e4-8c49-6a8d542124de,-6792.74,debit,bank-fee,AU00000,2023-09-30T13:25:05Z
transaction,9d412d87-40cc-462c-b80d-b89f8bdedb5c,posted,Hair Salon Appointment,-3926.69,04925856-3b68-4d9e-8bc1-735fd6d4b9a5,-10719.43,debit,cash-withdrawal,AU00000,2023-12-05T03:45:02Z
transaction,eb9f1303-0733-433c-9849-e26d15e0f322,posted,TRANSFER TO JOANNA SMITH CAMPING,-3610.71,75a531ad-49bf-4df5-a359-9687add9091a,-14330.14,debit,cash-withdrawal,AU00000,2023-10-13T20:15:04Z
transaction,3c647961-1ca7-4d92-897a-053f9d7745c7,posted,Non Hooli ATM Withdrawal Fee,-3214.66,d9e675a9-0ea1-47ca-b841-87d9fff71040,-17544.8,debit,payment,AU00000,2023-05-27T20:37:06Z
transaction,748d8641-df8f-4ee3-a54a-73996b4a95db,posted,Non Hooli ATM Withdrawal Fee,-2028.26,c1533cbc-2efd-4c8e-adf3-32c78d3d24b9,-19573.06,debit,cash-withdrawal,AU00000,2023-09-11T06:07:18Z
transaction,4c25320e-54d7-482e-8949-8a5e5260a5fd,posted,Clothing Store Purchase,-4632.87,b705aaca-5be6-4b24-afbb-4af3e55505c8,-24205.93,debit,bank-fee,AU00000,2023-09-06T20:06:37Z
transaction,105116d3-aad4-41a8-85e1-253cb6063fee,posted,Manly Maths Tutor Wages,-3432.78,b970c8c2-9c41-4e35-90bb-360dd36bf46e,12865.81,debit,payment,AU00000,2024-02-19T02:21:01Z
transaction,e69728d6-6591-4a9c-b073-2ba0c10341ba,posted,Gasoline Purchase,-4258.89,a922162f-7a23-4bda-83fb-89ae06733b3a,8606.92,debit,payment,AU00000,2024-01-28T22:27:45Z
transaction,a4b2ce59-c4f8-4165-9a53-ca19aa65432e,posted,Netflix Subscription,-3081.95,a297f225-42b9-4337-950d-978163006a09,5524.97,debit,payment,AU00000,2024-02-21T04:26:32Z
transaction,e07dd9d9-3757-4c05-bc3c-3c30b576b811,posted,Transfer Platnm Homeloan 346454,-4514.05,7b20cb68-5a77-4f15-898b-2b01b490c558,1010.92,debit,bank-fee,AU00000,2024-02-11T09:58:25Z
transaction,946f8a5a-e7de-4e34-a620-c9d8debb3b00,posted,Mobile Phone Bill Payment,-4949.72,40b37d29-7c6c-46c1-87fa-3dd52e49e5c2,-3938.8,debit,cash-withdrawal,AU00000,2023-09-05T12:38:34Z
transaction,a5bfa73d-7d81-4206-bd6b-74f071d6ac23,posted,Gasoline Purchase,-45.76,c91841c4-7b1b-4645-9ca5-4694b85b403d,-3984.56,debit,bank-fee,AU00000,2024-05-04T08:16:31Z
transaction,7cae05bf-e142-4ad9-9aa9-9ee431597f2f,posted,Online Gaming Purchase,-3842.52,ea7bfd75-f203-4e23-8f11-d2455383caa8,-7827.08,debit,cash-withdrawal,AU00000,2023-08-07T09:39:20Z
transaction,7afbf1ee-3cc7-4124-b557-37ecb1dc6ebb,posted,Travel Agency Booking,-2504.56,84cc4348-6865-42fc-b525-e2970f2c9220,-10331.64,debit,bank-fee,AU00000,2024-03-10T03:45:51Z
transaction,ceb03b97-6d86-4fef-951d-da86655331b1,posted,Amazon Online Shopping,-766.96,6d5e6298-7c85-40d6-97f8-5f9b0829f96f,-11098.6,debit,bank-fee,AU00000,2024-02-19T10:43:50Z
transaction,074dd148-67a9-4118-b121-a7891eebf72e,posted,Transfer Platnm Homeloan 346454,-1985.23,cb9738fe-45b9-4717-a230-996d282a5929,-13083.83,debit,bank-fee,AU00000,2024-05-01T15:01:56Z
transaction,fb7fd3c3-f209-44c2-bb0a-4db7771f82e0,posted,Mobile Phone Bill Payment,-3749.6,a709556a-9b26-49c6-816d-ac4dccd421bc,11744.03,debit,bank-fee,AU00000,2023-06-11T21:58:20Z
transaction,521fa3aa-88e6-4287-9161-eac77c0e2d4c,posted,Hair Salon Appointment,-3602.5,5ee7eaea-8acd-48eb-8504-444fa54e7bf0,8141.53,debit,cash-withdrawal,AU00000,2023-09-28T00:02:10Z
transaction,8cafde68-2788-4216-8acc-81ffcb0b3b55,posted,TRANSFER TO JOANNA SMITH CAMPING,-730.98,284500c8-6c78-4c4a-8483-73f172139e1f,7410.55,debit,cash-withdrawal,AU00000,2023-05-22T04:50:27Z
transaction,b4128181-8512-4413-b287-fee1b1146a7f,posted,Gym Membership Fee,-1192.12,71967a0d-f8e9-4a8f-828f-aabeff794b9a,6218.43,debit,payment,AU00000,2023-06-27T03:19:33Z
transaction,6a7c15ca-b18a-4b31-a7e3-5979ed0984a6,posted,TRANSFER TO JOANNA SMITH CAMPING,-1235.09,139e6ff7-d9ef-4102-80f3-156bd989b190,4983.34,debit,cash-withdrawal,AU00000,2024-04-07T23:51:00Z
transaction,c4112e3f-73ab-422d-8388-2f41b9755a97,posted,CTRLINK CARERS Ref: 998R6789201610974V,-2163.51,8e332351-1da9-4bc0-a66e-c450255eab65,2819.83,debit,cash-withdrawal,AU00000,2023-07-21T23:10:28Z
transaction,7400d474-de80-49a0-9e0d-790235504e02,posted,Coffee Shop Purchase,-1512.49,d076298b-5d68-4d59-a48c-e70d39c4d250,1307.34,debit,bank-fee,AU00000,2024-01-26T20:28:44Z
transaction,d283ebf9-7154-4384-a400-0b2e694de389,posted,Uber Ride,-2159.79,5f48c715-2d5b-4d8f-9356-aa031a5a1385,-852.45,debit,bank-fee,AU00000,2023-12-01T15:58:53Z
transaction,aadba1f5-a8fc-4d16-b0cc-4ff209db903d,posted,Electricity Bill Payment,-1007.89,165ffffa-131c-4417-83a0-85bc462280cb,-1860.34,debit,cash-withdrawal,AU00000,2024-03-17T08:04:07Z
transaction,0bd53901-05e8-404f-a723-02cdea32a3ad,posted,Travel Agency Booking,-4204.47,e75a91c0-8434-4d57-95a8-d55abdea4063,-6064.81,debit,payment,AU00000,2024-04-26T20:55:20Z
transaction,ded6ceff-f28d-4572-9312-3ba1571e7a87,posted,Gasoline Purchase,-3147.63,bce519fc-bf00-4f0d-9946-e8eefd60236a,16520.89,debit,cash-withdrawal,AU00000,2024-04-09T03:10:25Z
transaction,d8b211d0-d833-4d5b-bc9a-d9ab5b122ac1,posted,Online Gaming Purchase,-1578.85,dbb1b22a-e3e7-4840-9d1b-2123c9a8e1fa,14942.04,debit,cash-withdrawal,AU00000,2023-10-30T09:14:25Z
transaction,564ab166-0420-4e55-becd-f2bf4a40b43b,posted,Hair Salon Appointment,-2263.72,06e2e760-91ea-4a4e-920f-5ccace9c5884,12678.32,debit,cash-withdrawal,AU00000,2023-11-22T17:40:04Z
transaction,fa622cf1-055c-4972-9996-780140918e41,posted,Electricity Bill Payment,-3534.21,707ead00-090a-4077-b760-45a1d4981015,9144.11,debit,cash-withdrawal,AU00000,2023-09-26T22:43:57Z
transaction,e570ca1a-3bf1-48e9-9670-9b2722d596a1,posted,Netflix Subscription,-4376.38,d5043f3c-6e78-452c-89fe-38f8579b940c,4767.73,debit,payment,AU00000,2024-05-10T10:08:32Z
transaction,fd2f9ea9-2bcc-4f7c-acd3-7c438ce7479f,posted,Coffee Shop Purchase,-2326.3,9ae3907b-7e52-4ba9-b872-7af2feae383b,2441.43,debit,payment,AU00000,2023-08-10T14:02:37Z
transaction,d7932842-e7ab-49d1-9ec4-62733413204b,posted,Online Gaming Purchase,-3787.29,e5a2bb64-d59e-49a7-8849-3c22d867ed25,-1345.86,debit,bank-fee,AU00000,2023-09-12T22:48:53Z
transaction,21108edc-0f82-4c60-b6b0-be2ae2283dc9,posted,TRANSFER TO JOANNA SMITH CAMPING,-3229.81,267dd28a-900e-4473-b29b-3888aa562376,-4575.67,debit,cash-withdrawal,AU00000,2024-04-27T06:36:54Z
transaction,a19350cf-27ae-490f-8a3a-96882f21b495,posted,AGL RETAIL ENERGY LTD (GAS),-129.59,6fe2990f-f4dc-444f-81d7-c3d24b1e3c06,-4705.26,debit,cash-withdrawal,AU00000,2023-12-23T02:49:53Z
transaction,e5e46aef-ea56-452d-b1a9-8d07169bd177,posted,Manly Maths Tutor Wages,-152.54,ece111d9-397a-4613-aac4-90456a7afd82,-4857.8,debit,payment,AU00000,2023-10-11T13:51:24Z
transaction,20cff288-d8cc-4b0e-966b-c615635474fd,posted,Non Hooli ATM Withdrawal Fee,-3873.84,8f3ed673-32da-499d-bdc2-73cca9d2d17c,10730.26,debit,bank-fee,AU00000,2023-12-27T14:53:01Z
transaction,64f1a654-8c87-4e8a-b63c-c82be71f900e,posted,CTRLINK CARERS Ref: 998R6789201610974V,-1129.14,5b47427a-5ed0-4b99-b3a0-0d947c41bca3,9601.12,debit,cash-withdrawal,AU00000,2023-11-20T07:27:30Z
transaction,ff11963d-9c63-4591-b36e-4590abd970e9,posted,Home Improvement Store Purchase,-2843.76,1bcc6c60-f257-40ea-b7e2-98ef39ed6f6b,6757.36,debit,bank-fee,AU00000,2023-08-02T03:26:59Z
transaction,e5c92673-c1a7-405e-b7ff-19ee21aaeae4,posted,Payroll WFRMS 15439393,10694.61,831f1cd8-f001-4531-94c1-5045e6fdeb99,17451.97,credit,transfer,AU00000,2023-09-08T22:35:56Z
transaction,436c0d4f-f172-4526-ba32-6f081802df79,posted,Public Transport Fare,-1573.29,0163c871-6df1-400f-8589-638db832d579,15878.68,debit,payment,AU00000,2023-05-15T08:31:25Z
transaction,a037c6ed-78d8-4318-9e97-ae0dd8e1f6ec,posted,Gasoline Purchase,-2800.67,64e44118-9acd-47d0-b9b8-49a3dc1982e4,13078.01,debit,payment,AU00000,2024-01-26T04:42:11Z
transaction,33628a52-05cb-49a3-a54e-5813f00a1dab,posted,TFR Acc14000 TO 12389,-33.14,ff2cec84-96cc-4d85-9c53-2996a94fe4f4,13044.87,debit,cash-withdrawal,AU00000,2024-04-20T10:37:33Z
transaction,d9c49302-19de-4948-9e61-dfbadf454901,posted,Travel Agency Booking,-3167.32,93d674f0-e18c-4ff2-8b0a-424d330b9062,9877.55,debit,cash-withdrawal,AU00000,2024-01-24T03:39:10Z
transaction,6db50a40-08d2-4316-b043-8551832058b3,posted,Online Gaming Purchase,-3763.62,242e33d8-b713-4fb5-a16c-75417510fedb,6113.93,debit,bank-fee,AU00000,2023-11-18T16:13:31Z
transaction,6ccd8ea5-48cb-41a8-94be-92a0300002e6,posted,Mobile Phone Bill Payment,-343.85,41abad46-8c4b-48ae-bab1-51ae1b4230ba,5770.08,debit,cash-withdrawal,AU00000,2024-04-07T12:46:44Z
transaction,64da50e5-a0ac-4871-bdf9-5f050d3697a4,posted,Gasoline Purchase,-1143.26,cc897aab-4c11-419f-bfbd-3efd04132fcc,18153.09,debit,cash-withdrawal,AU00000,2024-02-03T22:13:01Z
transaction,8fdd7c9d-b2dd-4347-a81b-83eb9449023c,posted,Car Maintenance Expense,-1705.74,c1844e1c-d41a-4b90-b0a1-360c0d1ff4c9,16447.35,debit,bank-fee,AU00000,2023-12-24T07:44:58Z
transaction,a38ac8c1-97e2-4545-b996-e9cd13316da9,posted,Home Improvement Store Purchase,-2914.88,39718ae8-b173-4b60-aad5-402faeda2cfb,13532.47,debit,bank-fee,AU00000,2024-03-11T12:00:45Z
transaction,6b4052a5-9193-445a-9ef2-609aeee69da5,posted,Pharmacy Purchase,-1779.37,c3b9a3df-1e9b-4f5a-958e-89d23bbe8927,11753.1,debit,cash-withdrawal,AU00000,2023-11-12T03:53:43Z
transaction,5ccf09a0-7fed-49ff-a551-42a68e26ea92,posted,AGL RETAIL ENERGY LTD (GAS),-1873.22,f543a439-62e5-4277-a28c-a26fa9800f3b,9879.88,debit,payment,AU00000,2023-12-05T16:29:27Z
transaction,57dfb68b-ab17-4303-ba82-68e50c251b21,posted,Gym Membership Fee,-783.85,89223eb0-91ea-4065-8dd4-d1434d9da5d1,9096.03,debit,payment,AU00000,2024-02-18T16:15:12Z
transaction,9f3c1868-23ce-4fdc-825a-213ed262eaba,posted,Electricity Bill Payment,-3619.21,c85b57d3-c627-4ed2-9514-3010d4d19dcc,5476.82,debit,cash-withdrawal,AU00000,2023-08-16T19:19:47Z
transaction,049ee605-bede-44d9-a4db-d3fae94f8975,posted,Wdl ATM WESTPAC IGA BALGOWLAH BALGOWL AU,-2434.98,f4780586-4853-4282-a741-aa35456777fd,3041.84,debit,cash-withdrawal,AU00000,2023-06-08T12:40:15Z
transaction,a6f7b553-a0c8-4118-abc8-47d88584e520,posted,Travel Agency Booking,-1131.51,2677d2a4-eb74-4b12-b953-93c14d7937ef,1910.33,debit,bank-fee,AU00000,2023-08-17T02:11:14Z
transaction,bca8ae83-3c4c-4343-98d9-e9d8a8b2e6bf,posted,Bookstore Purchase,-4896.92,76ee9cac-93eb-4d85-a445-8d558f8c23c0,-2986.59,debit,payment,AU00000,2023-10-28T18:53:12Z
transaction,6fea441b-41e2-4ae7-9fec-00f549e5c4b4,posted,Online Gaming Purchase,-2327.37,aec795e5-e7f0-4dbe-b1cc-49d464245e9c,15300.22,debit,payment,AU00000,2023-11-04T06:47:25Z
transaction,0b6f6904-d696-4b0a-a3e0-620308c9d5e0,posted,Netflix Subscription,-1447.39,cc2151f5-83b3-4dfd-b60e-a1a79daee7db,13852.83,debit,bank-fee,AU00000,2024-01-13T10:22:47Z
transaction,49b53995-de2b-4833-abc6-e33ab103ce3b,posted,Public Transport Fare,-2142.76,4d5aaef2-6a8d-4583-86eb-0a05d54709d3,11710.07,debit,bank-fee,AU00000,2024-01-26T23:19:11Z
transaction,ab101573-640a-4f9f-9ee8-b1f2b41a9e19,posted,Uber Ride,-4875.55,19538808-6a72-49f2-8599-a832d0e25943,6834.52,debit,cash-withdrawal,AU00000,2024-04-26T17:01:55Z
transaction,c37c887c-0e0f-4e98-9adb-b1656e601592,posted,Online Gaming Purchase,-4670.07,a408ced3-f287-416a-bb8a-eaf4f8a62d3b,2164.45,debit,cash-withdrawal,AU00000,2024-02-09T21:19:52Z
transaction,137fee77-aeb6-456a-9699-c4b4e8e8bad5,posted,Public Transport Fare,-3453.82,d647ef23-4a83-48ec-9ade-8741d9109990,-1289.37,debit,cash-withdrawal,AU00000,2024-03-28T05:45:41Z
transaction,447adf5d-07b0-4c30-aaf0-668e01dd4bfe,posted,Music Streaming Subscription,-100.58,1479ec68-e3d8-4e98-9903-6a98bd8dc6a6,-1389.95,debit,cash-withdrawal,AU00000,2024-02-20T23:42:41Z
transaction,43e85443-1de0-475e-ab98-1355b7200665,posted,AGL RETAIL ENERGY LTD (GAS),-4753.46,e8c2cb51-a612-4357-8173-9c4b466ba8a8,-6143.41,debit,bank-fee,AU00000,2023-06-06T07:45:58Z
transaction,2d98a2a9-2e29-406d-b029-be64b4cf920d,posted,Wdl ATM WESTPAC IGA BALGOWLAH BALGOWL AU,-900.91,41cfb48f-f015-4548-917b-6aed20c06ac8,-7044.32,debit,payment,AU00000,2023-06-13T04:24:10Z
transaction,04cad546-bb71-41db-9ba6-edae71208a7b,posted,Gym Membership Fee,-1046.86,cbd002e4-58ea-420c-8b79-fe022f860b1a,-8091.18,debit,cash-withdrawal,AU00000,2024-03-02T01:57:22Z
transaction,8a67668f-f85a-4f51-aef9-feba1613a11c,posted,Mobile Phone Bill Payment,-3938.63,7de4020d-f8c0-46f5-b709-f967b5eb311b,6794.81,debit,cash-withdrawal,AU00000,2023-08-10T17:29:51Z
transaction,0c656c3b-83ed-4e7a-bd1d-ccb9d347f9ab,posted,Car Maintenance Expense,-4644.5,21538826-4ef7-4fac-bf9b-ff53fd12fee1,2150.31,debit,payment,AU00000,2023-11-15T08:43:09Z
transaction,a157f1db-60aa-4c1d-a989-9486b63d5616,posted,Wdl ATM WESTPAC IGA BALGOWLAH BALGOWL AU,-4277.92,9928f6b7-ff5a-4a3e-b18b-149504a9d185,-2127.61,debit,payment,AU00000,2024-02-25T18:44:30Z
transaction,0ae9f791-33fe-4f07-9112-fc16e438fa61,posted,TFR Acc14000 TO 12389,-1517.07,d1100c5e-f6a4-42c5-a94a-3d49d3a35dc6,-3644.68,debit,bank-fee,AU00000,2023-07-27T23:10:00Z
transaction,4a1f5add-c415-4adb-80b5-b42811538bb5,posted,Transfer Platnm Homeloan 346454,-4820.8,c3df60cc-6e93-495b-a95f-9a9bf654cb6a,-8465.48,debit,bank-fee,AU00000,2023-05-27T15:04:21Z
transaction,1f0d0302-e820-423d-b5dc-459bc7956bbd,posted,Manly Maths Tutor Wages,-1599.32,5193d3b6-398f-4f6d-b0ea-cb028b125a75,-10064.8,debit,payment,AU00000,2023-10-11T15:01:16Z
transaction,b85a82d8-37b2-4bd4-bf77-18ef74b63ab9,posted,CTRLINK CARERS Ref: 998R6789201610974V,-1053.04,9bbd4afb-39d1-4606-a398-8a5b99badfbd,-11117.84,debit,cash-withdrawal,AU00000,2023-05-17T20:19:26Z
transaction,b90469cf-edf7-4981-af87-efb414825625,posted,Coffee Shop Purchase,-2248.58,edc7b6be-74d2-455e-86c5-e18f52855dfa,-13366.42,debit,bank-fee,AU00000,2023-06-29T22:13:48Z
transaction,74d108cd-1177-4a3c-ad44-964dad946dba,posted,Coffee Shop Purchase,-4125.1,83aec5cb-d9ad-4942-8eae-331598001749,-17491.52,debit,payment,AU00000,2023-06-16T05:59:39Z
transaction,2dedfc4d-bba7-4e6a-8b82-43661e7f98df,posted,Car Maintenance Expense,-2689.58,9f81ecb3-8ac9-4697-aa6e-4f4643525466,-20181.1,debit,cash-withdrawal,AU00000,2023-05-20T01:27:12Z
transaction,9bee2a02-d8f0-476f-baa1-7c3ffef54043,posted,Music Streaming Subscription,-301.53,d098ebd8-f529-4724-8e1f-d3b390303e3b,18656.89,debit,bank-fee,AU00000,2023-08-11T11:31:28Z
transaction,7107bfb8-f494-4833-bdcd-47701d827527,posted,Transfer Platnm Homeloan 346454,-1753.71,84494c54-091a-4405-8d5c-4562480f1453,16903.18,debit,payment,AU00000,2023-12-06T13:27:07Z
transaction,247d0d85-70d7-4a29-9680-507943f51f91,posted,CTRLINK CARERS Ref: 998R6789201610974V,-1585.86,1a354833-b0b9-4bdf-92dc-9c73a93e7b13,15317.32,debit,cash-withdrawal,AU00000,2023-06-02T07:35:13Z
transaction,e752ee14-a64e-403f-8d26-6cd66081fb55,posted,Non Hooli ATM Withdrawal Fee,-614.92,a6dd417f-1d99-4d0b-9675-5bce3b511030,14702.4,debit,payment,AU00000,2023-11-11T10:40:19Z
transaction,2ec3a7ee-8c99-4c7d-be1e-e7e92c8c6371,posted,Manly Maths Tutor Wages,-2032.27,ff84b79f-2a2f-4aa1-9802-a9182df9ad29,12670.13,debit,cash-withdrawal,AU00000,2023-09-21T21:25:05Z
transaction,08a49d5d-f3e0-49ee-8f3d-4ff41641099e,posted,Payroll WFRMS 15439393,10924.86,20bb3afa-a228-4b0c-bd2e-12e1b3eb973c,23594.99,credit,transfer,AU00000,2023-10-31T12:32:58Z
transaction,79b11bdf-c8a0-4a92-98b4-9f6d0a2f5956,posted,Travel Agency Booking,-4635.21,7e4917bb-7494-4dad-b688-ac017364073a,18959.78,debit,payment,AU00000,2024-03-27T00:29:47Z
transaction,b8c14090-97da-4b37-a506-792b8941790a,posted,CTRLINK CARERS Ref: 998R6789201610974V,-669.96,eebe9726-c93f-4d2b-8fc5-126bd36bd830,18289.82,debit,payment,AU00000,2024-03-09T07:35:34Z
transaction,04f90c74-90f8-4f5d-8b95-ce412653ac49,posted,Payroll WFRMS 15439393,11333.59,f26b688a-ac48-41d8-8842-a4e4149c7d99,29623.41,credit,transfer,AU00000,2023-07-23T06:24:08Z
transaction,d1fd4b10-3d46-403b-9b5c-80d43a297d1b,posted,Car Maintenance Expense,-2361.82,f83809e1-1dca-4fee-8a9e-61cb6ea0cf01,27261.59,debit,payment,AU00000,2023-05-13T02:27:27Z
transaction,1febbe4d-2995-4b80-adda-9bb2b8eca02d,posted,Restaurant Dinner,-809.79,279c9d93-1f10-4f81-a782-441861a8aadf,7031.52,debit,bank-fee,AU00000,2024-03-06T16:22:39Z
transaction,171b950a-93b4-4bf4-b2bd-ee9e49241fe6,posted,Coffee Shop Purchase,-1683.0,560ca61c-a614-4f97-9c8d-ede02adbc4ed,5348.52,debit,cash-withdrawal,AU00000,2024-03-22T19:59:43Z
transaction,a5891d65-d9eb-49fc-815d-4e9c7ce33a3d,posted,Payroll WFRMS 15439393,10074.25,f229e449-5730-4deb-a05b-0d74d4d04738,15422.77,credit,transfer,AU00000,2023-12-27T00:44:40Z
transaction,f5981eae-1758-4428-b45b-c3e1baa19a68,posted,TFR Acc14000 TO 12389,-445.0,10ed685a-857d-46ef-bdd4-32fd7836f78a,14977.77,debit,cash-withdrawal,AU00000,2023-07-14T06:06:09Z
transaction,c05e8649-8e2e-4991-9492-b65d177adba7,posted,Online Gaming Purchase,-3974.85,7921d55e-9c4c-466d-a99e-6cb0898b87ac,11002.92,debit,cash-withdrawal,AU00000,2024-03-05T03:50:24Z
transaction,5c62c7de-e708-4a27-8559-310818ad9911,posted,Movie Ticket Purchase,-1856.28,dfb75f18-e115-48dd-88cc-47f35bf3c56b,9146.64,debit,payment,AU00000,2023-11-28T17:27:19Z
transaction,3a9553ac-dc0c-459c-afd2-acf9a7635500,posted,Bookstore Purchase,-1750.37,5e9d44f5-60d4-46b1-aca0-6da1edd38ce5,7396.27,debit,cash-withdrawal,AU00000,2024-03-20T17:29:33Z
transaction,696947e5-f611-459c-a76a-ebf094222b68,posted,Music Streaming Subscription,-4478.09,2ac7f96c-9851-457c-9832-c9ac4595a82c,2918.18,debit,bank-fee,AU00000,2024-02-01T09:16:12Z
transaction,2c1c4495-6c62-4c28-b45c-c974f2551d90,posted,Transfer Platnm Homeloan 346454,-678.89,e8860450-30bc-4635-9a01-bc714678542c,2239.29,debit,bank-fee,AU00000,2023-08-26T16:13:08Z
transaction,7e039aa1-b1d1-4d06-9bfb-4b746455f85e,posted,Uber Ride,-1442.03,5e72e8a5-e477-44f5-ae85-993d13502822,797.26,debit,cash-withdrawal,AU00000,2023-09-12T17:06:26Z
transaction,ac8ab3ae-9d3a-4093-9d5b-7293f5874224,posted,Clothing Store Purchase,-3073.85,8611caf7-3165-47ae-be1e-1b92b47ef49a,6281.8,debit,bank-fee,AU00000,2024-02-25T10:03:37Z
transaction,757619da-810a-408c-95b0-edd711c1e740,posted,Gasoline Purchase,-3175.73,2a077971-bc8c-4bc4-aedb-be60eb7aa531,3106.07,debit,payment,AU00000,2024-01-26T23:32:10Z
transaction,e9b64fe9-6a05-4510-966a-c32be9901d2c,posted,Public Transport Fare,-3174.65,5c0f0715-696e-4996-8504-f30ded4c09b5,-68.58,debit,bank-fee,AU00000,2023-12-16T16:21:21Z
transaction,3bd7d5a6-8110-4646-8f45-e1fcd97e92bc,posted,Uber Ride,-450.95,82eae331-4de2-4288-b909-8f7663c8a249,-519.53,debit,cash-withdrawal,AU00000,2024-01-04T16:00:59Z
transaction,5028fc15-739f-449f-bf31-802fc4240b1a,posted,Music Streaming Subscription,-592.28,f7a1ebda-fc1b-4c7a-9091-439ba53a8b96,-1111.81,debit,payment,AU00000,2023-10-31T02:11:19Z
transaction,a6076d05-995a-4e6c-9354-8d8367596b5d,posted,Home Improvement Store Purchase,-3214.18,16556c45-cb2a-44e2-95b8-97210f141e25,-4325.99,debit,cash-withdrawal,AU00000,2023-12-09T14:18:07Z
transaction,b5302155-fbf9-45be-96a0-ccf7aa7fe484,posted,Wdl ATM WESTPAC IGA BALGOWLAH BALGOWL AU,-1259.69,ff7d619c-e99b-4be5-a6d2-63818073ad7a,-5585.68,debit,cash-withdrawal,AU00000,2024-02-20T03:58:09Z
transaction,a02c235b-e883-475d-ae7b-aa202227a55a,posted,Home Improvement Store Purchase,-1662.63,31d52ffb-1717-4d65-b427-31556a206c8b,-7248.31,debit,cash-withdrawal,AU00000,2023-12-09T21:29:04Z
transaction,95aee39c-1f7b-4c27-844c-aab906f624c1,posted,Music Streaming Subscription,-4618.55,03f8e4c7-f90f-4545-b289-4595785182f6,-11866.86,debit,payment,AU00000,2024-02-12T05:42:12Z
transaction,8b570078-b378-4e78-9a89-7121ccf92bae,posted,Manly Maths Tutor Wages,-429.34,e3714997-c355-48a9-9659-fb5d793d3963,-12296.2,debit,cash-withdrawal,AU00000,2024-02-26T23:37:41Z
transaction,c67464e0-0b7c-40cc-967e-446923352d2a,posted,Hair Salon Appointment,-3895.71,67a6f747-d06f-4b67-baf5-88c11b20d4da,5605.31,debit,bank-fee,AU00000,2023-11-11T17:10:51Z
transaction,0189d74e-e557-4b2c-b48e-e6af29ce46ea,posted,Payroll WFRMS 15439393,10470.53,fe12f80d-d82b-4197-8136-c572a999cb30,16075.84,credit,transfer,AU00000,2024-03-20T00:15:48Z
transaction,6e922a83-3c67-47ed-bca2-1efda2472bd1,posted,Transfer Platnm Homeloan 346454,-173.93,6728ec8e-17c6-4e82-b01f-63434ea6aeb7,15901.91,debit,cash-withdrawal,AU00000,2024-01-20T15:52:47Z
transaction,c28bd8b4-59b0-4dad-b9ee-db8eb84021e3,posted,Netflix Subscription,-2015.14,11f7e36d-b25d-4411-925c-d2fc373c2057,13886.77,debit,bank-fee,AU00000,2024-01-22T00:12:32Z
transaction,c0d51d35-707e-45e6-8d5a-1dde16a8204b,posted,Movie Ticket Purchase,-4342.14,1478bd93-79ad-4dea-8115-d15d808c74a5,9544.63,debit,bank-fee,AU00000,2023-11-17T17:43:16Z
transaction,4c0de1ed-e11c-4508-9db9-0ba20ae91464,posted,Public Transport Fare,-4341.79,0873f99c-3299-4541-b8e2-5b37c2137e72,5202.84,debit,payment,AU00000,2023-10-21T22:12:59Z
transaction,e4e389e1-dfbc-4bf9-a0f1-9851e96cea8c,posted,Hair Salon Appointment,-3754.09,9e14cf29-9ebe-4dba-b711-60126f7c39fc,1448.75,debit,payment,AU00000,2023-08-08T02:48:28Z
transaction,34151612-39b4-4c5d-b53f-c19bad313a2e,posted,Pharmacy Purchase,-3507.02,1b5815a0-67c2-401a-8e8c-257421302567,-2058.27,debit,cash-withdrawal,AU00000,2023-11-12T16:58:51Z
transaction,78040b88-58a4-41bf-a777-0ea219be19a6,posted,Pharmacy Purchase,-1926.47,c7bbcd3c-ef64-4a33-af15-3b103fe72ea5,-3984.74,debit,payment,AU00000,2024-03-09T15:29:27Z
transaction,aaec1c54-b918-4b70-bc38-31b74e0c8e66,posted,Wdl ATM WESTPAC IGA BALGOWLAH BALGOWL AU,-2984.94,ff2dd7ff-085e-48b9-9aff-669f441ac9ea,-6969.68,debit,cash-withdrawal,AU00000,2024-01-17T06:17:42Z
transaction,e2121fe5-bdc3-4490-b0dc-f2ec2d470ff7,posted,Coffee Shop Purchase,-458.61,4c9a508e-fc63-453a-81b6-07e8d57fd8e1,18353.06,debit,payment,AU00000,2023-11-05T08:04:20Z
transaction,04ae624d-5f3b-4683-8722-5ad8489c7e67,posted,Online Gaming Purchase,-4657.71,26a6c4e3-4e3c-446f-a20d-cdd2e9b013eb,13695.35,debit,cash-withdrawal,AU00000,2024-03-21T16:58:30Z
transaction,74dfaa31-6030-41de-8310-415b94738827,posted,Music Streaming Subscription,-3963.48,c1efb14a-d7c4-478f-9a58-0bf066511b14,9731.87,debit,payment,AU00000,2023-07-18T18:08:12Z
transaction,1c30f9ed-cc38-4a4e-9318-331f47dffb94,posted,Restaurant Dinner,-2289.17,0d94d7f7-4599-42e4-b9e4-59c75efd19b8,7442.7,debit,payment,AU00000,2024-02-24T06:48:16Z
transaction,f9819a5d-a25f-46c3-9c71-9429d1a28d20,posted,Non Hooli ATM Withdrawal Fee,-2614.31,fc9fea65-f2bc-4852-8670-b3342733bebd,4828.39,debit,cash-withdrawal,AU00000,2023-10-21T17:31:18Z
transaction,e4828c15-62fe-4118-a48d-a471c4ba0743,posted,Bookstore Purchase,-2931.37,eead7a6c-2cca-4105-b3d5-815eb0d555cc,1897.02,debit,cash-withdrawal,AU00000,2023-07-23T02:43:40Z
transaction,6c63dccf-0a0f-40bf-83a2-4dc0d88d119d,posted,Pharmacy Purchase,-864.2,adf271d0-232e-4663-8d83-de1a279794b7,1032.82,debit,payment,AU00000,2024-02-11T03:30:06Z
transaction,0728f75c-cf58-48aa-8cb7-d13c2f97e7b8,posted,Travel Agency Booking,-2663.5,227d905e-1784-4c20-96cc-54eafec2ae47,-1630.68,debit,payment,AU00000,2023-12-27T03:23:13Z
transaction,1cdeb37b-8080-468a-a277-dd2e61965aee,posted,Manly Maths Tutor Wages,-1812.03,0147fe1d-183f-459b-91dd-bbda56cb5d61,-3442.71,debit,payment,AU00000,2023-09-06T23:50:20Z
transaction,a21b294a-994e-406d-aeaa-45c2ddbcc101,posted,TFR Acc14000 TO 12389,-3761.45,caebee1d-ab6a-4d05-b456-75f703a34091,-7204.16,debit,cash-withdrawal,AU00000,2024-01-02T14:33:59Z
transaction,0b7dd814-30c9-480f-9135-6993bef9d8f9,posted,Non Hooli ATM Withdrawal Fee,-1681.74,9749cc0e-1715-41f8-984f-9a2703a97dbc,4450.08,debit,bank-fee,AU00000,2023-05-30T12:33:18Z
transaction,5a36d0ad-4851-41e9-bae2-a07b9d26b0d5,posted,TRANSFER TO JOANNA SMITH CAMPING,-4148.42,c8685bc2-565b-4703-bfd1-4c6d9daa651b,301.66,debit,cash-withdrawal,AU00000,2023-08-11T21:55:31Z
transaction,d2b1d556-e8f1-472f-8b34-dfa6cfa4004b,posted,Netflix Subscription,-2226.67,efa18b0c-d361-4bbd-ade0-fc86bc23ae7f,-1925.01,debit,cash-withdrawal,AU00000,2023-12-09T10:34:40Z
transaction,d98d1856-c636-428d-a4af-8ae89fdd2353,posted,Home Improvement Store Purchase,-4835.07,beaf9465-0753-4ea3-87cc-1523aad4122b,-6760.08,debit,cash-withdrawal,AU00000,2023-10-04T00:59:22Z
transaction,3b290d1f-6569-4d47-9ecd-6ebaa78e6ca7,posted,TFR Acc14000 TO 12389,-4249.49,e0acfdf5-7d59-46d3-b32f-3e899246ba49,-11009.57,debit,bank-fee,AU00000,2024-02-19T21:46:09Z
transaction,0a0cc34f-b788-406d-9e16-8880174d20c4,posted,Coffee Shop Purchase,-3125.11,8d8e4491-9e93-4d20-9aeb-d372b23981d7,-14134.68,debit,bank-fee,AU00000,2024-04-22T12:39:13Z
transaction,6072e86a-c171-4c07-919f-f9790791afec,posted,Online Gaming Purchase,-1688.26,ee968583-592d-49f8-bb3d-99b01c77e42a,-15822.94,debit,bank-fee,AU00000,2024-04-22T05:09:51Z
transaction,d97fe589-456d-49ef-97f8-f1c74665a69f,posted,Manly Maths Tutor Wages,-1295.51,f9924074-40e3-46a3-a4a4-a374ea9de761,-17118.45,debit,cash-withdrawal,AU00000,2024-02-22T16:42:42Z
transaction,032a6573-4df9-4cd7-84f7-6acbe4fb03aa,posted,Manly Maths Tutor Wages,-4681.76,3010a133-60e3-4763-b23d-d5083feb553d,-21800.21,debit,payment,AU00000,2024-02-23T00:01:43Z
transaction,636f4ace-d8cf-4516-805b-92d858f676b0,posted,Home Improvement Store Purchase,-4733.64,784d0bfd-8c5c-42a5-aeb5-11b75b0cdeef,-26533.85,debit,payment,AU00000,2023-05-15T14:19:04Z
transaction,6d43e2db-a4f2-4070-b168-4279140f3452,posted,Coffee Shop Purchase,-4811.89,6026c985-6d7d-4f4b-beb2-6ea1bfb2cfaf,6826.62,debit,bank-fee,AU00000,2024-03-13T23:14:45Z
transaction,b6bb1010-41ac-49ac-93d8-39bd97b8f3f0,posted,Bookstore Purchase,-2868.29,31d9e11e-0a96-4ec3-b51c-7ba98019f3e0,3958.33,debit,payment,AU00000,2024-05-09T15:26:48Z
transaction,d1de1a7c-45d7-4f70-911e-de9e2d997b79,posted,Pharmacy Purchase,-3182.15,298e5f97-2250-4072-a979-9be200f1cefa,776.18,debit,payment,AU00000,2023-06-14T05:55:02Z
transaction,1c36c1d9-b8f7-4ab4-9a49-98d3c866314f,posted,Hair Salon Appointment,-3810.93,a4cd67cb-bca7-4c99-9233-6738350031d7,-3034.75,debit,cash-withdrawal,AU00000,2024-03-08T01:29:32Z
transaction,f2b6fd60-8768-435e-bdc6-1b68db96368d,posted,Hair Salon Appointment,-2911.64,18ecd96f-2d13-44d8-aa8b-5ab369da6e84,-5946.39,debit,bank-fee,AU00000,2023-07-16T16:25:40Z
transaction,e07d10d4-de16-49e0-a344-a0d52a372e17,posted,AGL RETAIL ENERGY LTD (GAS),-1293.71,4f2c48c9-96c1-4dd0-bfb3-87fe71cf01c9,-7240.1,debit,payment,AU00000,2024-05-04T02:01:31Z
transaction,e9481b50-adf2-4570-9cef-9066234fadf1,posted,Clothing Store Purchase,-2633.33,b629a37b-e6a5-43b6-85d2-3131342c7e15,-9873.43,debit,payment,AU00000,2023-12-20T01:49:07Z
transaction,abb26eeb-cc1f-473b-bc53-b1cf03fc7da4,posted,Manly Maths Tutor Wages,-2424.73,97b06a2e-75f8-408b-a89b-a92ee88333c3,-12298.16,debit,payment,AU00000,2023-05-24T05:01:51Z
transaction,2a0f831f-a0bd-4389-ae12-24b850dc4f71,posted,Netflix Subscription,-1683.21,c64a3459-76b2-4e1d-b03f-8794f5ac0a57,-13981.37,debit,cash-withdrawal,AU00000,2023-06-30T19:07:49Z
transaction,8c813e1d-b05f-4afb-862a-dce2d0f30d61,posted,Uber Ride,-2249.74,2fda4f30-bd3e-43ab-ba18-4e0844a7b54a,-16231.11,debit,payment,AU00000,2023-06-21T12:08:58Z
transaction,62c3a25c-e493-40a0-9464-1c59b3347176,posted,Manly Maths Tutor Wages,-3664.03,240af743-47b3-47e7-994f-1ac0b9df838d,15299.89,debit,payment,AU00000,2024-05-08T15:57:15Z
transaction,b5b0d914-a320-4b0a-8b59-409cadf7d7b5,posted,Online Gaming Purchase,-834.55,497f87d1-4c78-4e3a-8c63-ac34516a96d6,14465.34,debit,cash-withdrawal,AU00000,2024-01-20T13:31:59Z
transaction,dbb47791-8856-4592-af3a-243f6f4a45af,posted,Car Maintenance Expense,-2637.83,38821c9a-86e6-4fc2-b938-daa8e4518e92,11827.51,debit,payment,AU00000,2023-06-20T04:17:12Z
transaction,2dc0b48f-74b2-4750-8554-a76737a717ad,posted,Hair Salon Appointment,-3908.5,2a412b8c-3382-463f-8783-bad721d4c9fb,7919.01,debit,cash-withdrawal,AU00000,2024-04-09T15:48:36Z
transaction,f159b040-0e72-4bbb-98c8-7dd56ac99780,posted,TFR Acc14000 TO 12389,-4973.36,b793a256-c07d-4bf6-86a8-5491a21f3ae1,2945.65,debit,payment,AU00000,2023-07-09T04:31:29Z
transaction,d4907b97-70e5-4885-9eff-f1b96ad5dfe3,posted,Amazon Online Shopping,-956.9,99e59f29-022b-4fbe-a4c2-383c733dd0e5,1988.75,debit,payment,AU00000,2024-02-10T14:37:27Z
transaction,768ac3f2-d894-4d06-bc88-27bdf52f21d4,posted,Amazon Online Shopping,-3808.02,aea6defd-0596-4051-b206-15a0473e9fe3,-1819.27,debit,payment,AU00000,2023-09-11T19:34:10Z
transaction,d4f03213-f327-456d-a531-16c171f75406,posted,AGL RETAIL ENERGY LTD (GAS),-3712.73,c6dd5cf2-ddb3-48ec-9463-f24dbae6ca0d,-5532.0,debit,payment,AU00000,2023-05-26T16:24:08Z
transaction,6858b721-fb41-4237-bfd3-58a003fa4ff0,posted,Travel Agency Booking,-4791.87,5c5dc38c-b41b-4071-94aa-7af97b2c866c,-10323.87,debit,bank-fee,AU00000,2023-10-20T09:27:52Z
transaction,c07bf9fe-b3d8-43c9-9b62-a93b82950c16,posted,Uber Ride,-3130.78,4d3f6566-66a3-492a-a123-ca8e4b5ed055,-13454.65,debit,bank-fee,AU00000,2024-01-04T18:12:56Z
transaction,260d17b7-9bda-40db-96d2-dacd10eb450f,posted,Manly Maths Tutor Wages,-3119.01,2c2d92ee-0a83-4cd8-8291-9e72b3ac559e,5982.61,debit,cash-withdrawal,AU00000,2023-06-21T10:28:10Z
transaction,8c59c59e-c4a9-41d3-934b-8fa0f8070ad3,posted,Home Improvement Store Purchase,-1029.89,aa67ba50-2bad-4b14-bd01-280b6c67cfb5,4952.72,debit,bank-fee,AU00000,2023-09-27T16:14:44Z
transaction,f90d8599-f9d8-403e-ab42-741192fc7a7c,posted,Travel Agency Booking,-3781.57,e4345292-220f-47f5-89ad-7dfdffd390f8,1171.15,debit,cash-withdrawal,AU00000,2023-06-24T04:51:59Z
transaction,8bda7f3f-a049-406a-89a6-f486fbea4c7a,posted,Bookstore Purchase,-2420.49,0417edb7-153c-4555-834f-27f104cc4dbe,-1249.34,debit,cash-withdrawal,AU00000,2024-04-26T10:51:08Z
transaction,9fa9a7af-e18d-4feb-97ee-0e247468c711,posted,Restaurant Dinner,-192.25,11954452-f701-4079-9de0-fe3d51f986ca,-1441.59,debit,bank-fee,AU00000,2024-01-02T23:14:30Z
transaction,43ff7d55-79ef-4a81-96ce-819d8f0db210,posted,CTRLINK CARERS Ref: 998R6789201610974V,-2650.04,9b210f60-24fd-40f1-aba5-92a858003ec0,-4091.63,debit,cash-withdrawal,AU00000,2023-10-28T01:01:38Z
transaction,c824ffa8-8148-4c7b-b40e-14753a08ad74,posted,Bookstore Purchase,-1140.88,d5f3a1f7-6cf7-43ab-9d86-becc36efc048,-5232.51,debit,cash-withdrawal,AU00000,2023-09-04T19:11:07Z
transaction,f72c1506-c92c-4f6d-9acd-8936144320fe,posted,Pharmacy Purchase,-2584.19,17d9296e-e77d-4679-9fdc-e747f8caaca8,-7816.7,debit,cash-withdrawal,AU00000,2024-02-20T16:04:36Z
transaction,b23cc5a3-1163-4c93-811b-6f4048053510,posted,AGL RETAIL ENERGY LTD (GAS),-2761.79,09121dd1-c120-4129-ba43-f919d835501b,-10578.49,debit,payment,AU00000,2023-06-08T16:48:33Z
transaction,24bd44ee-4069-487d-b7a4-00b0d849db30,posted,Amazon Online Shopping,-3215.48,f22c9104-3049-49f8-bc98-0a02b8b58423,-13793.97,debit,payment,AU00000,2023-12-10T02:49:03Z
transaction,8b64ee86-b860-4962-a7cd-900821830fa7,posted,Car Maintenance Expense,-492.31,d4571c61-8a26-4216-91ea-45533cfdced8,16098.29,debit,payment,AU00000,2023-05-20T04:44:19Z
transaction,0ac3ae72-2fca-4f3e-8799-897e7133db79,posted,Wdl ATM WESTPAC IGA BALGOWLAH BALGOWL AU,-3466.97,5a50939e-1389-400b-867d-b40f5e9e8884,12631.32,debit,cash-withdrawal,AU00000,2023-10-26T08:28:33Z
transaction,2955fa3c-bf81-4962-8700-5aee89b96444,posted,CTRLINK CARERS Ref: 998R6789201610974V,-4827.08,6eea0e0f-5231-4bb0-9e37-69f6c5d8f5a5,7804.24,debit,bank-fee,AU00000,2023-07-13T15:27:54Z
transaction,4dedf4ce-b277-4fed-a22b-b1743f19b7df,posted,TRANSFER TO JOANNA SMITH CAMPING,-4037.31,7e1958f6-a6ea-461b-8108-6f48ff4464ef,3766.93,debit,payment,AU00000,2023-09-30T16:18:06Z
transaction,058609fe-3e0a-47a7-a1c3-e80ad83ebf02,posted,Restaurant Dinner,-53.44,cf3cf10b-ba60-46d1-899c-a922a419ee3e,3713.49,debit,bank-fee,AU00000,2023-08-24T10:11:29Z
transaction,7f1efea5-d98d-4767-84a0-ae25cde4661a,posted,Online Gaming Purchase,-2354.77,e8542ba2-b71c-43cd-9ce1-a9a5cb54446b,1358.72,debit,payment,AU00000,2023-11-17T12:58:45Z
transaction,d330c08d-81d6-47bf-8034-afc4bfa834a1,posted,Non Hooli ATM Withdrawal Fee,-1077.81,988b223b-595b-4499-90e8-c44aaba5b0d9,280.91,debit,payment,AU00000,2023-12-22T23:19:32Z
transaction,508bd3c6-aaa1-4c1b-8049-5bd263fd41d0,posted,Payroll WFRMS 15439393,11238.36,6ccb2ea3-a62c-4da2-9269-7f4c40abd030,11519.27,credit,transfer,AU00000,2023-11-20T00:49:26Z
transaction,2e32c03b-46b6-48bd-a5f8-f811eaf2094c,posted,Clothing Store Purchase,-983.85,dc997424-5c04-4512-be3f-5250687442dc,10535.42,debit,payment,AU00000,2024-02-24T20:34:11Z
transaction,4b47dfe1-080a-456e-8b95-402eab405dbc,posted,Electricity Bill Payment,-3807.47,bc5a97a4-da73-4046-93ad-e13bb10fafa1,6727.95,debit,bank-fee,AU00000,2024-03-13T06:48:56Z
transaction,b2eb7154-e617-4c8e-83e4-440e6480307a,posted,AGL RETAIL ENERGY LTD (GAS),-2708.36,7a381459-0db8-4a8c-a86a-8e1433d38818,11357.54,debit,cash-withdrawal,AU00000,2023-11-14T19:13:24Z
transaction,bd80cfb5-cf45-4bbe-a481-e329e7828579,posted,Non Hooli ATM Withdrawal Fee,-3736.42,50294318-ab87-41c4-ac47-1c6dd6543f35,7621.12,debit,payment,AU00000,2023-10-10T04:20:01Z
transaction,b941cf38-3324-40f6-af90-e2318effb9b9,posted,Netflix Subscription,-1007.13,1921ba69-8ca9-4112-abd1-086c8f2ad8fb,6613.99,debit,cash-withdrawal,AU00000,2024-02-19T18:38:19Z
transaction,11dd56b8-7b06-4d39-a929-fb05e054b44a,posted,Pharmacy Purchase,-2859.73,de7bd6d3-4d65-4e1c-bd40-9d59efbfebdc,3754.26,debit,cash-withdrawal,AU00000,2023-05-16T00:18:18Z
transaction,d23824ba-0bce-41bb-91dd-b9dd765f98c3,posted,Payroll WFRMS 15439393,10137.01,65924b83-3a31-4353-80b8-9fd29cb68cc3,13891.27,credit,transfer,AU00000,2023-06-30T16:20:16Z
transaction,b1301a62-cb24-407b-91c0-c0ba57a39bec,posted,Restaurant Dinner,-2476.05,3debddf6-2fab-4e1b-933a-c811d72a33f5,11415.22,debit,bank-fee,AU00000,2023-08-30T14:41:54Z
transaction,2e08de37-944a-4a20-8ac5-80ddda2000f6,posted,Gasoline Purchase,-2596.09,df3537e9-ba0a-40f2-951a-bc27d13051c6,8819.13,debit,cash-withdrawal,AU00000,2023-07-05T19:51:56Z
transaction,a82eabe3-92de-4f54-acfe-b91c94041d15,posted,Movie Ticket Purchase,-1034.43,e3e084e6-4d77-431c-a8d2-14b60ac185ba,7784.7,debit,cash-withdrawal,AU00000,2023-10-08T12:49:36Z
transaction,6f0493b7-8b7b-4890-95e5-898658b2f399,posted,Gasoline Purchase,-2002.25,8e9d8ac7-1a15-449c-87c9-d451e565ec24,5782.45,debit,cash-withdrawal,AU00000,2023-09-27T00:39:33Z
transaction,c3b4c273-b649-4c6c-bc67-f5a964f1ccb8,posted,Amazon Online Shopping,-2213.24,1de0bb7c-ffa4-4a46-b93a-ad96dc895a7d,3569.21,debit,payment,AU00000,2024-03-05T12:46:25Z
transaction,099017e0-80b8-41ed-8682-7d3e71716a6e,posted,Gasoline Purchase,-4653.25,f77a3aaf-2cda-427e-987b-a83b1be87cb1,10602.85,debit,payment,AU00000,2023-10-13T08:28:11Z
transaction,f12445cc-16b1-4196-9192-2dd15a81a453,posted,AGL RETAIL ENERGY LTD (GAS),-4339.53,74665cf5-fa03-4e56-a68d-1847e5432d9d,6263.32,debit,cash-withdrawal,AU00000,2023-07-26T11:01:21Z
transaction,bc54d2e9-c1e1-4b24-b34f-a34bd6e5ee9b,posted,Movie Ticket Purchase,-2072.85,64132aee-bfd9-45aa-a035-2b8aa872b4c8,4190.47,debit,cash-withdrawal,AU00000,2023-05-14T21:20:52Z
transaction,c33c4efc-9fcb-4174-814f-f406c798c927,posted,Music Streaming Subscription,-3865.38,5587dbf1-e19a-49e0-b38b-3fb8dd02c3d9,325.09,debit,payment,AU00000,2023-06-01T22:09:58Z
transaction,e37106c5-1312-4254-9a8d-f720f63c790a,posted,TFR Acc14000 TO 12389,-2677.66,711ba461-29b8-46ca-851b-e14f567b7acf,-2352.57,debit,payment,AU00000,2023-09-14T19:47:37Z
transaction,8318690b-7c98-4d1e-ba1a-9499afc06fdb,posted,Restaurant Dinner,-2068.42,26ef70bb-fc49-4b0a-98ed-232c8ca5b286,-4420.99,debit,cash-withdrawal,AU00000,2023-08-23T03:33:59Z
transaction,5ab2b7dc-bb07-4982-b30b-fc2e176fc292,posted,Gym Membership Fee,-946.1,42c6a8c7-e243-4a19-844c-434b1d5081e4,-5367.09,debit,payment,AU00000,2023-09-17T04:47:18Z
transaction,313c7619-5aac-4bad-a819-147d2d1e282d,posted,Netflix Subscription,-4632.88,61f73ca4-5fbe-4123-a310-cc918664487b,-9999.97,debit,bank-fee,AU00000,2023-09-08T09:50:14Z
transaction,0f61cfb3-133c-4868-94b3-31799e007c25,posted,Bookstore Purchase,-664.13,1837d4ec-dced-4e7f-915c-a4c5dff1d0ed,-10664.1,debit,bank-fee,AU00000,2023-10-26T19:13:06Z
transaction,768624ca-aa23-49e9-b304-04d793104429,posted,Clothing Store Purchase,-4865.58,ad20b8f3-4435-46cc-b9b1-89e8b0e15339,-15529.68,debit,bank-fee,AU00000,2023-07-03T02:40:42Z
transaction,a3e24451-415b-4665-a844-3e493e8c4155,posted,Movie Ticket Purchase,-4299.22,61d49490-a38e-4184-9311-e27d0127d9c0,10604.16,debit,cash-withdrawal,AU00000,2023-11-13T22:50:14Z
transaction,86318db0-2976-4d7e-b0b5-09d092331e48,posted,Wdl ATM WESTPAC IGA BALGOWLAH BALGOWL AU,-3787.48,66b4e252-f2c8-4f21-9c94-59d3a6e67256,6816.68,debit,cash-withdrawal,AU00000,2024-03-05T18:36:28Z
transaction,7fc03dec-2c1d-412e-b91a-2c0d78729198,posted,Hair Salon Appointment,-4417.36,e8bb43ae-d19e-4306-94ea-30411ce38724,2399.32,debit,bank-fee,AU00000,2023-11-26T20:14:41Z
transaction,3ec207bd-55d4-4dc9-b65f-16bc386fc418,posted,Wdl ATM WESTPAC IGA BALGOWLAH BALGOWL AU,-3673.65,a0a40349-bd36-459b-9901-ce200e2d95d1,-1274.33,debit,bank-fee,AU00000,2023-10-18T21:33:05Z
transaction,d839bdb4-6379-4a74-bba9-89ed57d36705,posted,TRANSFER TO JOANNA SMITH CAMPING,-3460.64,2a45456f-06d2-4d3c-9a91-638db1b961b4,-4734.97,debit,payment,AU00000,2024-02-14T16:00:43Z
transaction,8d8115f8-3e08-47d3-9f62-3efd70dd9a6a,posted,Hair Salon Appointment,-1074.62,b9dd8417-a32d-4649-85d8-f7256c56d7d0,-5809.59,debit,bank-fee,AU00000,2024-02-07T16:26:38Z
transaction,705d23b5-a322-4818-b535-bc0b2a42c306,posted,Non Hooli ATM Withdrawal Fee,-4729.79,d08734f3-93f5-4368-9986-46e289d35f82,-10539.38,debit,payment,AU00000,2023-08-21T13:51:55Z
transaction,d5f98af2-7207-44a4-88bf-b13a624117d4,posted,Home Improvement Store Purchase,-2126.74,00593dc8-7058-4165-b60d-9d68abc86379,-12666.12,debit,payment,AU00000,2024-04-23T18:34:16Z
transaction,6a44436d-f6fd-47ee-b749-2b97fa5fa08d,posted,Manly Maths Tutor Wages,-4451.86,2533cf49-9e41-4cdf-98d4-f39d745a9669,-17117.98,debit,bank-fee,AU00000,2023-06-27T13:59:04Z
transaction,c6a7a59c-d186-4794-9ee7-f4e0dff8b2d0,posted,Restaurant Dinner,-3818.3,a1d06d1d-a178-4547-b3e6-73f767b7cac2,-20936.28,debit,bank-fee,AU00000,2024-04-23T06:25:35Z
transaction,1b48a213-4b31-4a1d-a867-e2246759a316,posted,Coffee Shop Purchase,-1537.81,3c0b297c-0ec3-4c09-86d8-c9fdd631c27b,17644.89,debit,payment,AU00000,2024-01-18T19:11:04Z
transaction,c891b164-418b-459f-a72f-c3ba748a401b,posted,Restaurant Dinner,-4736.19,3c0f68b9-1d93-4d76-95f1-f758a9aa3b04,12908.7,debit,bank-fee,AU00000,2023-05-22T04:12:44Z
transaction,b1ee1c2e-c490-4eea-8233-bfec476380e3,posted,Pharmacy Purchase,-3050.91,e16430c5-a9a5-48c1-b169-c4cb1f805962,9857.79,debit,payment,AU00000,2023-09-10T15:09:29Z
transaction,26495362-c03a-4fe2-96d4-8f5fcdf3fb6b,posted,Wdl ATM WESTPAC IGA BALGOWLAH BALGOWL AU,-4001.89,c859c256-d795-486a-a0ed-9a47a957370d,5855.9,debit,bank-fee,AU00000,2023-05-21T09:06:46Z
transaction,cec52e10-353c-4d6b-af74-68f3928dcc73,posted,Online Gaming Purchase,-1682.31,54413281-6411-4735-9e5e-f6ca9c1e1416,4173.59,debit,cash-withdrawal,AU00000,2023-10-07T04:51:47Z
transaction,d59fdcd8-908a-4b5a-bc62-d0a4c055ce70,posted,Clothing Store Purchase,-4744.5,c6133776-e7f5-493e-9ebc-d69daa67d22a,-570.91,debit,bank-fee,AU00000,2023-07-25T17:14:25Z
transaction,e3e98b51-b534-4b27-a273-f18cb841bd71,posted,Manly Maths Tutor Wages,-3660.14,53ade08d-7aac-400e-a7d3-36058abf4e6f,-4231.05,debit,bank-fee,AU00000,2023-11-25T21:32:26Z
transaction,6dd93d51-a880-416c-8326-b441d8034c4b,posted,Restaurant Dinner,-3899.16,5f4c9de3-a38a-4dbf-8ff1-d30a9d26fbe0,-8130.21,debit,cash-withdrawal,AU00000,2023-11-18T12:07:05Z
transaction,80144000-de74-49d4-a738-f30c1fbf1bb4,posted,TRANSFER TO JOANNA SMITH CAMPING,-4993.65,58ce209e-6173-4d38-9695-532784367dc8,-13123.86,debit,payment,AU00000,2023-06-08T07:10:31Z
transaction,d2c63d84-483c-412d-b972-b1126b847dcb,posted,TFR Acc14000 TO 12389,-2070.49,513ec370-c341-490b-a165-a16ce29f8d36,-15194.35,debit,payment,AU00000,2024-01-11T02:33:20Z
transaction,42b4cec0-6d7c-44e7-88f3-bb2ddb416044,posted,Gym Membership Fee,-4144.52,72e90bc2-8b82-4348-9831-386b4c0cf750,12083.52,debit,bank-fee,AU00000,2024-03-30T18:57:25Z
transaction,db79d18f-f5fa-41c2-b092-1920b943a3e0,posted,Clothing Store Purchase,-3241.34,b60868c8-5358-4c43-b34c-945997c2bf28,8842.18,debit,cash-withdrawal,AU00000,2023-08-07T14:55:42Z
transaction,98c5e13c-78cf-4ae3-aa0c-616c2465325b,posted,Online Gaming Purchase,-2810.37,0ff7b780-f699-4c92-b66e-8bbd0ca88c6f,6031.81,debit,bank-fee,AU00000,2023-11-01T06:08:23Z
transaction,bf30b7d9-8db6-45b9-b1a1-4581b5cb9c07,posted,Bookstore Purchase,-2388.13,5e5871e5-7e33-4d67-a7d7-cf1a5f01c7a0,3643.68,debit,bank-fee,AU00000,2023-10-28T00:37:26Z
transaction,68666fee-2e15-477e-a609-9d363a36c1ff,posted,Electricity Bill Payment,-3698.98,7be89bc9-4319-482f-8d2c-e1bf01ba7b82,-55.3,debit,cash-withdrawal,AU00000,2023-12-23T21:08:44Z
transaction,3b645474-21af-4182-a6a0-c49cb1f4fcf2,posted,Netflix Subscription,-2021.77,79f1e5b1-2e75-4c85-9d08-068636c79e65,-2077.07,debit,cash-withdrawal,AU00000,2023-10-30T06:49:04Z
transaction,2251d41f-516f-44b3-98e8-1f6450bdbf00,posted,Pharmacy Purchase,-1979.22,c24ac87e-a222-4dbb-8ad5-b4b84bd287e0,-4056.29,debit,payment,AU00000,2024-02-17T16:01:36Z
transaction,444b0fe6-a529-45a4-8b54-51526c9dc2ca,posted,Wdl ATM WESTPAC IGA BALGOWLAH BALGOWL AU,-4807.44,462ee98f-dbfa-49ff-946d-87a5eff59567,-8863.73,debit,payment,AU00000,2023-12-28T02:02:27Z
transaction,c8d1552b-8beb-4083-a27b-d79cd5ef9c94,posted,Gym Membership Fee,-3467.38,a60068af-49ad-4d93-94c7-13e20dd30427,-12331.11,debit,cash-withdrawal,AU00000,2023-12-27T15:03:03Z
transaction,8a48f3b7-7f13-42ef-ab41-566bd4bc4f37,posted,Online Gaming Purchase,-1710.95,78085b7d-cb94-4eef-87e3-0d0dcf133d21,-14042.06,debit,bank-fee,AU00000,2023-05-15T16:29:55Z
transaction,3ea744bb-de45-40ff-9270-6e08e43cde90,posted,Pharmacy Purchase,-4295.22,9d04b336-28fd-43be-89c6-f432f99ce94d,6825.63,debit,payment,AU00000,2023-05-14T20:19:23Z
transaction,19b0607f-3b74-42e5-bd01-70b1485afeb1,posted,Electricity Bill Payment,-4952.46,afacdb9a-dff5-4862-916c-44aa65c85574,1873.17,debit,bank-fee,AU00000,2023-10-05T14:15:33Z
transaction,2fba3b27-f724-4fb6-80e1-7a4edfb9c4d4,posted,Amazon Online Shopping,-1370.58,b9ae6689-d927-4019-9574-6c12bf221e9e,502.59,debit,payment,AU00000,2024-04-29T06:43:28Z
transaction,5ea3854c-8247-4633-922d-17b7507dc0a6,posted,Car Maintenance Expense,-1688.76,d129bd9a-b4bf-44f5-a0b2-373145a20bd6,-1186.17,debit,payment,AU00000,2023-12-07T15:55:54Z
transaction,f40ead08-50af-4a32-8a5d-c1d16c4b07f8,posted,TRANSFER TO JOANNA SMITH CAMPING,-2827.52,06882ab1-b11d-46d2-bd67-ea406d43653f,-4013.69,debit,payment,AU00000,2023-11-09T06:34:53Z
transaction,8afe63de-9c19-458d-83b2-a12e72e3a65f,posted,Electricity Bill Payment,-3566.58,40efb878-08bb-4ae4-bf67-94a98e89c0c6,-7580.27,debit,bank-fee,AU00000,2023-10-19T23:22:37Z
transaction,1475a367-d59a-4ce4-bce2-716954a5f51c,posted,TRANSFER TO JOANNA SMITH CAMPING,-4564.09,1ca5d9a5-d48b-44c2-82ed-7ea76f3c9182,-12144.36,debit,bank-fee,AU00000,2023-07-20T01:28:19Z
transaction,b1024aed-710f-4fba-b652-4fe9e8f3ac00,posted,Travel Agency Booking,-3569.23,35367b3e-51e5-49ac-8502-66c60845047c,-15713.59,debit,bank-fee,AU00000,2024-05-02T16:28:19Z
transaction,6efbc360-fac8-42d2-ba68-fa1065849151,posted,Bookstore Purchase,-4029.54,2e91221a-5085-4561-aac0-0aa6e43d9db0,-19743.13,debit,bank-fee,AU00000,2023-07-23T00:02:08Z
transaction,6fd93f82-c576-4971-9217-405915b33769,posted,Restaurant Dinner,-420.47,3f6d3e71-32c7-432d-8eed-c5cb25c160c6,-20163.6,debit,cash-withdrawal,AU00000,2023-08-16T04:01:56Z
transaction,6c07cfe6-dcdb-4212-8817-ff6eadc0c620,posted,Car Maintenance Expense,-4848.85,5b2b32e0-b6fe-4a15-a7a9-7fcb968201a6,5594.14,debit,cash-withdrawal,AU00000,2024-02-24T07:57:27Z
transaction,dbeceb6a-e09a-4f65-be81-a1cd7574fdce,posted,Manly Maths Tutor Wages,-785.59,bb690ec3-acfc-40ec-9843-63f7bc92afe0,4808.55,debit,payment,AU00000,2023-06-21T01:00:34Z
transaction,e2a0f430-8f4f-4438-9bf0-8cb21733427c,posted,Electricity Bill Payment,-2223.35,18cee9cd-9131-429c-a5bf-f4c6c9b03fed,2585.2,debit,payment,AU00000,2024-01-17T20:27:17Z
transaction,b4d7a792-8021-43b7-9d6b-8f5718ffb407,posted,Car Maintenance Expense,-4917.72,cc7a1285-4c3a-4708-898e-24d347eafd58,-2332.52,debit,payment,AU00000,2023-10-12T22:57:02Z
transaction,ae4fcbb4-65c5-4652-8b85-bd9cc076af6c,posted,Amazon Online Shopping,-6.14,baadc0c6-08e3-43da-952c-7c092312c65e,-2338.66,debit,payment,AU00000,2023-12-27T04:47:57Z
transaction,3944d669-4712-4161-bb08-3cab672ced1e,posted,Movie Ticket Purchase,-3806.52,642ae501-450a-468d-a9b7-956eaf05d4e4,-6145.18,debit,cash-withdrawal,AU00000,2023-10-05T10:44:10Z
transaction,591bec5d-4b0c-4551-be36-5f805276a14f,posted,Restaurant Dinner,-4419.54,7546a701-398d-46a3-bb9c-a63af528b2f0,-10564.72,debit,payment,AU00000,2023-09-15T15:47:51Z
transaction,ec8dc592-d89f-42e0-8ded-a4cdca309baa,posted,Bookstore Purchase,-1986.46,0cdbaf6a-78c2-45ec-a9a8-4029aa6de4d1,-12551.18,debit,payment,AU00000,2024-04-24T02:33:27Z
transaction,57e71135-4de5-4dd7-bcc8-5017564ec83d,posted,Pharmacy Purchase,-3440.99,85b4f4d4-5e28-43ce-bf16-8e873da8b9cb,-15992.17,debit,cash-withdrawal,AU00000,2024-03-29T01:44:24Z
transaction,f9386481-560c-4efa-a607-48cb2df34cd9,posted,Mobile Phone Bill Payment,-1814.77,d91665f0-b9b7-4954-b417-191ab1d837dc,-17806.94,debit,payment,AU00000,2023-08-28T16:51:39Z
transaction,d64b7104-0c76-4fa6-aafb-fef659c39a47,posted,TRANSFER TO JOANNA SMITH CAMPING,-3324.68,ca20bc59-5744-46ac-95a1-8dccdf6d35b9,12388.88,debit,bank-fee,AU00000,2023-05-27T09:02:18Z
transaction,85a8e3b0-e734-4b42-94aa-750415df85fe,posted,Hair Salon Appointment,-652.71,d4a13b86-1393-4466-8270-7d94d7c572c5,11736.17,debit,payment,AU00000,2023-10-29T19:12:11Z
transaction,56f6cdf6-5392-4331-b09e-a1d95c3268fa,posted,Netflix Subscription,-2301.93,42e94b79-372f-4613-a3d6-46f861378700,9434.24,debit,cash-withdrawal,AU00000,2024-01-03T16:46:08Z
transaction,6f3c9dbc-fbf5-4315-a9a5-2be8ffd9e38f,posted,Bookstore Purchase,-1545.5,d37db90c-400f-40aa-adb7-4723115239f6,7888.74,debit,bank-fee,AU00000,2024-03-15T08:37:27Z
transaction,7e7619a2-4a81-49d6-9930-85fadf462329,posted,TRANSFER TO JOANNA SMITH CAMPING,-626.38,f8d5290c-da84-499e-ae1e-927c0b6a8438,7262.36,debit,bank-fee,AU00000,2024-03-02T18:10:07Z
transaction,5421cb95-2be5-4cbb-94b4-d3f18d7e230f,posted,Wdl ATM WESTPAC IGA BALGOWLAH BALGOWL AU,-4569.42,bd91aac8-d059-4316-8669-1d8914466c8c,2692.94,debit,payment,AU00000,2023-10-16T12:33:01Z
transaction,2a117c83-f506-4404-9eeb-60673a1b28af,posted,TFR Acc14000 TO 12389,-3524.44,3433973c-84fc-468f-bcd9-50b5a53f3751,-831.5,debit,cash-withdrawal,AU00000,2023-08-22T11:33:15Z
transaction,c0341642-9a11-4a43-b2cb-ed1ea7d0e5a5,posted,Payroll WFRMS 15439393,10361.64,bb1b7a5c-446e-4fd5-93e6-95d757131206,9530.14,credit,transfer,AU00000,2023-07-13T16:08:46Z
transaction,c0aa0e19-858e-4cb0-9dca-489c244ea87f,posted,TRANSFER TO JOANNA SMITH CAMPING,-1458.57,a12dd3cb-15ea-49ed-8dc8-de72d1432ecf,8071.57,debit,bank-fee,AU00000,2023-05-17T00:58:28Z
transaction,f87709cd-08f4-43af-b6fb-06568424932d,posted,Electricity Bill Payment,-4467.73,c7a58220-677f-4381-ab8d-753c596146c9,3603.84,debit,cash-withdrawal,AU00000,2023-06-13T18:14:55Z
transaction,4d77fdc8-229f-4664-879d-6a200c15c11f,posted,Transfer Platnm Homeloan 346454,-2986.56,5941b7e0-e9ed-45ef-bf33-b6877ff0a8bd,3410.48,debit,payment,AU00000,2024-05-07T09:55:09Z
transaction,c06456ef-98b1-4df0-bce3-09e6ea489dd4,posted,Car Maintenance Expense,-1937.09,29ec687d-1366-4052-9965-e5ed42e7e061,1473.39,debit,payment,AU00000,2023-07-26T06:38:39Z
transaction,008c12e9-6e53-4c64-96bd-a4766949dc6a,posted,Movie Ticket Purchase,-4144.31,d71d35a7-e64b-41be-b9ec-56c5de10cc41,-2670.92,debit,bank-fee,AU00000,2023-10-05T03:46:07Z
transaction,ba33c2ab-74b7-458a-a336-f98c9bb8533b,posted,Wdl ATM WESTPAC IGA BALGOWLAH BALGOWL AU,-3643.06,29dbbb80-c47d-477e-9b17-593a10c39a5a,-6313.98,debit,bank-fee,AU00000,2023-10-07T21:19:45Z
transaction,795a6c89-32f6-480c-97ca-bdb1e2b688a1,posted,Non Hooli ATM Withdrawal Fee,-693.67,b4cd1bb7-eb41-4a2c-96b3-e899bfb786bd,-7007.65,debit,bank-fee,AU00000,2023-06-17T16:29:15Z
transaction,2763ae9a-b074-4e86-b657-e5953e61cac4,posted,TRANSFER TO JOANNA SMITH CAMPING,-1658.18,b01c434c-de50-4cc3-8a04-6c8067bad793,-8665.83,debit,payment,AU00000,2023-09-26T03:23:04Z
transaction,6f6345d7-223e-475a-ab1a-22a5e3d94504,posted,Mobile Phone Bill Payment,-1495.78,f1826c06-19cd-488d-9e8d-bcef937bc328,-10161.61,debit,payment,AU00000,2023-11-11T06:14:42Z
transaction,1785b25e-4f7f-4419-9ad5-0e19eb0b3dd6,posted,Hair Salon Appointment,-1030.92,ef27fc36-05c8-42ee-955d-3a8a32a3ef8e,-11192.53,debit,payment,AU00000,2024-04-28T21:37:54Z
transaction,7d920302-eb02-4629-bd0f-b59f528b4a43,posted,TFR Acc14000 TO 12389,-2081.97,fab36571-defb-4412-ae49-98220f01afe8,-13274.5,debit,payment,AU00000,2023-11-17T07:15:28Z
transaction,2c968333-98d5-47ad-955c-2bdc00e8ec93,posted,Coffee Shop Purchase,-3816.48,a6322e9d-aeeb-4d47-bb49-366b3415fc70,-17090.98,debit,payment,AU00000,2023-08-26T22:00:49Z
transaction,da65d6d9-6dad-4745-a54e-9a77e368329c,posted,TRANSFER TO JOANNA SMITH CAMPING,-865.85,620b45d2-84a2-4335-9cc4-0ae661081585,7607.9,debit,cash-withdrawal,AU00000,2024-03-30T22:04:04Z
transaction,2f076ce6-5fd3-4fb3-803f-d3d57975f77d,posted,Transfer Platnm Homeloan 346454,-3986.13,a9cc58ee-97b1-4c44-82dd-c6c8e6da769c,3621.77,debit,bank-fee,AU00000,2023-09-16T00:16:04Z
transaction,e2e132d4-ea7e-4d8d-a06a-a45adf965974,posted,Movie Ticket Purchase,-3483.89,563af08d-f826-4fbe-935c-2ea947934dbd,137.88,debit,bank-fee,AU00000,2023-12-03T21:57:42Z
transaction,ab07ce8a-a3ef-4abb-aa0a-676116ffaa88,posted,Bookstore Purchase,-1308.85,94979cdc-dd09-4d03-adc2-2c680bf1964a,-1170.97,debit,payment,AU00000,2023-12-22T12:19:09Z
transaction,cb7dede3-f293-425b-acc2-1baf25bcdfe0,posted,Manly Maths Tutor Wages,-90.44,a6086ee8-35d4-4b5f-8813-f761f643df92,-1261.41,debit,cash-withdrawal,AU00000,2024-02-22T06:05:44Z
transaction,8d5c2f7a-c62e-42e3-9373-e34257673da6,posted,TRANSFER TO JOANNA SMITH CAMPING,-2282.84,002fce89-a016-41a0-a55a-fe3536333792,-3544.25,debit,bank-fee,AU00000,2023-09-19T16:07:37Z
transaction,36b55055-3529-4b31-822b-c4f5c119acf0,posted,AGL RETAIL ENERGY LTD (GAS),-2199.25,ea0bdfb4-a3e5-425b-a442-92a998e0af92,-5743.5,debit,bank-fee,AU00000,2023-11-05T05:48:22Z
transaction,fb1b0dcb-3199-4344-a8a3-dd485b689d1c,posted,Car Maintenance Expense,-989.79,db078b86-c433-4026-acb8-f66f3b68eb58,-6733.29,debit,payment,AU00000,2023-08-04T05:59:46Z
transaction,5607d587-a3b6-4723-acd8-192482abdb77,posted,Movie Ticket Purchase,-2388.94,08755cad-3c84-4456-b831-4dda41db22e7,-9122.23,debit,cash-withdrawal,AU00000,2024-01-17T00:58:17Z
transaction,b778f26a-a5eb-4293-a51a-90764c5d8974,posted,Electricity Bill Payment,-3336.5,3c771cd1-048f-4a7e-bc44-89012e4fa497,-12458.73,debit,payment,AU00000,2023-07-31T15:39:50Z
transaction,d3650c48-c7e3-4db1-ab2a-f87d3c5bed15,posted,Payroll WFRMS 15439393,10801.51,96587cdb-af6c-4741-994d-127ea71390e2,26058.75,credit,transfer,AU00000,2023-08-22T08:15:22Z
transaction,01e00d3f-eafd-4bc6-8b3c-654426ac5242,posted,Coffee Shop Purchase,-4205.7,687d0e24-bc65-4c70-b1fa-fc0b587cb63c,21853.05,debit,bank-fee,AU00000,2023-05-15T15:44:01Z
transaction,340f898b-263a-4462-9a3a-6dda48211332,posted,Home Improvement Store Purchase,-3551.92,ba9179c7-37ec-421c-8a04-b4a873a96ddf,18301.13,debit,bank-fee,AU00000,2024-03-18T17:02:10Z
transaction,1737f716-655e-42dc-b17c-516a5e433383,posted,Music Streaming Subscription,-4245.08,4168164f-0aec-4d54-8655-69a00da51b6a,14056.05,debit,bank-fee,AU00000,2023-08-09T04:17:30Z
transaction,a28a6c84-bed5-4316-9ad9-a42f3ac94c80,posted,TRANSFER TO JOANNA SMITH CAMPING,-3197.6,52ee9371-0d56-461b-9b54-87e316afd287,10858.45,debit,cash-withdrawal,AU00000,2023-08-15T19:42:40Z
transaction,70bbe023-8b04-47a1-a7e9-3133f2918bc5,posted,Movie Ticket Purchase,-2436.16,a0798355-5f59-4012-bd21-22e855d5bd82,8422.29,debit,cash-withdrawal,AU00000,2024-01-06T06:36:11Z
transaction,e52569d7-08c4-4dc9-88ea-7441b7218171,posted,Public Transport Fare,-2614.89,5a0cf092-3b63-445e-b7c0-4e5c93b0dde0,5807.4,debit,bank-fee,AU00000,2023-07-15T05:18:59Z
transaction,f751da89-f9bc-4284-9d23-d2896a2d824f,posted,Clothing Store Purchase,-460.08,7f1500cf-3341-4b99-93d9-da2c2a6f6e58,5347.32,debit,bank-fee,AU00000,2023-08-23T10:47:07Z
transaction,d1a11a60-963a-4cf7-9d06-2df12012f60d,posted,CTRLINK CARERS Ref: 998R6789201610974V,-3727.73,f3ea2a03-e7a2-4eb1-8ca4-c9512b7119c7,1619.59,debit,cash-withdrawal,AU00000,2023-08-10T10:20:47Z
transaction,21f44722-168f-4b87-842d-f7b09a4656ea,posted,Movie Ticket Purchase,-4253.57,b21800ef-e103-4bfb-b64e-7faa7982a9b5,-2633.98,debit,bank-fee,AU00000,2023-09-03T21:17:28Z
transaction,2dddcd44-5e99-4394-ad0c-947820f3750d,posted,Payroll WFRMS 15439393,11075.76,1ef84fd8-4891-4e2f-8270-fc5ba47e03eb,18180.45,credit,transfer,AU00000,2023-07-31T01:29:48Z
transaction,25d16af7-7a92-4e7e-87ff-a7a746f35637,posted,Online Gaming Purchase,-961.17,24f26666-4fd3-4c0f-9931-9ea356653870,17219.28,debit,bank-fee,AU00000,2024-01-23T01:12:01Z
transaction,f89cac20-77d6-406c-9139-3551e824b6c9,posted,Online Gaming Purchase,-4770.99,323f5b76-a786-49d0-bd69-3f08581c8d9f,12448.29,debit,payment,AU00000,2023-11-26T16:34:08Z
transaction,050b2303-2dd0-4840-9409-30b9186f7225,posted,Wdl ATM WESTPAC IGA BALGOWLAH BALGOWL AU,-3830.5,bac62abf-b8aa-4de3-a902-84361855436f,8617.79,debit,bank-fee,AU00000,2024-03-21T21:25:59Z
transaction,6ca1a716-6b43-4434-be5b-8b4bee9b82fb,posted,Mobile Phone Bill Payment,-2814.33,b1a865e5-3c85-470f-af92-efd6702b020a,5803.46,debit,payment,AU00000,2023-09-18T22:50:55Z
transaction,42b9d3e8-a0bb-45ea-a68c-0d9955311f45,posted,Hair Salon Appointment,-90.82,03d1a3dc-6aea-4609-8ffa-dbd8d2b6f584,5712.64,debit,cash-withdrawal,AU00000,2023-09-25T01:11:59Z
transaction,881a8504-d22e-47e1-ba3e-94bb4b7de9b9,posted,Hair Salon Appointment,-2115.04,ebc6241d-31b3-4dcf-ab03-b8b882ec933c,3597.6,debit,bank-fee,AU00000,2023-10-07T13:47:25Z
transaction,710f6a67-5601-4944-80d9-d66ebf50e7b4,posted,Manly Maths Tutor Wages,-3460.59,ee60121d-113f-4540-82a3-475d3d51b082,137.01,debit,cash-withdrawal,AU00000,2023-06-24T17:18:25Z
transaction,01622352-e56a-482e-b693-338974d224ab,posted,Manly Maths Tutor Wages,-700.12,8dbf9fb5-33c5-4e90-8734-7a343addc59a,-563.11,debit,payment,AU00000,2023-06-27T01:24:08Z
transaction,9a234add-0c50-4f8b-b1b9-fd85b981ec7a,posted,AGL RETAIL ENERGY LTD (GAS),-1798.13,77972c6a-7846-4dc9-9c7e-a24b75767ab7,-2361.24,debit,payment,AU00000,2023-12-05T11:58:02Z
transaction,fbe27c03-b21f-49d8-baad-8643420dbba5,posted,Movie Ticket Purchase,-1902.3,aa67f087-fd93-4401-a718-bff21285536c,4793.64,debit,cash-withdrawal,AU00000,2024-04-09T02:20:45Z
transaction,2128ce02-d30e-4a29-874c-857b49dbb3dc,posted,Pharmacy Purchase,-3415.47,d4f377fc-4353-4c14-8a2c-2dab8676a985,1378.17,debit,cash-withdrawal,AU00000,2023-06-20T13:38:51Z
transaction,276b9476-3184-488c-a4d2-32554c9fe5e9,posted,Travel Agency Booking,-1412.18,a3e8f44a-c3e7-4ae5-b42f-e8b1162494d0,-34.01,debit,bank-fee,AU00000,2023-09-13T00:18:27Z
transaction,98075392-fa11-415e-b998-4ac97e6212fc,posted,Pharmacy Purchase,-788.64,08fb26c6-344a-4a7d-848e-8ec7e3241cc7,-822.65,debit,payment,AU00000,2023-06-13T18:06:55Z
transaction,4e710bc1-e745-472a-908f-6ab905df66cd,posted,Non Hooli ATM Withdrawal Fee,-2341.27,525199ec-bb1d-4b54-b641-1a89c7acfb6b,-3163.92,debit,bank-fee,AU00000,2024-01-06T15:17:24Z
transaction,ba0ccfd2-b819-4a04-9fb2-aecbc539a160,posted,Wdl ATM WESTPAC IGA BALGOWLAH BALGOWL AU,-3589.03,440e3db6-ca11-4f6d-babb-46adf8952ae9,-6752.95,debit,cash-withdrawal,AU00000,2024-02-25T21:11:00Z
transaction,0ac9288c-19ba-45ec-927c-2efe948df3fe,posted,Electricity Bill Payment,-2900.91,c537ab81-c765-4f31-933f-018f4e2690ac,-9653.86,debit,cash-withdrawal,AU00000,2023-06-28T21:42:54Z
transaction,f89699f0-fcb3-40bd-81be-b23b4ce62154,posted,Non Hooli ATM Withdrawal Fee,-2200.45,8fb4c21f-9ea5-4b17-a56f-580d3319ea8c,-11854.31,debit,cash-withdrawal,AU00000,2023-07-03T06:16:39Z
transaction,7e0f5918-6fc7-48da-be49-fae2738666cd,posted,Home Improvement Store Purchase,-1524.54,cf637f7d-2485-408d-a7d5-8ae6a0f7cb5c,-13378.85,debit,payment,AU00000,2023-10-19T15:49:53Z
transaction,21075c44-983b-40dc-9fcf-4e9c03c0e1a9,posted,Movie Ticket Purchase,-3008.07,dd85f80c-cf03-4448-949d-d722b59e8072,-16386.92,debit,bank-fee,AU00000,2023-11-07T09:32:26Z
transaction,f6f32a4c-8d63-4ee4-b0ba-10d8950ac0cf,posted,Payroll WFRMS 15439393,10330.44,26ad9939-a506-4738-88ef-0633d5e0c914,20878.45,credit,transfer,AU00000,2024-04-17T12:59:40Z
transaction,285602d9-fcf5-4404-8b7c-586a6d7d1ad7,posted,Netflix Subscription,-4125.71,1cf8351b-4057-4a05-b880-4f7ba32648a4,16752.74,debit,bank-fee,AU00000,2024-03-27T23:54:51Z
transaction,0b401927-654a-4382-a1e9-df2c18275aef,posted,Gym Membership Fee,-3705.16,072b5739-df1d-447c-ac58-2bc74bbfc317,13047.58,debit,payment,AU00000,2024-04-28T02:53:45Z
transaction,9202fb21-2ef1-4e78-a034-559c2d1b41d9,posted,TFR Acc14000 TO 12389,-2029.48,d05b0ed3-ff42-4e19-92d9-9a7f3e598a3c,11018.1,debit,cash-withdrawal,AU00000,2023-10-05T19:44:22Z
transaction,f2f84fe7-b88d-42b8-9eb6-5b92670ece4f,posted,AGL RETAIL ENERGY LTD (GAS),-1477.34,3266b619-75c1-496f-872c-f87bf5d98359,9540.76,debit,bank-fee,AU00000,2024-01-27T01:59:31Z
transaction,9da92175-cde3-405e-a204-71ad95b2143e,posted,Manly Maths Tutor Wages,-2038.01,f166b88c-96a7-4fe6-a443-2742d7afeea5,7502.75,debit,bank-fee,AU00000,2023-10-18T08:51:09Z
transaction,590e1293-60f9-4b3c-9806-89a16693ae05,posted,CTRLINK CARERS Ref: 998R6789201610974V,-2536.27,cb918318-7ab4-46d3-91df-832343c7b4bc,4966.48,debit,cash-withdrawal,AU00000,2024-03-21T06:05:18Z
transaction,5242c198-373f-4e8e-96d6-b4cc74f19142,posted,Payroll WFRMS 15439393,10977.88,dcb35070-f0ed-4a8a-a700-9d6648b4a06e,15944.36,credit,transfer,AU00000,2024-02-04T21:12:49Z
transaction,333183ec-95dc-41cc-95be-54fd7a33b463,posted,Pharmacy Purchase,-4542.95,7de21cb8-a8f6-416f-820c-1aea5f7e9ec8,11401.41,debit,bank-fee,AU00000,2023-06-27T12:40:03Z
transaction,b55a9492-d489-43d5-a085-f67de5a4c405,posted,Car Maintenance Expense,-3055.48,e60b8809-1867-490c-8a17-d5a56262108d,8345.93,debit,payment,AU00000,2023-05-31T15:35:44Z
transaction,2c673317-b8b5-4a54-9644-4010e563840a,posted,Movie Ticket Purchase,-2786.72,01be1028-7bc0-4eec-b4e3-06fc792d2a75,15205.72,debit,payment,AU00000,2023-11-14T07:33:53Z
transaction,1e4f96a9-f540-48b9-9ea7-151d2e28fa8f,posted,Electricity Bill Payment,-965.76,29df9b25-3c3d-434a-91aa-ef69f482990a,14239.96,debit,cash-withdrawal,AU00000,2023-09-13T04:21:05Z
transaction,81577268-f36c-4677-b623-ecbf95e15568,posted,Restaurant Dinner,-3814.74,c5918295-ee6e-482b-a161-3ab8648e98f8,10425.22,debit,cash-withdrawal,AU00000,2024-01-31T18:02:53Z
transaction,d1d35345-3b29-44e0-8194-43a5d1aa94a6,posted,Public Transport Fare,-806.81,6300442f-962b-4bfe-907b-0a355b6f202d,9618.41,debit,cash-withdrawal,AU00000,2023-09-12T08:15:31Z
transaction,e4ad4d6c-b8f5-4f91-a984-eefb85fa74eb,posted,Netflix Subscription,-4837.04,cf16f614-8874-43cb-9bff-618eb612cfba,4781.37,debit,bank-fee,AU00000,2023-10-24T02:49:34Z
transaction,824cd3af-b6d9-4123-92ac-a0392bcc8077,posted,Travel Agency Booking,-84.83,40ecfd83-91ef-4b62-9054-9968b3400009,4696.54,debit,payment,AU00000,2024-05-08T12:12:38Z
transaction,2119d1a4-abad-4491-b028-83201666ba23,posted,Netflix Subscription,-14.6,aa6b4591-d67e-4066-bcde-e8c3304aabd8,4681.94,debit,bank-fee,AU00000,2023-11-19T13:10:17Z
transaction,00cfa1fe-f2c1-4cdc-a5c8-f8d2c262cefd,posted,Travel Agency Booking,-4381.26,1b499b69-b58c-496b-8c33-88476fbf90d5,300.68,debit,payment,AU00000,2024-03-04T12:17:48Z
transaction,0a250a30-6d21-499e-ba69-c1c3c45a5c70,posted,TFR Acc14000 TO 12389,-3234.95,968311b0-800c-4e7f-9ddc-0d03ba99a138,-2934.27,debit,cash-withdrawal,AU00000,2024-03-09T15:33:45Z
transaction,77c364ec-834f-42d5-8afd-4a3d34b791f9,posted,Gym Membership Fee,-1346.99,e9f94779-564d-49f7-b014-aca33cc1f40f,-4281.26,debit,bank-fee,AU00000,2023-08-20T01:27:07Z
transaction,ec3f61c5-df31-4c5e-a0db-4e07b1a7252e,posted,Online Gaming Purchase,-828.71,1312f5db-f786-4920-96dc-cde3b8ef13c1,17384.65,debit,cash-withdrawal,AU00000,2023-12-02T11:40:14Z
transaction,7462f16f-c541-4a22-b84d-d2f41cede659,posted,Netflix Subscription,-1121.22,4ad982ef-2171-4628-b04c-77510fb10624,16263.43,debit,payment,AU00000,2023-11-17T00:18:01Z
transaction,83af2a69-5d65-4b91-a30f-28bfe7a890f8,posted,Restaurant Dinner,-2586.8,5d518d37-56f3-49cd-9b13-59eec7b3f8c5,13676.63,debit,bank-fee,AU00000,2023-09-05T23:26:07Z
transaction,4d0e00b0-e540-49b5-a914-117002a8a54b,posted,Manly Maths Tutor Wages,-4924.84,ba47dd41-d590-4a55-b1cf-99dc68e132d7,8751.79,debit,payment,AU00000,2024-01-06T23:05:48Z
transaction,c6b75b6b-1091-426f-99b7-681a074712a4,posted,Wdl ATM WESTPAC IGA BALGOWLAH BALGOWL AU,-3167.3,52f909ef-5b22-44d5-bb94-49d7d183fe65,5584.49,debit,payment,AU00000,2023-10-18T21:16:49Z
transaction,1c291f3b-cb49-45eb-a684-b89348da6f05,posted,Amazon Online Shopping,-93.81,73c5c2b2-6342-4ebe-b386-f209865074ff,5490.68,debit,bank-fee,AU00000,2024-02-16T06:38:41Z
transaction,78a9bd90-639b-442b-9ad6-dab82af0d758,posted,AGL RETAIL ENERGY LTD (GAS),-67.01,4bd25c03-4be5-47bb-bf80-807b4096471e,5423.67,debit,payment,AU00000,2023-07-20T20:10:11Z
transaction,d8c6c9ea-82cd-4806-aa23-4110e078b426,posted,Clothing Store Purchase,-3642.49,8bd0ca5a-074b-406e-a97f-87a71b5df17d,1781.18,debit,bank-fee,AU00000,2024-01-13T08:22:10Z
transaction,4ae7f2e7-b2ef-4985-a217-5ea67571d533,posted,TFR Acc14000 TO 12389,-2986.81,a3045082-e1e1-42d1-ab30-d7fff40be3de,-1205.63,debit,cash-withdrawal,AU00000,2023-09-16T11:04:42Z
transaction,00ba687e-9c6f-43a1-98ae-8baa92ad9faa,posted,Online Gaming Purchase,-647.23,1d84634a-ccf2-460c-b612-ca189fc7a6fa,-1852.86,debit,bank-fee,AU00000,2023-10-11T22:27:11Z
transaction,50588548-cafe-4bc5-9232-339117f90f73,posted,Non Hooli ATM Withdrawal Fee,-264.87,4d926aff-750d-4c3c-91fb-99dbddbfaaa1,18275.87,debit,payment,AU00000,2024-05-03T18:46:42Z
transaction,61240307-ae6e-48eb-a0d5-e4a3d2916dbc,posted,Non Hooli ATM Withdrawal Fee,-1732.08,2327c82a-366b-4663-a6fd-611418313ddd,16543.79,debit,bank-fee,AU00000,2023-11-17T11:24:56Z
transaction,f9b152ec-9fc9-4432-83ff-4c311c6840be,posted,Uber Ride,-267.75,3fa973b0-d807-494a-aee8-7447eb338ec8,16276.04,debit,bank-fee,AU00000,2024-04-03T19:11:09Z
transaction,b8a18d81-5b22-4ee8-abef-931a71df6054,posted,Uber Ride,-4634.76,62aefe89-1dbb-4f57-abc4-930c51ea9c11,11641.28,debit,cash-withdrawal,AU00000,2023-11-17T07:21:48Z
transaction,e0e74fe8-d0c7-4954-8019-3b5f308d0a6d,posted,Non Hooli ATM Withdrawal Fee,-4680.05,8eaf4833-5c39-464c-a865-5b87f46dfd63,6961.23,debit,cash-withdrawal,AU00000,2024-03-14T19:01:38Z
transaction,cb691cd5-ad2b-49df-9acd-95171445fa53,posted,Music Streaming Subscription,-784.51,d723ddf8-c1c0-4c57-b374-83420e6d8c11,6176.72,debit,payment,AU00000,2024-02-12T17:28:20Z
transaction,333873ad-c380-45ee-9499-51f26cfc2e63,posted,Wdl ATM WESTPAC IGA BALGOWLAH BALGOWL AU,-1462.48,90d73f8d-3626-4405-b7be-09066e2e5715,4714.24,debit,payment,AU00000,2023-06-05T12:16:44Z
transaction,d9f99d79-3d7e-4648-89c8-67a02a5fc382,posted,Payroll WFRMS 15439393,11370.6,121b8ad7-d5e1-4f70-b878-e102edc42cb6,16084.84,credit,transfer,AU00000,2023-05-16T00:28:57Z
transaction,c6f2dd5f-394b-429f-a454-a6092069abea,posted,Payroll WFRMS 15439393,10865.77,00651fa9-807d-4b30-9546-90083b688632,26950.61,credit,transfer,AU00000,2024-03-18T22:21:56Z
transaction,49cdfa9a-1993-441a-b84a-d8b846a0c5f3,posted,Hair Salon Appointment,-4278.28,0a500b20-094e-46b5-a309-4c8d2758cf10,22672.33,debit,payment,AU00000,2023-07-19T04:56:43Z
transaction,28e9e40b-7631-4caf-b55b-046e09da51e7,posted,Restaurant Dinner,-4867.56,e71ad5bf-e65d-4de1-a428-8681adead023,6996.02,debit,cash-withdrawal,AU00000,2023-08-02T08:33:48Z
transaction,0c8e11d9-c2d5-475e-a2c3-513dbf67f2d6,posted,Gym Membership Fee,-4565.5,b52e5fe4-d8b5-400a-b209-edf492261cb7,2430.52,debit,cash-withdrawal,AU00000,2024-01-25T10:55:07Z
transaction,bb8624e4-a224-4d12-b2e2-0ca54697b830,posted,Gym Membership Fee,-4939.68,62660e85-4704-4955-9985-aa3578bf4221,-2509.16,debit,payment,AU00000,2024-02-01T21:49:20Z
transaction,8cf1331e-7da3-46b4-8e28-29ec86ccac6a,posted,Uber Ride,-1153.24,652b7954-d78d-4fc3-814c-ed52e71e1ede,-3662.4,debit,bank-fee,AU00000,2023-08-27T03:11:18Z
transaction,efb477dd-3858-49f7-afb4-2982fd53634b,posted,Amazon Online Shopping,-2384.43,27700dbe-5e60-432e-abd7-0a2ada549d23,-6046.83,debit,cash-withdrawal,AU00000,2023-09-27T14:24:47Z
transaction,49abdbc3-34b8-44ac-ac6d-53739e842ebf,posted,Gasoline Purchase,-322.24,cf55fd3c-82d0-4a2a-882c-0e4096b4df16,-6369.07,debit,cash-withdrawal,AU00000,2023-12-28T07:06:19Z
transaction,b162c891-11e0-4cfb-b1db-e43ca8c9b7eb,posted,Home Improvement Store Purchase,-3785.17,178d4c38-2b92-464d-9915-c33643e14367,-10154.24,debit,payment,AU00000,2023-10-30T14:21:44Z
transaction,0b37d8d3-c62e-4fa6-96e2-d49accca9110,posted,Manly Maths Tutor Wages,-2390.28,b7dd389d-94ac-4aac-814d-9580960b2ccf,-12544.52,debit,bank-fee,AU00000,2023-06-01T07:47:03Z
transaction,6d821487-151d-4693-9082-9d8af0db7474,posted,Wdl ATM WESTPAC IGA BALGOWLAH BALGOWL AU,-1207.34,7516fa55-5c9a-4ac3-9a3d-a790ee0b4de3,-13751.86,debit,payment,AU00000,2024-04-24T09:19:10Z
transaction,977a2ff4-d79e-4c2e-bc60-1a0c817c9154,posted,Gasoline Purchase,-2881.32,844c49af-888b-42ec-a795-3434d154ed64,-16633.18,debit,bank-fee,AU00000,2024-03-06T21:31:01Z
transaction,99cbefdd-1345-410f-82eb-b184c9b65882,posted,Coffee Shop Purchase,-4450.72,1d92f999-2d2b-4f15-bd9f-3234eb452034,11153.9,debit,payment,AU00000,2023-08-04T10:09:11Z
transaction,8e5e9392-6e60-415a-8522-761c52e9c8d2,posted,Movie Ticket Purchase,-2778.83,3a2e8623-82f8-4c73-a6af-3a8afdb6252d,8375.07,debit,bank-fee,AU00000,2024-04-01T02:46:37Z
transaction,4617523a-9b10-4bc7-882d-69ae7e3aa556,posted,Wdl ATM WESTPAC IGA BALGOWLAH BALGOWL AU,-4391.12,b2e2cee3-3f25-469d-8763-6a1d0f713afc,3983.95,debit,bank-fee,AU00000,2024-01-31T09:04:17Z
transaction,2caebcd8-b421-428a-8649-7873f56f7049,posted,Wdl ATM WESTPAC IGA BALGOWLAH BALGOWL AU,-4815.47,0a5cabfb-7ba4-4420-8a0a-e0ee08e0ad82,-831.52,debit,cash-withdrawal,AU00000,2024-01-02T07:23:06Z
transaction,b14b2ada-b441-44a6-9899-f3a0b38c086a,posted,Uber Ride,-3956.86,d6dad73f-c0b5-4965-abff-97319dd92ad5,-4788.38,debit,bank-fee,AU00000,2023-08-15T05:29:58Z
transaction,24ab9dab-4e11-4c43-9f89-b62af6f701db,posted,Hair Salon Appointment,-1574.38,9704e206-961a-423e-862d-6fc6454e4ef5,-6362.76,debit,cash-withdrawal,AU00000,2023-10-11T10:43:20Z
transaction,598ce809-bd50-424f-90ec-534818f0e028,posted,Electricity Bill Payment,-3857.19,0a679b26-1936-40e0-a062-3ef20a5e8585,-10219.95,debit,bank-fee,AU00000,2023-09-20T21:56:30Z
transaction,7a6c6f86-92bf-491c-b375-b060d0e1eaa5,posted,AGL RETAIL ENERGY LTD (GAS),-3703.35,784c0ea6-d57a-41d5-80b4-e362734b2609,-13923.3,debit,payment,AU00000,2023-05-12T05:39:50Z
transaction,026266aa-b5bb-490a-afa8-f1674ef85ff2,posted,Mobile Phone Bill Payment,-307.62,7c8b3147-42b1-47e7-8fa7-9e28625a57ca,-14230.92,debit,cash-withdrawal,AU00000,2023-09-08T23:00:35Z
transaction,c80d5cd6-9623-4241-a2e9-29df774f09a2,posted,Uber Ride,-573.03,7a98f830-259a-4ffd-9611-05c1f1fd0927,-14803.95,debit,cash-withdrawal,AU00000,2023-08-14T07:32:39Z
transaction,2a3b5868-2503-4e85-b73b-b13a3da3b7a1,posted,Manly Maths Tutor Wages,-2765.61,16beb71a-f035-469b-8eed-0da1157c4e37,10399.63,debit,cash-withdrawal,AU00000,2023-12-27T05:02:45Z
transaction,367e2bb1-56e2-44c8-b8ec-f0d34c001759,posted,Online Gaming Purchase,-230.7,13bacb7a-d5c7-47e4-aaf5-9db6edf9384e,10168.93,debit,cash-withdrawal,AU00000,2024-02-15T12:07:45Z
transaction,b901f5c4-fe10-4790-b45f-c50fa766fc95,posted,TRANSFER TO JOANNA SMITH CAMPING,-593.75,afc12df4-511f-4f95-be33-83655970c00b,9575.18,debit,payment,AU00000,2024-04-22T13:46:53Z
transaction,0f9cf041-9cd8-4254-ad4d-7a51381f23b2,posted,Coffee Shop Purchase,-1661.6,87c2d538-100c-4a63-b034-694f53eca620,7913.58,debit,cash-withdrawal,AU00000,2024-03-28T12:43:53Z
transaction,227d76b8-a84d-4eac-9c89-ff38f0d7f5d7,posted,Amazon Online Shopping,-1083.11,d33ec9e2-4b47-4df3-9553-de7ed66dfcc5,6830.47,debit,cash-withdrawal,AU00000,2023-06-27T05:53:37Z
transaction,e6eab31b-6d5a-43bf-a3f6-737ba7dd9d21,posted,Amazon Online Shopping,-1641.5,1ff60c28-acc3-46a6-9d09-94ad50711cad,5188.97,debit,payment,AU00000,2023-09-09T02:28:32Z
transaction,1845e550-568e-4905-8bfc-2de565687cdc,posted,Restaurant Dinner,-1501.37,13fc6d12-e791-4f30-b2ff-5162e44ab9e6,3687.6,debit,cash-withdrawal,AU00000,2023-06-20T00:39:28Z
transaction,5dadc52c-ccbd-4ee5-a3c2-43042c799b16,posted,Online Gaming Purchase,-387.08,195c36b1-3724-47fe-a87e-0a39a3e3dcba,3300.52,debit,cash-withdrawal,AU00000,2023-12-01T12:42:36Z
transaction,dbc2c345-a669-48ab-b571-61fef8975fab,posted,Gasoline Purchase,-1409.45,421e804c-5706-4613-9b48-0681f8257956,1891.07,debit,cash-withdrawal,AU00000,2023-05-25T17:45:56Z
transaction,25afe074-c030-4e58-9137-007f1f65365c,posted,Transfer Platnm Homeloan 346454,-1922.35,914a10ab-7fab-4100-a2a2-047a1af000fb,-31.28,debit,bank-fee,AU00000,2024-02-22T15:56:21Z
transaction,cf05da89-4270-45ad-a7c1-e095f18576fc,posted,TRANSFER TO JOANNA SMITH CAMPING,-4286.95,f9f0d65d-45e5-4b56-b729-4a66db22558a,11465.83,debit,payment,AU00000,2023-09-17T16:59:22Z
transaction,85f3f0ea-7a29-4995-a072-dfb1dfc32b4c,posted,Travel Agency Booking,-2282.67,aa0e2210-0b8d-4c6a-b6a1-dab1c8aa9853,9183.16,debit,bank-fee,AU00000,2023-11-25T18:46:26Z
transaction,0f713280-de0b-402c-a730-c630fcb5d179,posted,Manly Maths Tutor Wages,-2900.29,61dc844d-025f-465f-9277-2fca8105c3be,6282.87,debit,bank-fee,AU00000,2024-01-20T08:41:30Z
transaction,f23dabbe-24de-44a1-9309-42e1596db2e6,posted,Home Improvement Store Purchase,-532.36,4e909105-72a5-49d0-b1bc-3e9f9e7ca8e6,5750.51,debit,payment,AU00000,2023-08-28T10:37:57Z
transaction,b2352550-a4c7-49d2-a092-2d70b9ab86dc,posted,Gasoline Purchase,-770.8,2ad4b70c-799a-44cd-9873-cc61e22b49cf,4979.71,debit,cash-withdrawal,AU00000,2024-03-09T09:56:56Z
transaction,221fd600-7f0f-485a-8530-0038555e9fc0,posted,Gym Membership Fee,-2087.71,f6ee2fbd-f2b6-4d58-9af5-7f04345d3ef1,2892.0,debit,payment,AU00000,2023-11-28T22:26:52Z
transaction,33a80ad5-bf4a-448b-bd95-22ea24b561d5,posted,Transfer Platnm Homeloan 346454,-417.11,5906fba8-c687-4c70-bdf6-1cd699dba579,2474.89,debit,payment,AU00000,2023-12-15T11:06:34Z
transaction,c8002041-6944-4996-8d52-76d4cfef952a,posted,Netflix Subscription,-1725.7,48839a8e-0539-4849-a5f9-5cee831bfdc8,749.19,debit,cash-withdrawal,AU00000,2023-06-11T16:35:27Z
transaction,798e20c3-080c-4c16-aa72-0098afe77dee,posted,Wdl ATM WESTPAC IGA BALGOWLAH BALGOWL AU,-3782.16,472e6525-72f2-4503-8571-8d65e8278333,-3032.97,debit,bank-fee,AU00000,2023-07-17T10:44:09Z
transaction,6db26380-9854-4b83-8e7a-1ce0f0c4e873,posted,TRANSFER TO JOANNA SMITH CAMPING,-1894.74,3254c399-4aff-4aef-98a8-070e0e2d742f,-4927.71,debit,bank-fee,AU00000,2024-02-18T16:29:48Z
transaction,9a890075-86c6-4739-a831-4a7b7113f740,posted,Music Streaming Subscription,-1376.71,d0900899-d9f3-40f0-aa88-506305bdb9c7,3931.96,debit,bank-fee,AU00000,2023-10-26T05:06:14Z
transaction,181c054f-19e4-45df-955a-8a129cc0af47,posted,Restaurant Dinner,-1268.56,8c7b860d-8590-47a7-8786-75a0bc8fd8f4,2663.4,debit,cash-withdrawal,AU00000,2024-01-16T10:07:33Z
transaction,409206a2-3de2-4f92-85f6-711ae27d8fe5,posted,Uber Ride,-3914.37,f6a53e5c-42f3-4081-86ab-57594695ce73,-1250.97,debit,payment,AU00000,2023-06-10T06:53:16Z
transaction,a038cc18-41f8-4913-871f-448424b070f6,posted,Travel Agency Booking,-1268.79,f334747b-88cd-48a4-8dd1-225c4ede5614,-2519.76,debit,bank-fee,AU00000,2023-10-09T02:56:02Z
transaction,54da650a-0f9e-4098-9fd3-50629f6b0904,posted,Non Hooli ATM Withdrawal Fee,-2616.28,ea65c783-57a6-4c48-82d3-9c331aea1982,-5136.04,debit,payment,AU00000,2024-01-10T06:14:18Z
transaction,2d5b0814-eb9d-40f4-b010-381ebca9e6f6,posted,Gym Membership Fee,-1610.76,d438fe4b-3c42-41b0-a740-4d8cd89a8f65,-6746.8,debit,bank-fee,AU00000,2023-09-11T03:44:58Z
transaction,5fdd1daf-aacf-46f7-96b8-dbd5f2e619a2,posted,Amazon Online Shopping,-2449.96,daea39f9-df7d-4e60-9e49-177ef1bd25cd,-9196.76,debit,bank-fee,AU00000,2024-02-22T18:51:16Z
transaction,8f3592e6-97a5-4c4e-add3-07ff7e5c89a4,posted,Netflix Subscription,-4256.27,4f64a661-7c60-4a0a-a7a1-dbdec7669c34,-13453.03,debit,payment,AU00000,2023-06-04T07:42:30Z
transaction,d603aaba-abe0-4602-b2c3-c7e3862860b7,posted,Non Hooli ATM Withdrawal Fee,-4893.81,e1bec9c4-9cf0-4bce-bd3d-925f0d7a4c3b,-18346.84,debit,cash-withdrawal,AU00000,2023-06-27T21:20:29Z
transaction,909ce19a-9a65-4e67-bddc-77f2dcc90e4d,posted,Non Hooli ATM Withdrawal Fee,-4648.46,be84bf39-eadf-4b0a-8bdd-b78e42560b45,-22995.3,debit,payment,AU00000,2023-09-19T03:23:25Z
transaction,759573b7-0dcb-4c4d-b1ce-8327d21f7e73,posted,Gym Membership Fee,-175.17,21dc2c30-0aae-41b2-92aa-085271a406c2,17837.3,debit,cash-withdrawal,AU00000,2023-11-10T20:06:53Z
transaction,d8bfdda3-34ec-44c2-9e14-733dd0af4eb8,posted,Hair Salon Appointment,-1695.28,f0d6d361-8d05-4994-b771-8cf4a7377397,16142.02,debit,payment,AU00000,2024-04-24T03:57:20Z
transaction,4702d724-b734-484e-9b2f-cc0b0e5db076,posted,TFR Acc14000 TO 12389,-3277.92,d0b0fddf-7e62-4366-8f02-0726b2440c1d,12864.1,debit,payment,AU00000,2023-11-18T10:46:58Z
transaction,cb40f9bf-ce37-4cd7-a830-6997e8f4d8bb,posted,Travel Agency Booking,-3249.73,55d52c58-ee46-4398-97f0-854e2f48b3f8,9614.37,debit,payment,AU00000,2024-02-29T14:37:37Z
transaction,22a5fb83-dad2-4455-8d5d-cc1a2888c56d,posted,Wdl ATM WESTPAC IGA BALGOWLAH BALGOWL AU,-830.71,80253bd3-d1fa-4d63-9fc0-bc6c39bb763a,8783.66,debit,cash-withdrawal,AU00000,2023-09-21T14:39:10Z
transaction,c8b8bc92-b753-49f8-ae21-64b626989aef,posted,Hair Salon Appointment,-4721.29,36a2bd46-5b57-497e-89bb-d20e54231c0c,4062.37,debit,cash-withdrawal,AU00000,2023-10-30T20:33:56Z
transaction,6e18c775-6153-4314-bf8c-fbf31f497b2e,posted,Netflix Subscription,-3012.87,fd235c86-9a28-42d5-90f1-97407c917069,1049.5,debit,bank-fee,AU00000,2024-03-18T11:21:00Z
transaction,8fdda3b3-e4cc-4b76-a319-a4ad7403cafd,posted,Music Streaming Subscription,-245.49,4f2fb3a6-b334-40ec-8174-8bd0b20dc257,804.01,debit,payment,AU00000,2023-08-19T14:20:31Z
transaction,9e65c58a-4193-434e-b20b-74aaf028030d,posted,Online Gaming Purchase,-942.24,9c33a460-95d1-4049-b878-e9cf958b7163,-138.23,debit,cash-withdrawal,AU00000,2023-07-20T04:10:35Z
transaction,736df0df-f7db-4b3f-9c5f-9fed074513b3,posted,AGL RETAIL ENERGY LTD (GAS),-4858.46,ca6679b0-163b-4378-bfa8-b6ed9506d481,-4996.69,debit,cash-withdrawal,AU00000,2023-10-24T02:13:35Z
transaction,64a22655-bb49-4048-bdad-b2f002d5e78b,posted,CTRLINK CARERS Ref: 998R6789201610974V,-2611.0,1d199288-1446-461f-8edd-ce1ef02d8aaf,14125.49,debit,cash-withdrawal,AU00000,2024-01-26T17:34:46Z
transaction,48988751-dceb-428d-ace9-27fd13081fb6,posted,Travel Agency Booking,-2442.61,6ace145f-4c6a-485b-bf38-64e452e487ad,11682.88,debit,bank-fee,AU00000,2023-06-25T07:14:30Z
transaction,126aa7b1-31ba-4177-8d6c-a84d2d74227e,posted,Gasoline Purchase,-1333.06,5a6cf7a4-8658-4273-83c4-a0517409fa3f,10349.82,debit,payment,AU00000,2024-03-29T05:20:34Z
transaction,27efedc6-71a7-4c74-91db-9815799feb5e,posted,Payroll WFRMS 15439393,11870.46,fcf42c15-230b-4d8d-b32c-2a0f633fa71c,22220.28,credit,transfer,AU00000,2023-07-30T06:34:49Z
transaction,cfbe8333-40ba-4f18-bc2c-ad05ffc3011e,posted,Pharmacy Purchase,-4155.88,b95794c9-682a-49b6-bd37-5eca79ea7b3a,18064.4,debit,payment,AU00000,2023-11-06T11:54:07Z
transaction,d7c6ec29-1b96-453b-846e-43fec319692b,posted,Payroll WFRMS 15439393,10086.16,706c76c7-302e-4cd5-9cf2-c5c9446f0703,28150.56,credit,transfer,AU00000,2024-01-04T20:14:40Z
transaction,05323d2b-e3c2-44eb-a83a-f5de65d327ae,posted,Travel Agency Booking,-932.81,7243ac10-bd35-4388-bebc-dca5c360bac9,27217.75,debit,bank-fee,AU00000,2024-04-27T12:35:32Z
transaction,7a62f4bd-4f2d-4b30-b2ba-dce914b67f3f,posted,Travel Agency Booking,-3833.48,38a401c9-7ec6-4a79-a121-b8a0471bba79,23384.27,debit,cash-withdrawal,AU00000,2023-10-27T22:46:30Z
transaction,89db1de9-e9c6-44f0-ba70-5f3c83828642,posted,CTRLINK CARERS Ref: 998R6789201610974V,-2215.81,a820dac9-402f-43b8-95d5-2091587fa6cb,21168.46,debit,payment,AU00000,2023-12-04T21:58:10Z
transaction,b1806e05-a3bd-470d-bb43-7174e27d02da,posted,Movie Ticket Purchase,-1342.98,c4aef568-2488-4c9d-b99c-62a15997de65,19825.48,debit,cash-withdrawal,AU00000,2023-09-07T07:33:45Z
transaction,f6156184-9aba-40c2-8ea7-d5e86b3958f1,posted,Clothing Store Purchase,-3682.85,c756f788-3aa0-4444-bc83-71e8985daafc,3577.17,debit,payment,AU00000,2023-08-22T13:18:42Z
transaction,cae5f0b1-dec8-475c-bd28-5b2ae3d7dfd2,posted,Netflix Subscription,-1143.14,be4cfb2b-1d0f-402e-a82f-e8cff538f7cb,2434.03,debit,payment,AU00000,2023-09-22T09:40:05Z
transaction,1a723e49-2888-4aba-8b35-059ed4bf73ef,posted,Travel Agency Booking,-3707.28,178a7558-318f-4ce2-8eb6-571dcad309d8,-1273.25,debit,payment,AU00000,2023-11-26T01:28:20Z
transaction,044a7062-f366-4d79-8d90-c7c57fb6fd07,posted,CTRLINK CARERS Ref: 998R6789201610974V,-1349.02,cbf00af2-35cb-4ca3-8b14-db3505a9f34a,-2622.27,debit,cash-withdrawal,AU00000,2023-10-16T09:54:33Z
transaction,19c24b5f-78b3-4286-b690-fb49aecf428b,posted,Home Improvement Store Purchase,-132.09,dc349515-1da7-4053-bd80-b60d2d931827,-2754.36,debit,cash-withdrawal,AU00000,2023-06-25T18:44:00Z
transaction,2f317277-fc8c-46b7-924a-d4338d228b7a,posted,Clothing Store Purchase,-4495.39,6e4a3482-4cbd-486f-bf2c-670bad58eefd,-7249.75,debit,bank-fee,AU00000,2024-05-07T20:10:52Z
transaction,63563478-4e4f-40c8-bf36-8faacd4e46ef,posted,Music Streaming Subscription,-4744.96,4b34458e-3d1d-4d9e-aaaa-8b7524edb485,-11994.71,debit,payment,AU00000,2023-10-29T01:21:24Z
transaction,efefebf9-e3be-40d4-a603-f8e3aee36ff9,posted,Travel Agency Booking,-398.14,0ef9db30-6920-4b98-ac64-e4214a425a01,-12392.85,debit,bank-fee,AU00000,2023-12-15T06:44:20Z
transaction,723d0629-2d01-492d-93d8-c0038cb939c0,posted,Transfer Platnm Homeloan 346454,-1530.24,2cb3f754-bbb0-469b-92a3-0d9296d6b8ae,-13923.09,debit,cash-withdrawal,AU00000,2023-06-04T21:39:26Z
transaction,9cc083be-cd7d-47d7-9826-cc8eabb51c63,posted,TRANSFER TO JOANNA SMITH CAMPING,-1584.85,8cbc66d9-42fd-4cfe-b983-d9940d90cb36,-15507.94,debit,cash-withdrawal,AU00000,2023-09-28T16:34:10Z
transaction,4ad3177a-db5d-44a4-9be9-7dfd10a3c1d2,posted,Restaurant Dinner,-1866.59,b0b69e1d-ad66-4bcd-a012-5208196c8ce4,7589.01,debit,cash-withdrawal,AU00000,2023-09-08T19:40:07Z
transaction,f8dfcfff-5bc5-4d4f-b60a-f46e73ce2f3c,posted,Travel Agency Booking,-3864.4,565a22a3-a0f7-478a-aa93-c558db985fdf,3724.61,debit,cash-withdrawal,AU00000,2023-12-06T04:06:09Z
transaction,4be9e3f1-1930-482c-a16f-338849f977fd,posted,Coffee Shop Purchase,-1798.01,f36353cf-c36d-4bd7-ac59-9212daf6be6c,1926.6,debit,bank-fee,AU00000,2023-12-14T08:41:00Z
transaction,a6a3b61c-2d1d-43f0-8ddf-0cf97be0afb9,posted,Movie Ticket Purchase,-4513.19,e2f196d4-da6a-4cd4-bb47-1ada923846bf,-2586.59,debit,bank-fee,AU00000,2023-06-04T14:56:58Z
transaction,30803c3f-340a-4711-8f47-93aa59b07c21,posted,Bookstore Purchase,-3636.45,ec1bcd23-abec-418e-87ee-d9c6400f58a7,-6223.04,debit,payment,AU00000,2023-10-25T22:02:13Z
transaction,b8c19d71-59f2-415d-8760-a62ac407450a,posted,Manly Maths Tutor Wages,-2092.62,04a4ac15-cf54-4fbd-aa65-b15f2f04b7ed,-8315.66,debit,payment,AU00000,2023-08-16T11:51:33Z
transaction,6f57c99d-fc4f-4aa8-bbac-a45d3de10be8,posted,Uber Ride,-2697.83,2235767e-0617-4a0b-8e95-a5f59fea8a69,-11013.49,debit,bank-fee,AU00000,2023-06-11T16:41:58Z
transaction,eeb89f70-d28d-4da7-b387-3327a80239c8,posted,Hair Salon Appointment,-4190.15,ad499553-8db8-43f3-8ddd-8ab68ab1b21a,-15203.64,debit,bank-fee,AU00000,2023-10-30T17:29:29Z
transaction,99da15ba-2ba8-42d9-88aa-cb6be6cea4e9,posted,Electricity Bill Payment,-3721.26,4be524cb-d14a-4b3f-8b36-764ecfa98851,-18924.9,debit,payment,AU00000,2023-09-16T11:02:44Z
transaction,d66d87f7-798e-43e9-b936-649c9065823d,posted,Bookstore Purchase,-187.75,8b6de101-9e6d-42ce-801c-269503185bbd,-19112.65,debit,cash-withdrawal,AU00000,2024-01-17T08:47:39Z
transaction,90897d40-d504-46d3-b7a0-876c7dced188,posted,TFR Acc14000 TO 12389,-4892.91,c3cd8818-c5b1-4bc7-b385-6b3bac9f4691,6303.67,debit,payment,AU00000,2024-03-02T06:10:42Z
transaction,5819b844-eb07-4b32-9319-7c4ef5a194e2,posted,Travel Agency Booking,-4467.62,6f4df749-4585-4b28-81c2-0a93ccdcbe26,1836.05,debit,bank-fee,AU00000,2023-08-09T09:45:11Z
transaction,031d184a-fb60-41bc-97a7-7db146eb9fa0,posted,TRANSFER TO JOANNA SMITH CAMPING,-1601.92,8de16f7b-85d2-479a-a18d-ae4ac93fb3f4,234.13,debit,payment,AU00000,2023-06-28T16:17:40Z
transaction,201d820d-8355-4620-a154-550b85fdb3b5,posted,Travel Agency Booking,-1994.01,67a75045-441b-40f4-9126-4676adcb00c3,-1759.88,debit,payment,AU00000,2024-02-10T19:23:21Z
transaction,dbe3b865-821f-4da0-b348-908937a7f608,posted,Manly Maths Tutor Wages,-638.67,5e6f6c24-e54a-40f2-9d3e-286a4f06a3bc,-2398.55,debit,payment,AU00000,2023-12-03T11:18:25Z
transaction,c6c16482-20ed-46ea-b1d6-4be1fc9c40b1,posted,Online Gaming Purchase,-1433.22,f86038b1-3142-4da6-bef1-3d5214fea72d,-3831.77,debit,payment,AU00000,2023-12-12T14:25:08Z
transaction,4d215d16-d751-47b4-8285-2487dc3d26a2,posted,Manly Maths Tutor Wages,-2472.08,7af0f050-32f6-4dcc-9d8a-7f67df92b8d4,-6303.85,debit,bank-fee,AU00000,2023-05-18T01:52:12Z
transaction,8b8d5f2d-b9bd-4f27-bdfc-34c24260f84b,posted,Manly Maths Tutor Wages,-1286.69,9d4785ae-5d54-4813-ab66-e63addd399ac,-7590.54,debit,cash-withdrawal,AU00000,2023-09-14T04:33:36Z
transaction,830ec10b-748f-4e2f-97a1-3fa71565b2a1,posted,Amazon Online Shopping,-1656.11,7f318de3-c5bf-4aea-b75d-80076fd64c65,-9246.65,debit,cash-withdrawal,AU00000,2023-09-09T16:13:05Z
transaction,ce8f4ad3-2fb0-43e9-adeb-434a313f84c1,posted,Gym Membership Fee,-3993.39,1212f8f2-5538-4c87-ad73-3b657da3cfe8,-13240.04,debit,bank-fee,AU00000,2023-08-12T08:12:29Z
transaction,499b2982-6bec-4ebc-9aa0-c00cb688a882,posted,Amazon Online Shopping,-1231.29,db3fc44e-a010-4088-979c-8e955dacd3f9,5350.03,debit,payment,AU00000,2024-03-11T09:47:32Z
transaction,965392b2-5227-47b1-a73a-7a8762d2281c,posted,TRANSFER TO JOANNA SMITH CAMPING,-1497.45,cde96a36-ac19-425f-b034-1da445675deb,3852.58,debit,payment,AU00000,2023-10-27T17:48:12Z
transaction,4e8c1fa7-1b42-4ddc-94be-eedfeaba006d,posted,Bookstore Purchase,-3878.34,ef156a0f-6e78-4fb6-9b92-df6e4eaaa30c,-25.76,debit,cash-withdrawal,AU00000,2023-09-12T09:43:03Z
transaction,c9fe9201-bc19-46e2-85b9-985b1011bbee,posted,Home Improvement Store Purchase,-591.47,bec6ee4a-5a13-480a-943f-ee20dfa689e8,-617.23,debit,bank-fee,AU00000,2024-04-12T20:47:03Z
transaction,fa032fbd-49a9-4fce-90b0-8d761a06f993,posted,Hair Salon Appointment,-3563.52,f639a695-33c5-47ef-a881-3ea94e581c60,-4180.75,debit,payment,AU00000,2023-11-28T22:40:48Z
transaction,307e35ca-ff21-4fb2-ad63-62551b11a9b2,posted,Mobile Phone Bill Payment,-588.1,3f55c422-3bb4-4bf4-b102-c679c33d6c13,-4768.85,debit,bank-fee,AU00000,2024-02-17T20:46:53Z
transaction,ce11b5ec-9ecd-4755-8d2b-338a5982cb29,posted,Travel Agency Booking,-2373.22,c46dc001-a07f-4ec2-b9c6-845d69ea4425,-7142.07,debit,bank-fee,AU00000,2023-12-16T14:49:05Z
transaction,6425a4ed-b25e-4e62-98e3-74e75b6940ea,posted,Coffee Shop Purchase,-4151.87,74e2da0a-be01-469b-8871-6ec754e7d477,-11293.94,debit,payment,AU00000,2024-03-27T23:58:53Z
transaction,73e3f195-fb09-4e52-83ae-1950842e563c,posted,Wdl ATM WESTPAC IGA BALGOWLAH BALGOWL AU,-2964.81,0f5487cf-1410-4d34-a3e2-49f46673c391,-14258.75,debit,cash-withdrawal,AU00000,2023-06-07T23:28:22Z
transaction,7e3ed64b-e85f-4baf-bdbf-7ff585d36945,posted,Payroll WFRMS 15439393,11655.21,b8a6d110-3898-4781-904f-22801c5163ee,-2603.54,credit,transfer,AU00000,2024-04-06T20:49:33Z
transaction,75a58307-632d-419d-b3d9-cd8a677952fc,posted,Amazon Online Shopping,-1376.72,b0571e70-b7d1-4c2d-8445-4b2d351735af,13666.79,debit,cash-withdrawal,AU00000,2023-05-20T06:10:29Z
transaction,6a5a38e7-a819-4049-b522-4b2329ca0563,posted,Netflix Subscription,-2026.9,bda18224-185a-4901-a645-a7a7e3f98980,11639.89,debit,cash-withdrawal,AU00000,2023-07-02T17:53:34Z
transaction,730154fd-1a4f-4d33-940a-125780c7c9b5,posted,Online Gaming Purchase,-1061.44,c0e4a452-dbf4-48f7-8dcc-355fccc77c81,10578.45,debit,bank-fee,AU00000,2023-12-03T15:05:15Z
transaction,74bcf9c1-5908-4d75-9fb1-1796c1392d37,posted,Movie Ticket Purchase,-4493.7,3052460e-3e94-4042-a5b4-57583e85dc57,6084.75,debit,payment,AU00000,2023-10-30T19:42:40Z
transaction,3fbc619d-cc6a-4d78-9fcd-5cce519350d3,posted,Online Gaming Purchase,-4947.1,5c6b2816-c272-4d7e-86a3-f953a66f2f27,1137.65,debit,cash-withdrawal,AU00000,2023-07-14T04:16:02Z
transaction,26e95260-7325-4b45-8110-8b60b281b2c1,posted,Gasoline Purchase,-4807.13,08be2576-bf45-4c14-ad5f-d8b497a7ede6,-3669.48,debit,cash-withdrawal,AU00000,2023-10-10T14:37:25Z
transaction,f31a0873-3a0a-4020-8517-0a2bc473d4fa,posted,Mobile Phone Bill Payment,-344.2,dc851f30-ec3c-4d7a-a109-56de0f101d6e,-4013.68,debit,bank-fee,AU00000,2023-10-15T20:46:54Z
transaction,56b9b854-b6fa-4323-ab63-6b8adff758af,posted,Hair Salon Appointment,-3386.03,ae6cc107-a479-4c74-9eb3-2e26bd8c399b,-7399.71,debit,bank-fee,AU00000,2024-03-01T15:11:20Z
transaction,0d7188a5-960f-4ff1-bd8c-1aeaa6e548a4,posted,Amazon Online Shopping,-1836.83,37baed37-6eb6-4cfc-93ab-73429e0aba95,-9236.54,debit,cash-withdrawal,AU00000,2024-03-16T18:40:07Z
transaction,40728c6e-9a14-4313-9202-85f546a654e9,posted,Payroll WFRMS 15439393,10234.61,abba08be-1fdb-4531-8d22-767a22216c5d,998.07,credit,transfer,AU00000,2024-01-05T19:51:23Z
transaction,f7443115-edd2-41b1-b4e8-a3ac27f26cb1,posted,Public Transport Fare,-1616.32,55eed7fb-281b-4da3-980c-4bec0587d1aa,11516.45,debit,bank-fee,AU00000,2024-03-09T23:04:09Z
transaction,63fb55a4-9d09-46a4-ab16-35128af005ea,posted,Payroll WFRMS 15439393,10028.43,0a50d6e2-a35b-47e1-94ee-d039704cdc08,21544.88,credit,transfer,AU00000,2024-01-28T12:20:36Z
transaction,e76393d5-dcbb-42d1-99f9-541e41666f8e,posted,Coffee Shop Purchase,-321.5,49ec36fa-d9cb-4cbe-a165-15061a54b2d0,21223.38,debit,cash-withdrawal,AU00000,2023-11-13T02:35:06Z
transaction,800aa3c5-90e5-4d43-aa15-1c5c3561239d,posted,Mobile Phone Bill Payment,-1713.67,be86b920-3d76-4790-940d-3d8a81eabc38,19509.71,debit,bank-fee,AU00000,2024-03-31T03:18:47Z
transaction,467e1dc7-db11-4445-85ea-91f4341445d4,posted,Home Improvement Store Purchase,-1343.88,88cc50fe-e616-4b8b-bb58-10b134d5ea72,18165.83,debit,payment,AU00000,2024-04-18T16:54:14Z
transaction,08cb9fa7-7ffa-4b77-b386-8809f3bb3b83,posted,Gasoline Purchase,-3113.81,2937ab0f-9f31-4096-bec2-9aad3a8c8278,15052.02,debit,bank-fee,AU00000,2024-02-01T02:34:06Z
transaction,0da09bf8-62f3-4c17-935d-955b9fcd28a4,posted,Hair Salon Appointment,-4730.41,21a1c77a-4f9a-4975-a84f-04263f74065b,10321.61,debit,payment,AU00000,2024-01-09T06:19:32Z
transaction,37746a8a-5804-412f-8d6d-31d0db132ea4,posted,Payroll WFRMS 15439393,11677.38,4542edb6-1fcb-47d1-bfb5-db0f35363849,21998.99,credit,transfer,AU00000,2023-10-30T11:22:41Z
transaction,ea909625-b04d-4b94-936a-283d63d6402e,posted,Gym Membership Fee,-903.25,cb19e67c-0c98-4001-8d54-eda8275d3ac4,21095.74,debit,payment,AU00000,2024-05-01T23:57:38Z
transaction,56667611-c1f3-4ac7-aa8d-0430fdbe2e92,posted,Gasoline Purchase,-1056.27,f2ce3daa-2ea4-4f8b-aa67-6072ec1ec273,20039.47,debit,bank-fee,AU00000,2023-08-17T05:50:13Z
transaction,0a3f10b3-396b-466d-9698-d5b2e2fffe7a,posted,Music Streaming Subscription,-3744.27,8627e497-4082-4619-836b-79721b7aac62,1943.52,debit,payment,AU00000,2024-02-08T22:10:13Z
transaction,1d025523-ee54-4205-b312-d6ffa4af8c80,posted,Wdl ATM WESTPAC IGA BALGOWLAH BALGOWL AU,-2921.83,0012c672-7152-4f22-83e9-98aad13eb33b,-978.31,debit,bank-fee,AU00000,2024-01-18T07:44:53Z
transaction,32959e81-7589-4385-b376-cdb4cd5af3ed,posted,Car Maintenance Expense,-4685.18,facc0eaf-c622-43df-ba2d-d2c3052884bc,-5663.49,debit,cash-withdrawal,AU00000,2023-12-21T21:52:55Z
transaction,4aaf9122-46f6-4c78-8621-5b714ff3f02a,posted,Clothing Store Purchase,-529.33,b72dd8c7-2eda-492f-bb35-5a829c49e142,-6192.82,debit,payment,AU00000,2024-03-21T22:15:44Z
transaction,918599f3-ab00-496c-9920-8f2f3a05d1dd,posted,Car Maintenance Expense,-4812.28,63818468-ef85-44b3-8969-29aa244f42a0,-11005.1,debit,payment,AU00000,2023-06-24T22:24:47Z
transaction,9bce2a8f-ce94-467b-b55a-c4ce25b40fd0,posted,Car Maintenance Expense,-3256.15,e79bd86c-2b5f-448a-a977-18046854893e,-14261.25,debit,cash-withdrawal,AU00000,2024-02-13T08:59:43Z
transaction,857076b5-ee55-4247-9304-6551b8240f7a,posted,Movie Ticket Purchase,-4002.02,2455c86e-f2a5-4ffe-96b2-ffd53a58e849,-18263.27,debit,cash-withdrawal,AU00000,2023-10-18T01:16:22Z
transaction,0fa6e908-1104-47d8-bf18-19b8b6918392,posted,AGL RETAIL ENERGY LTD (GAS),-1651.0,a73f6e8b-9a99-4106-a08a-dee14134f4a2,-19914.27,debit,cash-withdrawal,AU00000,2023-09-03T19:01:32Z
transaction,62a989a8-5582-4a5b-8ca6-2d5a55779a08,posted,Music Streaming Subscription,-366.88,84d001e0-3539-4a7f-bf3f-a736ef8b57df,-20281.15,debit,cash-withdrawal,AU00000,2023-10-24T05:38:50Z
transaction,196ea889-cfc5-43f0-ac25-6f4d4a057ffb,posted,Mobile Phone Bill Payment,-3484.41,639140b9-3847-40d7-a881-f34b64ae7bb2,-23765.56,debit,cash-withdrawal,AU00000,2023-12-03T04:10:51Z
transaction,200d7f5b-b0ba-4f5a-b0fa-a9feda58cf31,posted,Music Streaming Subscription,-2145.94,b245678c-803c-4e39-802e-7b9c96806bb7,6075.19,debit,bank-fee,AU00000,2024-05-03T15:49:08Z
transaction,4489adb1-c2ab-49c1-9c9d-672cf2ec4d57,posted,CTRLINK CARERS Ref: 998R6789201610974V,-1950.74,b0d61aad-768a-492f-afb5-286c24d21b29,4124.45,debit,cash-withdrawal,AU00000,2023-12-05T05:56:39Z
transaction,da45ff7d-f2fb-43d1-ad01-e16cc6c62391,posted,Payroll WFRMS 15439393,11970.97,cb98c6cc-3050-4a78-b7cf-3c1899e463fc,16095.42,credit,transfer,AU00000,2023-08-10T18:42:52Z
transaction,e9aaac20-6c31-4739-9b53-0d3fad3ade56,posted,Gasoline Purchase,-4913.96,96ac2a8b-8048-4e5d-af48-2d0158fb3a90,11181.46,debit,bank-fee,AU00000,2023-12-28T19:10:31Z
transaction,addfb6e1-6381-44df-98da-c4d573cd170f,posted,Coffee Shop Purchase,-1346.45,3eeebdcf-7b3e-4cb2-a2ef-7be82f272104,9835.01,debit,payment,AU00000,2024-04-03T17:00:57Z
transaction,a054c2b2-29a6-42a7-98db-60e1fcd73c14,posted,Mobile Phone Bill Payment,-4310.28,fda7b881-43bb-4715-a92d-34a3572b4166,5524.73,debit,payment,AU00000,2023-12-13T22:52:29Z
transaction,51bccedb-ccce-49d1-9988-874ded3978cd,posted,Home Improvement Store Purchase,-4778.78,f238a93a-aba7-4802-82b8-cecc36644ad1,745.95,debit,cash-withdrawal,AU00000,2023-12-25T22:02:02Z
transaction,7ca015f5-e569-4700-8e35-4ae946b6aac6,posted,Transfer Platnm Homeloan 346454,-4327.8,c91088f8-26d0-4d7e-a1e5-8254df89fc14,-3581.85,debit,cash-withdrawal,AU00000,2023-08-18T14:00:34Z
transaction,596850a9-3a89-4750-9a3d-1e798648115c,posted,TFR Acc14000 TO 12389,-294.14,2d7de32d-6d66-4060-bce2-fa910fce3bf7,-3875.99,debit,bank-fee,AU00000,2024-01-29T05:53:24Z
transaction,7ff9a1c1-9c87-4ca9-bf39-d928f3bd92c5,posted,Amazon Online Shopping,-2439.22,5543ccda-5baf-44c8-9b0f-4edc0cb2ea69,-6315.21,debit,bank-fee,AU00000,2023-08-13T00:36:01Z
transaction,653d5def-252b-4cc2-b88e-df5a76e3294b,posted,Travel Agency Booking,-4093.82,f49ebab0-6286-4b0c-83ec-0f27248f7da5,3807.33,debit,bank-fee,AU00000,2023-06-24T14:57:17Z
transaction,3c3d594c-4d3f-4467-8922-02d165665862,posted,Uber Ride,-443.96,b5354f67-9481-4535-9bd1-6610f911e9e5,3363.37,debit,bank-fee,AU00000,2024-03-30T09:06:58Z
transaction,549eac37-6193-458e-b218-dd1a575baa2c,posted,Netflix Subscription,-4566.68,071b7785-26c7-4955-b511-922523f449c9,-1203.31,debit,cash-withdrawal,AU00000,2023-11-06T09:17:21Z
transaction,7ac4bc79-a51c-45e4-9f3a-bd0f5f8c8cd8,posted,Pharmacy Purchase,-1662.62,6cabeb6a-4fb3-4dd3-9cc4-b4fb6f6c4e4f,-2865.93,debit,bank-fee,AU00000,2023-07-03T09:42:45Z
transaction,2ded92c6-c7da-4bcb-859f-2c036cd10871,posted,Restaurant Dinner,-3666.21,cd287767-8542-4510-a670-96ae399565f2,-6532.14,debit,payment,AU00000,2023-09-25T18:57:58Z
transaction,8054e23e-abf6-44de-80fe-99755b298b56,posted,Clothing Store Purchase,-4649.81,1894ce8c-8e72-4fae-a4aa-7139947d5e41,-11181.95,debit,cash-withdrawal,AU00000,2023-08-15T01:23:24Z
transaction,d747166a-5c3e-44bf-b922-5cbfbf22024e,posted,Manly Maths Tutor Wages,-3685.49,2f196d2b-b610-432d-839c-d6162081d41e,-14867.44,debit,cash-withdrawal,AU00000,2023-12-21T05:02:15Z
transaction,68223cb2-b0e2-45f2-9f44-5514bbee88c2,posted,Travel Agency Booking,-1991.46,e7f56496-7814-4a4a-8679-1f0f7d0d249d,-16858.9,debit,payment,AU00000,2024-01-20T23:22:40Z
transaction,9df2143a-edfd-443f-adad-0ea83a12aa48,posted,Wdl ATM WESTPAC IGA BALGOWLAH BALGOWL AU,-903.23,a6d74a95-8291-4429-be6b-190c868de25b,-17762.13,debit,bank-fee,AU00000,2024-04-23T02:49:13Z
transaction,730388e8-470f-4779-b95a-897bdf5f814f,posted,Clothing Store Purchase,-3370.11,12431f96-24f6-4554-be4c-da1d8e1372cd,-21132.24,debit,payment,AU00000,2023-07-21T18:27:43Z
transaction,eddd17db-9996-4bcc-b46e-cd582f00d6d5,posted,TRANSFER TO JOANNA SMITH CAMPING,-1586.18,caf2751b-2dd5-4d0e-a729-5a8e2365e7cf,5236.59,debit,payment,AU00000,2023-10-25T09:21:51Z
transaction,1441c7fc-21e1-4ffb-977d-e18781632519,posted,Music Streaming Subscription,-1848.63,3f02785c-7597-4c1e-a47d-5ae1dd11fe7f,3387.96,debit,payment,AU00000,2023-11-06T21:29:58Z
transaction,f86d20f4-611f-4218-869b-7930f2d598c6,posted,Music Streaming Subscription,-4182.56,5a1e70e5-960a-4235-b05c-11b370619778,-794.6,debit,bank-fee,AU00000,2023-12-13T23:33:00Z
transaction,d5d47713-1dde-4ea6-8fb6-74da4d193e23,posted,Travel Agency Booking,-3417.68,9689ca3e-017f-4120-8bd9-07d57dfd15e5,-4212.28,debit,payment,AU00000,2024-04-14T19:01:40Z
transaction,57581f59-fa8a-4ed1-9fb4-49e015c7a483,posted,Transfer Platnm Homeloan 346454,-3926.25,8722567f-1705-4db0-ae5c-28b92ef94b47,-8138.53,debit,cash-withdrawal,AU00000,2023-08-25T22:43:05Z
transaction,8b196621-f21e-4105-b0ad-fe826a37d054,posted,Online Gaming Purchase,-3591.02,4c0c6c1b-d475-4a3b-a959-f543ea120660,-11729.55,debit,cash-withdrawal,AU00000,2023-10-20T07:33:17Z
transaction,4dcefa03-69db-4fda-93e0-976c488e021c,posted,Electricity Bill Payment,-1053.08,a4e0e048-22a3-4d2c-840b-a8abf2cb918b,-12782.63,debit,bank-fee,AU00000,2023-06-05T03:34:00Z
transaction,10c94445-d205-4799-ac19-a32ffa6cf4b8,posted,Coffee Shop Purchase,-2571.47,8e32f778-e031-49cf-a58e-9766f20a7e4b,-15354.1,debit,bank-fee,AU00000,2024-04-05T04:02:17Z
transaction,33433f75-4772-41ec-a1ca-e97ca6d924c7,posted,Wdl ATM WESTPAC IGA BALGOWLAH BALGOWL AU,-3889.08,80bae322-71f4-4bc7-8b7b-02edbc0ab18c,-19243.18,debit,payment,AU00000,2023-05-24T09:59:32Z
transaction,55329ad0-aa7d-4ffa-84bb-e48b24bb91d1,posted,Car Maintenance Expense,-4276.34,80876288-9e7e-442c-83aa-123ba51be1c8,-23519.52,debit,bank-fee,AU00000,2023-05-21T01:03:15Z
transaction,1b06d58c-4d6e-4fb2-98e4-7b199cc56431,posted,TRANSFER TO JOANNA SMITH CAMPING,-3012.45,d4e05346-8e74-4d18-bfd6-86b757c88301,8678.8,debit,bank-fee,AU00000,2023-05-18T03:31:53Z
transaction,81fe15bc-8571-44b0-bf1c-3d710da87486,posted,CTRLINK CARERS Ref: 998R6789201610974V,-4162.67,5a66dae6-845c-42ef-bedc-cf3661fd5cbf,4516.13,debit,bank-fee,AU00000,2023-11-17T07:26:30Z
transaction,ff27b7dd-bbea-4477-ab07-88823f9d1321,posted,Netflix Subscription,-3213.99,85f05bfd-6dba-465a-8e5c-b06a3d1fe901,1302.14,debit,bank-fee,AU00000,2024-02-25T11:18:44Z
transaction,b5cf590a-8927-43ac-9d03-fa8c14d2a6d0,posted,Home Improvement Store Purchase,-1227.97,8a5c6be7-1c60-4eec-8e13-41ec46210334,74.17,debit,payment,AU00000,2024-03-31T01:53:49Z
transaction,2044cf55-dcf3-4703-98cf-0b4fd431fda1,posted,Netflix Subscription,-1491.41,921b282b-b621-46ac-8a29-0cbd42a60ad7,-1417.24,debit,bank-fee,AU00000,2023-09-24T14:04:42Z
transaction,0aa22b6d-eb4a-417d-85ec-c4fc90fb9a04,posted,Gasoline Purchase,-2189.6,fd9c10e2-815b-4041-b473-16ce3bef4e55,-3606.84,debit,payment,AU00000,2023-10-18T10:13:02Z
transaction,4c922796-c4d4-42c8-be1a-3e8c5843f83e,posted,Manly Maths Tutor Wages,-3294.81,6c26efb3-1955-4e22-9d6b-7d77e56293c8,-6901.65,debit,cash-withdrawal,AU00000,2023-08-17T22:42:04Z
transaction,9762146c-d292-4046-93d2-49248916b7d7,posted,CTRLINK CARERS Ref: 998R6789201610974V,-766.15,4c8ed7ad-f79c-42a3-a97c-8c4a5cb3e787,-7667.8,debit,payment,AU00000,2023-11-23T14:24:28Z
transaction,7c337c28-6517-4dad-9612-8429b917ed7f,posted,Manly Maths Tutor Wages,-1133.76,a80c57c0-ceb8-4c64-9a9b-74658b6d1fad,-8801.56,debit,bank-fee,AU00000,2023-10-29T15:20:26Z
transaction,d30e0186-bcf0-4bab-af3a-097d69eb3fd8,posted,CTRLINK CARERS Ref: 998R6789201610974V,-3758.38,3deb601c-68db-4397-bba5-67df3a974713,-12559.94,debit,cash-withdrawal,AU00000,2023-12-19T13:36:52Z
transaction,692a164e-f133-43f7-add7-1deb32bcc478,posted,AGL RETAIL ENERGY LTD (GAS),-3121.7,6b1312f4-3236-41e0-9be7-27d3bc428469,7742.89,debit,cash-withdrawal,AU00000,2023-07-25T00:19:32Z
transaction,3eb54210-ed41-45c1-906e-296b6a0e070f,posted,Manly Maths Tutor Wages,-4466.23,f36e419c-be5f-4585-8da4-9c10e7be6d3e,3276.66,debit,bank-fee,AU00000,2024-02-12T03:05:52Z
transaction,8a655f35-4edf-43ed-a297-f51abaa0e270,posted,Home Improvement Store Purchase,-4337.44,58685ec9-9e53-41c5-a01d-7a03820874d6,-1060.78,debit,cash-withdrawal,AU00000,2023-07-24T00:47:47Z
transaction,8cf0d55d-f264-4167-be75-3aff651ea9a4,posted,Manly Maths Tutor Wages,-1947.73,a1e3b4a3-6995-4a72-9dc5-4b773a0a446a,-3008.51,debit,payment,AU00000,2023-07-07T20:42:33Z
transaction,2cd417c3-0923-451b-8d64-9cf6cc6eb7b3,posted,TFR Acc14000 TO 12389,-974.38,35bf9d67-5e30-4d20-b245-1730424b2897,-3982.89,debit,payment,AU00000,2023-11-06T13:14:54Z
transaction,4a1125fe-0b2f-4af2-b0bf-26e04b3a7a0a,posted,Netflix Subscription,-4208.29,298039ef-84cf-429f-9f00-7930e28b14f6,-8191.18,debit,bank-fee,AU00000,2023-10-05T05:24:06Z
transaction,67714d1b-b1a0-405f-b207-c721e4513944,posted,Car Maintenance Expense,-324.72,481a95a7-e688-4696-8ebc-93ce6c9bce83,-8515.9,debit,bank-fee,AU00000,2024-04-18T12:01:41Z
transaction,f2151ee1-da01-43df-8d2c-b1aa441e45d3,posted,AGL RETAIL ENERGY LTD (GAS),-2972.75,bb736809-4927-4302-af05-1442fd2f341c,-11488.65,debit,bank-fee,AU00000,2023-09-27T10:03:23Z
transaction,6126a782-0786-4bda-8a87-931b72e974f7,posted,Electricity Bill Payment,-4696.86,82ff5e44-00dd-4807-8cf4-4b2a01c6739e,-16185.51,debit,payment,AU00000,2024-02-21T09:14:01Z
transaction,f594e374-1ec9-4dc4-8f60-62cdaf526cca,posted,Uber Ride,-354.69,c56c8f1e-8050-48a4-8a1e-fe75c027931d,-16540.2,debit,payment,AU00000,2024-01-16T15:18:56Z
transaction,2c438264-a110-4561-8717-19f95931a1e8,posted,Electricity Bill Payment,-1786.34,d9389f3f-7d66-402f-8933-fd1db7a5a9bd,15054.21,debit,payment,AU00000,2024-01-07T04:13:57Z
transaction,af1fa2fd-4f11-4d2d-9a1a-99b2cb3e4905,posted,Gym Membership Fee,-664.84,a6b77b3b-71a7-46c4-8ebe-60cd97636e0b,14389.37,debit,payment,AU00000,2024-01-30T15:00:31Z
transaction,d4c1322e-a209-46f1-a410-f01074c4d2ff,posted,Non Hooli ATM Withdrawal Fee,-346.88,3e0f5a8b-7695-4850-9e73-45e154e67319,14042.49,debit,payment,AU00000,2023-10-01T01:10:16Z
transaction,c4cf6a88-08f5-4837-b448-41ff374c980f,posted,Gasoline Purchase,-4105.31,ff74532e-e9fe-438d-b7fe-61edd8cd0307,9937.18,debit,cash-withdrawal,AU00000,2023-09-19T05:51:32Z
transaction,5068e871-060f-4d39-b9d5-d1c8e055b65d,posted,Pharmacy Purchase,-2697.86,807703a6-5e2a-4d30-aeb6-30badc4397cd,7239.32,debit,cash-withdrawal,AU00000,2023-07-15T07:48:35Z
transaction,e5fca06d-6a48-458f-9582-de69fa647092,posted,Transfer Platnm Homeloan 346454,-3101.15,11e39477-4e57-4252-bc13-170252f7ca56,4138.17,debit,cash-withdrawal,AU00000,2023-09-24T18:34:51Z
transaction,b41f7e20-3973-4a77-b741-aac15250c968,posted,Home Improvement Store Purchase,-4504.79,e0dd9368-53c6-4f1d-a7d6-8c9492918421,-366.62,debit,cash-withdrawal,AU00000,2023-07-30T01:08:10Z
transaction,106f6d00-e626-4650-afd5-e10cb6e6d77f,posted,Online Gaming Purchase,-1419.61,8cd07a41-4219-421c-99b9-840929fe08a7,-1786.23,debit,bank-fee,AU00000,2023-05-12T21:58:20Z
transaction,2f1668e4-45ad-43ab-ae79-8ba109c69bc0,posted,Manly Maths Tutor Wages,-4552.82,c68f6016-616e-4b3a-b48c-7f06ba37c7fa,-6339.05,debit,cash-withdrawal,AU00000,2023-10-30T08:32:34Z
transaction,21ba7937-ec49-449b-8003-56390f893ee2,posted,Clothing Store Purchase,-2917.29,910ddacd-ab98-4d98-8092-11a5d43c7ad1,-9256.34,debit,bank-fee,AU00000,2023-06-02T23:56:10Z
transaction,0d10d68d-3a16-44f7-819b-ec9c655d3385,posted,CTRLINK CARERS Ref: 998R6789201610974V,-438.29,2ed09a0b-0059-41a5-b166-7ffdeff9c4c9,9929.33,debit,bank-fee,AU00000,2023-07-23T03:36:42Z
transaction,a5fd2cb9-2a0e-44d6-bac8-353bd5091c69,posted,Music Streaming Subscription,-4487.44,811bfc0e-b616-4109-a32c-cd0685ceafd9,5441.89,debit,bank-fee,AU00000,2023-12-26T15:53:47Z
transaction,23989c69-9a62-4e28-a953-a75e3e346b3b,posted,Mobile Phone Bill Payment,-697.57,b025219a-dbda-4b97-8c83-2a97a8238363,4744.32,debit,payment,AU00000,2023-09-02T01:17:14Z
transaction,4c1f8167-d0f2-426d-bba5-2bd9602569d4,posted,Netflix Subscription,-3334.13,af9a8752-ed40-45a9-a864-2582b8c51fa6,1410.19,debit,cash-withdrawal,AU00000,2024-01-14T08:55:02Z
transaction,9f7ff516-cc77-4820-8de0-3579f6c2a639,posted,AGL RETAIL ENERGY LTD (GAS),-4758.33,d03ad913-2792-46e5-aa7a-6b44e478e5dc,-3348.14,debit,cash-withdrawal,AU00000,2023-05-24T23:21:49Z
transaction,dc801e67-4ceb-4e5d-95d2-d87c674dd869,posted,TRANSFER TO JOANNA SMITH CAMPING,-970.23,edb22772-8aa2-4695-8701-043eceaa2b7a,-4318.37,debit,payment,AU00000,2023-12-22T01:08:38Z
transaction,39fe015a-65f7-4fda-a62f-9a654c142c86,posted,Hair Salon Appointment,-1902.52,45b3e683-041d-493d-86f7-0bcc48859a8c,-6220.89,debit,bank-fee,AU00000,2024-03-02T20:19:45Z
transaction,ee43d74f-3f55-4205-873f-e3a8e461ed4d,posted,Clothing Store Purchase,-410.37,e4c69e4e-f922-4380-b943-adba418f70a8,-6631.26,debit,bank-fee,AU00000,2024-02-22T01:29:23Z
transaction,d8817ffd-bb37-4ac4-afcf-3592eee29eda,posted,Gym Membership Fee,-4145.41,31a832e2-5202-4d84-b18a-e57ee92585ec,-10776.67,debit,cash-withdrawal,AU00000,2024-01-17T07:46:52Z
transaction,8ede445c-ea74-4bcd-8ece-763b2ff49e17,posted,AGL RETAIL ENERGY LTD (GAS),-3958.91,eb91f6a7-7265-4876-a0aa-7aa598477eb0,-14735.58,debit,payment,AU00000,2024-04-21T23:14:51Z
transaction,8c66a78f-209e-414e-acac-7c57e5e4ef49,posted,Movie Ticket Purchase,-364.41,3aaf132c-4621-48e0-b505-05d0e1159094,17697.82,debit,payment,AU00000,2023-08-06T05:24:24Z
transaction,a9440a0e-2d62-48e5-9cf4-2a58f99335b3,posted,Home Improvement Store Purchase,-2398.75,3dc531bd-a03a-4203-b22d-cfdb9c91ad33,15299.07,debit,payment,AU00000,2023-09-29T10:28:19Z
transaction,91f93c4e-3e6f-4e3c-94cc-e7d00f4fd5dc,posted,Restaurant Dinner,-3642.56,87995d0b-ebff-4045-abdf-a3dcbfa63e89,11656.51,debit,cash-withdrawal,AU00000,2024-03-16T01:56:43Z
transaction,775fe7e3-d5e3-482a-986e-977f027208f9,posted,AGL RETAIL ENERGY LTD (GAS),-3328.67,8b1e23fe-f1d0-40b4-b9c8-0817c507e62a,8327.84,debit,bank-fee,AU00000,2024-02-04T05:04:04Z
transaction,69e9cae0-a248-450b-a5ac-264027158f02,posted,Car Maintenance Expense,-3342.1,1407e188-3d61-4a3a-b336-6a725e0c2eeb,4985.74,debit,bank-fee,AU00000,2023-08-13T15:11:24Z
transaction,a774281e-05d9-4785-a17c-0f644bc39e71,posted,Non Hooli ATM Withdrawal Fee,-92.33,d450ca30-b779-41cc-8d36-91f95013432e,4893.41,debit,bank-fee,AU00000,2023-07-21T20:24:18Z
transaction,0c90e1dc-6d23-4462-b887-6c37092a5326,posted,Gym Membership Fee,-4894.18,4fe5bf16-3dc0-4743-9a3c-d813035a00d0,-0.77,debit,payment,AU00000,2023-08-18T21:36:08Z
transaction,80ffdd16-0d22-45fb-a1c4-7c2619e55def,posted,Non Hooli ATM Withdrawal Fee,-2882.08,f5f86a5a-92c3-48ba-abcb-b0a36c0a899c,-2882.85,debit,bank-fee,AU00000,2023-06-19T00:09:53Z
transaction,aa2792f6-975b-4f20-a748-ba2693f51590,posted,Pharmacy Purchase,-3059.06,93ca56b7-9a08-45a8-8819-1ad517e0dcb8,-5941.91,debit,bank-fee,AU00000,2024-02-01T12:42:53Z
transaction,65c04ba0-3f7a-4ffa-844c-9e6c66cf8007,posted,Online Gaming Purchase,-1405.33,41e21844-c04f-49a6-937d-4b68447afe81,-7347.24,debit,bank-fee,AU00000,2023-07-22T05:57:48Z
transaction,dd5fe68d-8a20-4265-9d4c-758718358861,posted,Public Transport Fare,-2789.79,5dbbc619-69e0-476a-a9db-243b263a5539,7525.55,debit,cash-withdrawal,AU00000,2023-09-02T13:14:27Z
transaction,65c411f6-57d5-47be-9f12-5088442048f7,posted,Gym Membership Fee,-2836.4,401b0caf-799b-46ba-b104-4e47715d0973,4689.15,debit,payment,AU00000,2023-06-10T00:06:35Z
transaction,f6203764-b1c0-47f9-aafe-5eee3b2f9855,posted,Payroll WFRMS 15439393,10097.5,eaad52e1-5c28-4962-b918-111d17863406,14786.65,credit,transfer,AU00000,2023-09-05T09:09:10Z
transaction,cbb13f48-ea05-4336-911f-0281449b08bd,posted,Home Improvement Store Purchase,-2033.56,c3d029bc-0259-4fa9-9c1c-c82fc4567fb6,12753.09,debit,payment,AU00000,2023-10-30T03:30:00Z
transaction,cf471a13-0661-489b-9953-ee9356c3c063,posted,Public Transport Fare,-105.08,2994dab4-8723-4680-9711-6ad32d0b34a7,12648.01,debit,payment,AU00000,2023-05-16T00:32:09Z
transaction,0d79041d-22b8-4aa4-8719-780e344c7655,posted,TRANSFER TO JOANNA SMITH CAMPING,-1881.98,bc0f66f4-2ecf-4834-8daf-6930ded795eb,10766.03,debit,cash-withdrawal,AU00000,2023-06-02T01:03:00Z
transaction,9cf14921-323e-40f7-8fee-f23c801dcfdc,posted,Uber Ride,-346.38,7be5e949-ab21-4575-8aae-8f072983a9a7,10419.65,debit,payment,AU00000,2024-02-18T02:10:27Z
transaction,65306c97-50ca-474c-8fbe-47d804ccedb0,posted,CTRLINK CARERS Ref: 998R6789201610974V,-2301.96,f5676e93-0d4a-4196-b20b-60c5e861a64e,8117.69,debit,payment,AU00000,2023-10-09T21:49:18Z
transaction,acd90b5f-c67f-471b-b178-66bc2f03d17c,posted,Mobile Phone Bill Payment,-1717.11,4e8af1c4-df30-4452-8f67-0b99b3ae1196,6400.58,debit,bank-fee,AU00000,2024-01-08T05:40:13Z
transaction,aa629705-d46b-4840-b8b4-12e17fbb71cb,posted,Transfer Platnm Homeloan 346454,-3497.03,20fbcc26-2c08-4db9-859a-8a7ce2ef32b4,2903.55,debit,payment,AU00000,2024-05-07T22:41:41Z
transaction,42780acd-3339-4374-8794-d4cf0a0dae74,posted,Pharmacy Purchase,-567.82,2ffd78d1-ff1c-4628-9443-2a5d9acef73e,16859.76,debit,payment,AU00000,2023-12-30T08:23:14Z
transaction,cd7c724b-c524-4bf8-9548-31a55ba83bc2,posted,Public Transport Fare,-857.25,0982426a-24b1-42b7-a704-963c06628f12,16002.51,debit,payment,AU00000,2023-08-23T16:00:32Z
transaction,c9247529-af24-46f8-9c9c-f6aeb90fb7ad,posted,Travel Agency Booking,-1962.91,bdb7d6c7-d4ca-4198-8147-5b16b4f6c549,14039.6,debit,cash-withdrawal,AU00000,2023-12-02T21:15:03Z
transaction,85541586-b916-433d-b75c-7af95b8107b7,posted,Gasoline Purchase,-137.99,695dc56a-57d1-4360-ab4a-57855a7c75cf,13901.61,debit,cash-withdrawal,AU00000,2024-02-18T21:51:13Z
transaction,9f8b999a-0bfe-40c2-8ab5-06793b32d293,posted,Gasoline Purchase,-4579.64,be5f1b02-e832-4a17-b721-a64d803b0b1a,9321.97,debit,cash-withdrawal,AU00000,2024-03-08T23:53:46Z
transaction,831f14aa-049b-43fe-a55e-d27ed9c958da,posted,CTRLINK CARERS Ref: 998R6789201610974V,-3480.74,239c5a62-0ad3-4a86-8fa1-a8518777102e,5841.23,debit,bank-fee,AU00000,2024-04-22T12:47:56Z
transaction,2639a9a7-6919-4582-ad46-d8eb95fab835,posted,Transfer Platnm Homeloan 346454,-2013.59,55357a82-82e6-4deb-8f31-34e65453e51c,3827.64,debit,payment,AU00000,2024-04-30T06:44:03Z
transaction,97decaee-3280-45bb-85cd-36974d5d9be7,posted,Manly Maths Tutor Wages,-3220.38,0b38c044-0757-4da7-8c1b-1a316f38e776,607.26,debit,bank-fee,AU00000,2024-02-29T14:54:27Z
transaction,5c9b2c41-13d3-4a4d-b42a-7c8597bf59cd,posted,Travel Agency Booking,-1173.77,78ae7e91-8754-4ed5-ad9c-8822e85dcad5,-566.51,debit,cash-withdrawal,AU00000,2024-03-25T07:04:21Z
transaction,91703a04-14b0-4aee-a170-36e7f58fe2b0,posted,CTRLINK CARERS Ref: 998R6789201610974V,-904.56,e70054cd-02b9-45a3-aae3-581877891328,-1471.07,debit,cash-withdrawal,AU00000,2024-01-06T11:46:08Z
transaction,286070e8-dbf2-42f9-a986-e1ebc0f678f8,posted,Home Improvement Store Purchase,-2278.8,448ba443-d9ba-42c3-8c6d-ffc0575d439c,11988.34,debit,cash-withdrawal,AU00000,2023-05-26T13:37:34Z
transaction,f964203e-7485-4b16-88ef-7b9c91bb7b74,posted,Non Hooli ATM Withdrawal Fee,-1150.91,1e33d7cd-f1cf-4ddd-91a3-b5b3402f255e,10837.43,debit,bank-fee,AU00000,2024-03-15T03:57:55Z
transaction,fb498c43-2aa5-4e72-ad42-7167d1d4766d,posted,Music Streaming Subscription,-57.83,f2918cf4-83d9-40eb-953a-af54409f5b21,10779.6,debit,payment,AU00000,2023-10-28T17:53:57Z
transaction,ac9c619c-0915-4db5-979c-bd2d059b7ed8,posted,AGL RETAIL ENERGY LTD (GAS),-2507.45,265e2e48-578a-4118-a84f-f301db6a7dd4,8272.15,debit,cash-withdrawal,AU00000,2023-11-27T12:00:02Z
transaction,6ed2d3c6-75f8-4673-afb4-c1977f961f6c,posted,Hair Salon Appointment,-1978.58,ca89f7e7-bc62-4371-a867-6a4cc1ba2528,6293.57,debit,payment,AU00000,2023-06-21T14:30:11Z
transaction,6899d996-8497-4839-9835-38ac7ef5e325,posted,Clothing Store Purchase,-1270.55,59a8a58f-479a-4536-8048-6b5010adf967,5023.02,debit,cash-withdrawal,AU00000,2024-03-20T04:41:00Z
transaction,9219c1c9-df91-4a55-ba13-4475280360fa,posted,Pharmacy Purchase,-1981.61,82e5da9d-8683-40dc-8a4c-53e9ac690edc,3041.41,debit,bank-fee,AU00000,2023-11-19T20:53:46Z
transaction,c386d705-3e2e-4aa3-9102-3b9f4f19f091,posted,Clothing Store Purchase,-4208.2,6cd96374-7fb3-46c6-9558-3aa1508b292e,-1166.79,debit,bank-fee,AU00000,2024-03-11T22:32:02Z
transaction,ddde19ab-216b-4203-a7d8-f9ab6d8227d8,posted,Bookstore Purchase,-3744.42,7351b474-05ce-4c61-843d-21319cf48cf7,-4911.21,debit,cash-withdrawal,AU00000,2023-12-22T06:21:17Z
transaction,65c2f920-cf45-47dc-a202-bb82fd7180c6,posted,Car Maintenance Expense,-1720.63,22deebc9-9d55-4f45-8cb0-f1dfbe58e856,-6631.84,debit,payment,AU00000,2023-07-23T03:25:53Z
transaction,512e2624-e0f3-492f-a9ce-f5453f1f7b47,posted,Public Transport Fare,-4138.02,f3af66e9-c2e4-43ad-a73d-dfee90f0465a,6217.55,debit,bank-fee,AU00000,2023-06-28T07:09:40Z
transaction,0b8cc40d-51a5-445f-b0a6-f4800e06a73a,posted,Gym Membership Fee,-2410.57,0a0be18b-3d72-4952-969c-16c65b12d73b,3806.98,debit,cash-withdrawal,AU00000,2024-01-26T01:59:52Z
transaction,15ffa749-61e3-47d4-9dc5-3c949d03c5e1,posted,Wdl ATM WESTPAC IGA BALGOWLAH BALGOWL AU,-2345.27,069ede7f-6373-473b-8dd4-dcd06512492b,1461.71,debit,payment,AU00000,2023-07-12T22:00:03Z
transaction,46d30480-6a42-486a-af6c-1f4a6e3eeac3,posted,Mobile Phone Bill Payment,-3628.43,9ce7bae3-0bad-4189-aefa-d39a177e7290,-2166.72,debit,bank-fee,AU00000,2024-03-07T14:17:03Z
transaction,f1f3ebd9-d608-4767-b7b3-2f69864cb8bd,posted,AGL RETAIL ENERGY LTD (GAS),-1927.65,7b75a89f-3fe7-4814-88ba-65f0290ca11d,-4094.37,debit,payment,AU00000,2023-06-12T00:17:26Z
transaction,e2dda6d2-4d86-4751-8722-8c35436591ad,posted,Netflix Subscription,-856.25,9218a8eb-32ff-4792-bf49-24a53ef9924c,-4950.62,debit,cash-withdrawal,AU00000,2024-04-28T02:04:43Z
transaction,8f01ef79-edb1-4b79-875c-8fd579519906,posted,Movie Ticket Purchase,-3683.6,19694893-abc1-441d-8d0b-800eb3cf505d,-8634.22,debit,cash-withdrawal,AU00000,2024-01-25T22:32:05Z
transaction,1c2e784d-6081-4e91-a0dc-0591980f18bf,posted,Bookstore Purchase,-2124.07,1b483c9f-20a8-4237-8312-766f34523170,-10758.29,debit,cash-withdrawal,AU00000,2023-07-23T07:18:34Z
transaction,9f69dba0-663a-4213-8bed-bfce0ed97357,posted,Coffee Shop Purchase,-2944.61,454040b5-d05d-43c3-b46d-9609b13c3e7c,-13702.9,debit,payment,AU00000,2023-08-21T00:14:58Z
transaction,0a8182b9-22a7-45d2-a6f4-56b1e2f1a365,posted,Movie Ticket Purchase,-2485.49,a8941502-167a-4ce2-aceb-d34fc57b7340,-16188.39,debit,bank-fee,AU00000,2024-03-22T01:58:21Z
transaction,c87a451b-e9c1-4174-ae89-df85c56e76b7,posted,Non Hooli ATM Withdrawal Fee,-915.74,e806457e-c406-422d-8223-2a99098a2740,14787.9,debit,payment,AU00000,2023-06-14T09:17:39Z
transaction,355d31cd-e1d4-4856-876c-0ca6738cccd5,posted,Mobile Phone Bill Payment,-4473.81,9373c8b8-d1e1-4039-8219-429b575bf9be,10314.09,debit,cash-withdrawal,AU00000,2023-07-16T10:37:07Z
transaction,f0d690cf-ca0b-4a03-875d-c68c17c12046,posted,Music Streaming Subscription,-4326.72,04db1c86-7a91-41c6-9f00-ecf7908053f7,5987.37,debit,cash-withdrawal,AU00000,2024-04-16T09:09:28Z
transaction,f7d4f1ef-14b8-4ea6-ab29-ea63877bf4b8,posted,Public Transport Fare,-1627.14,53ba033f-a9b7-4c04-a3a7-1801d9e02b14,4360.23,debit,payment,AU00000,2023-06-28T07:10:22Z
transaction,d3e6d543-aeeb-4a50-bb3b-5e4ca73242a3,posted,TRANSFER TO JOANNA SMITH CAMPING,-2147.78,3361d069-9057-4869-a3ae-be5768a1c51a,2212.45,debit,bank-fee,AU00000,2024-04-05T21:50:58Z
transaction,6193bb76-f277-47bc-bae2-1e4ad01242d0,posted,Gym Membership Fee,-1348.69,604d366e-a672-4d35-8ddf-3e637227a2b4,863.76,debit,cash-withdrawal,AU00000,2024-02-17T12:46:13Z
transaction,c1414a1a-de0c-4004-860a-5dd5750ec8a9,posted,Electricity Bill Payment,-3316.8,ab395bcb-c915-4fa4-9f6c-42beb1c1498a,-2453.04,debit,payment,AU00000,2023-11-22T16:53:15Z
transaction,3b670457-6b76-42c9-a890-b19513f93296,posted,Netflix Subscription,-1791.01,bbfaf4ec-0fa7-4e65-a00f-710f18c94584,-4244.05,debit,payment,AU00000,2023-07-14T14:09:53Z
transaction,b6a9cd78-2364-462d-974a-1bc22c7eb77b,posted,Pharmacy Purchase,-795.52,9f4d7c6d-e8d2-4c17-a2f4-dee299dfba3b,-5039.57,debit,payment,AU00000,2023-08-28T17:47:44Z
transaction,d5df527a-d976-4d40-8cb3-037b21698977,posted,Music Streaming Subscription,-4419.47,ed75c60f-0597-4d30-841b-d7c29fd2102e,-9459.04,debit,cash-withdrawal,AU00000,2024-01-28T07:38:25Z
transaction,230fff55-92c6-497d-9b36-540713550233,posted,Transfer Platnm Homeloan 346454,-3803.49,6b24d5a3-92b1-447d-a280-fcb065cb93e8,3932.32,debit,cash-withdrawal,AU00000,2023-12-28T06:47:26Z
transaction,e6a9395a-25cf-4e5d-a5c5-6257f0df3975,posted,Bookstore Purchase,-126.13,ab27ea8d-240d-4529-a707-5ed9fe471a8b,3806.19,debit,payment,AU00000,2023-12-15T15:57:33Z
transaction,117f93ec-7921-422a-90dd-7b2aa191ede2,posted,Movie Ticket Purchase,-3107.64,e3a80bc6-6672-46d4-92f2-40b9c583f15a,698.55,debit,bank-fee,AU00000,2023-05-29T13:41:50Z
transaction,5512293b-443b-4a57-b04b-10f75338e851,posted,Pharmacy Purchase,-2916.79,720faefd-4f41-436b-9cb0-c792fded8e9e,-2218.24,debit,payment,AU00000,2024-04-30T14:45:34Z
transaction,4a875d16-c8cf-41de-96aa-f5f7c257d5c2,posted,Coffee Shop Purchase,-2921.6,8da2d7af-32b9-4178-b7da-f9553d4f59e0,-5139.84,debit,payment,AU00000,2023-12-08T04:35:56Z
transaction,197a225e-05da-46dd-afff-be6db96fb80e,posted,Travel Agency Booking,-2662.6,a97faa28-3669-4eb0-9c01-037a54ded7ea,-7802.44,debit,cash-withdrawal,AU00000,2024-01-25T14:53:08Z
transaction,c7852718-180e-4cc4-95c7-9bd3f31cc9fc,posted,Music Streaming Subscription,-2916.33,2884df39-f528-496e-9277-8725b4bebf3f,-10718.77,debit,payment,AU00000,2023-12-02T09:46:29Z
transaction,2f4b03f8-7d8c-4be5-b7eb-3b0e4d4a5d1d,posted,Clothing Store Purchase,-4168.28,6bdc9ff7-2455-47dc-8bf0-287a053d95bf,-14887.05,debit,cash-withdrawal,AU00000,2024-04-12T10:15:36Z
transaction,d04f61a0-f9d1-482b-aedd-cba1971e1cc6,posted,Gym Membership Fee,-4854.15,5ce7b00b-2605-4746-834c-77b09884c07b,-19741.2,debit,cash-withdrawal,AU00000,2023-05-18T19:04:35Z
transaction,9752077a-7d7e-4d99-8b4f-4bdbd90c5968,posted,Hair Salon Appointment,-2694.19,69cc59e5-4262-4235-b62a-b1f4fdda81fc,-22435.39,debit,payment,AU00000,2023-09-08T11:22:37Z
transaction,4607c3b0-b185-408b-875b-e3c3033d010f,posted,CTRLINK CARERS Ref: 998R6789201610974V,-4712.87,0ef6eb18-8ee1-4697-abf8-d18fe32c647c,5010.09,debit,bank-fee,AU00000,2023-06-13T23:12:22Z
transaction,d2439cb7-7760-4162-8dfb-ceb077aa66da,posted,Car Maintenance Expense,-2553.78,03de9a41-0c13-4fcd-8f81-234f531ac06a,2456.31,debit,payment,AU00000,2023-05-15T03:35:33Z
transaction,f77457bc-4aad-4d37-b249-6bf5e6649035,posted,Gasoline Purchase,-2350.14,9ab7dec0-4df2-4dd9-b821-d28972433369,106.17,debit,payment,AU00000,2023-10-26T05:47:21Z
transaction,ac77be2e-de4a-4fef-bfaa-491ee7ba045d,posted,Movie Ticket Purchase,-2651.77,fe014b78-c82b-435b-8c85-5e715d257ccd,-2545.6,debit,bank-fee,AU00000,2023-08-03T08:01:49Z
transaction,93983da8-aac1-4077-85f9-8bd789085229,posted,Gasoline Purchase,-4825.57,c7f4c0bf-fede-4554-ba5f-4ec248c50258,-7371.17,debit,bank-fee,AU00000,2023-07-17T12:24:22Z
transaction,3962476a-848e-4b51-85dd-2d9b2c89d81c,posted,Non Hooli ATM Withdrawal Fee,-1568.49,afd0efd2-bdb4-496f-9b8d-d8686e52edbf,-8939.66,debit,bank-fee,AU00000,2024-04-02T23:31:06Z
transaction,f6efe088-0f78-4e7c-821e-09cd5d2cdca6,posted,Manly Maths Tutor Wages,-4698.96,e11ca3dd-4522-4211-a1af-72a9624af807,-13638.62,debit,cash-withdrawal,AU00000,2023-09-02T13:10:46Z
transaction,01de929f-24bc-4e18-bdce-75140824b4ba,posted,Home Improvement Store Purchase,-4838.01,e3cdda67-29eb-45a3-9b13-82e1a6b6c865,-18476.63,debit,cash-withdrawal,AU00000,2023-07-12T09:32:17Z
transaction,7d0352e1-16dc-4a23-bcf5-114c05e9585f,posted,Payroll WFRMS 15439393,11713.31,504fcaac-ef8d-4115-9e61-d50c3497ce35,-6763.32,credit,transfer,AU00000,2024-04-02T21:50:06Z
transaction,278b97a4-e826-40b6-899e-df2c176691d1,posted,TFR Acc14000 TO 12389,-784.04,3e98ce6a-eac8-4d6f-b4df-4b1514f73644,-7547.36,debit,cash-withdrawal,AU00000,2024-05-01T05:31:26Z
transaction,c666c1b4-3e0f-4b62-bc9e-a165f45da42e,posted,Music Streaming Subscription,-1292.84,64be9da8-753d-46de-a8a4-41e0025f3395,3748.36,debit,payment,AU00000,2024-02-06T21:48:03Z
transaction,16e9201d-e6a6-418a-a84f-cd34bb4eebea,posted,Coffee Shop Purchase,-3916.95,a7c2ca0b-21ec-4ba4-aba2-3e22f82bdf0c,-168.59,debit,bank-fee,AU00000,2024-03-15T17:08:58Z
transaction,4c628e1a-86c4-4ae7-b13c-4424ac932b6e,posted,Restaurant Dinner,-4186.18,27e8fd8e-f2cf-4d59-9e8e-8eed968737d2,-4354.77,debit,payment,AU00000,2023-10-10T21:25:32Z
transaction,ea468f12-37fc-4e27-912d-8ee2b99047c3,posted,Coffee Shop Purchase,-925.35,a622edb0-3431-429b-a6a1-5f91e7391d2b,-5280.12,debit,cash-withdrawal,AU00000,2023-06-24T21:38:25Z
transaction,b0079664-5c77-4f36-9459-05a4d819cbed,posted,Amazon Online Shopping,-20.47,c7db854c-f347-445d-8a33-42b0ec74d39d,-5300.59,debit,cash-withdrawal,AU00000,2023-11-18T12:58:43Z
transaction,79cd6ba2-34bd-4aec-a15c-d852ff96991a,posted,Travel Agency Booking,-2629.86,9fef6d02-a03d-497a-a05a-df4341b34378,-7930.45,debit,cash-withdrawal,AU00000,2023-09-07T03:29:32Z
transaction,e10f1627-1056-48ee-9b50-334a47ce20a1,posted,Music Streaming Subscription,-907.37,246b2c6c-36c4-4d35-baf1-3971b65fc1ac,-8837.82,debit,payment,AU00000,2023-06-08T23:50:31Z
transaction,4afa78db-e2d4-44cf-855f-c902dc5098c9,posted,AGL RETAIL ENERGY LTD (GAS),-3724.05,c3aba5c4-9f1b-4fa6-9fdd-3a5f19f95b22,-12561.87,debit,cash-withdrawal,AU00000,2024-01-27T07:42:13Z
transaction,ab48f867-3274-4abe-a60d-483389778d80,posted,TRANSFER TO JOANNA SMITH CAMPING,-4382.06,a48eb219-79b8-43e8-8c90-89e8ceb6d205,-16943.93,debit,bank-fee,AU00000,2023-12-26T15:56:09Z
transaction,e1ce40f1-d87d-4a21-ac6a-08483005c1ba,posted,Clothing Store Purchase,-3962.07,2ca2cabb-1c37-428e-8ac1-4e82f54390c0,-20906.0,debit,cash-withdrawal,AU00000,2024-02-10T10:30:37Z
transaction,3f8654d3-67b3-40d4-9f29-6ad050ccc0dd,posted,Restaurant Dinner,-1497.6,dbe95ea1-8349-482a-ba73-2962fc787abe,5990.98,debit,payment,AU00000,2023-12-14T05:26:45Z
transaction,328fc902-4baa-4c68-8fee-85c3175c6b4b,posted,Pharmacy Purchase,-3513.22,75d45fe4-f329-4006-bde1-486a56a66fbc,2477.76,debit,payment,AU00000,2024-05-07T15:46:19Z
transaction,a0294c31-8a4c-423e-9d8e-77d06a5d2397,posted,Transfer Platnm Homeloan 346454,-625.94,25e82cc1-3767-47c7-b61a-74f9b2623769,1851.82,debit,payment,AU00000,2024-02-29T19:53:49Z
transaction,d33333fc-2cee-4938-ba13-24124134541c,posted,Car Maintenance Expense,-3768.45,d24c3b16-b78b-49f6-84c6-fb665c66c259,-1916.63,debit,cash-withdrawal,AU00000,2024-04-23T13:04:43Z
transaction,18190bd4-b637-4975-bac6-ea4a1d3599d0,posted,Gym Membership Fee,-1990.45,f5c64065-e13f-4613-91db-0e6c3926d587,-3907.08,debit,cash-withdrawal,AU00000,2023-08-02T12:44:41Z
transaction,cf9ff1b0-adbf-4543-9785-9f69677bad3e,posted,Restaurant Dinner,-3230.58,8a96e565-01ff-49c6-ba51-2c1b248575b0,-7137.66,debit,bank-fee,AU00000,2023-07-18T18:12:54Z
transaction,2543944f-40dc-4ca5-b87b-0e501dc70c80,posted,Gym Membership Fee,-1565.53,8da0a7c6-df32-471e-857e-0947d88e26ce,-8703.19,debit,payment,AU00000,2024-04-06T21:00:49Z
transaction,306d0f66-879e-4454-8fa0-2a407a484d6c,posted,Clothing Store Purchase,-680.02,b343bf95-ecc0-48a3-9f22-1c8c96ac353e,-9383.21,debit,payment,AU00000,2023-11-30T01:08:32Z
transaction,3d27e258-2e49-443b-b018-e50deb8d45e9,posted,Netflix Subscription,-2415.48,6dc41f6c-1259-4057-8094-e9672f7179c1,-11798.69,debit,payment,AU00000,2024-04-23T07:01:02Z
transaction,010ea82a-b811-4b3e-b4a9-06a4afd19193,posted,Public Transport Fare,-3382.49,825ea646-4515-4edc-81a7-c8cba9996c6f,-15181.18,debit,cash-withdrawal,AU00000,2023-07-16T22:52:41Z
transaction,0f2f30b0-fa87-4c0f-915c-0a0bb64c4986,posted,Amazon Online Shopping,-3982.66,7d9482a2-bbbe-493b-bd74-e0bc4f5d5f61,5206.67,debit,payment,AU00000,2023-06-27T08:43:05Z
transaction,d8746e8c-a4d6-4c40-bf96-d4acc15e3899,posted,Bookstore Purchase,-3768.8,4c0060ed-09c3-4b42-970e-dd4ec375e0d8,1437.87,debit,payment,AU00000,2024-01-26T04:23:52Z
transaction,b6fad14a-30c2-4167-a497-f349400e0cb2,posted,Travel Agency Booking,-2478.75,22a75024-6462-4f84-8758-91283d5174a9,-1040.88,debit,payment,AU00000,2024-01-18T20:32:12Z
transaction,e8b82f93-a9ea-4a8f-9b08-4ef53cc23cbb,posted,Home Improvement Store Purchase,-1454.07,b05b296c-44b2-4ff5-bd1d-fbf2d30a00ed,-2494.95,debit,bank-fee,AU00000,2024-02-23T00:11:48Z
transaction,cfeeab48-cff2-4489-af93-0fd94ff4eb42,posted,Coffee Shop Purchase,-99.09,aeb21d1f-f903-4512-b109-393fab768045,-2594.04,debit,bank-fee,AU00000,2023-09-04T08:24:49Z
transaction,e107a897-c1a7-4ac8-a764-42bfbb7c92b5,posted,Gym Membership Fee,-2206.35,f7a6eeff-5aa2-4f10-80c1-222bf0a1b0fe,-4800.39,debit,cash-withdrawal,AU00000,2023-10-29T12:48:58Z
transaction,93355a9a-ef75-478f-a112-d986be2a71c6,posted,Car Maintenance Expense,-165.5,19c6139b-981e-44fb-8724-fbfaf54ee558,-4965.89,debit,payment,AU00000,2023-08-02T18:55:06Z
transaction,c4991a1b-cec1-43fd-82ef-0a185f202b84,posted,Payroll WFRMS 15439393,10791.56,3a9057a5-32f9-41d3-9bba-240da1918543,5825.67,credit,transfer,AU00000,2023-08-16T22:18:39Z
transaction,5d50fbe6-d535-4d5e-bf94-ce6967c22396,posted,Travel Agency Booking,-2005.62,fd852d66-f689-4bac-a825-a2fb2b57a6b5,3820.05,debit,cash-withdrawal,AU00000,2024-03-22T04:41:58Z
transaction,3b0cf6ea-c21e-41ef-adc1-44278ebac67c,posted,Non Hooli ATM Withdrawal Fee,-406.5,928b5b6d-5b4a-4ef6-ba1d-cc9829b001d6,3413.55,debit,payment,AU00000,2023-08-15T06:19:25Z
transaction,6bdf1cab-5167-476c-a8f1-4111dde3ad61,posted,Home Improvement Store Purchase,-269.59,8ac95b9c-f840-4275-b2f3-c6ba1745a421,9480.13,debit,cash-withdrawal,AU00000,2023-12-04T13:52:25Z
transaction,b8af0ad1-23b4-4e30-b229-ff1fe63c6157,posted,Amazon Online Shopping,-781.21,f7d84967-d835-46db-bfc5-b5532f39f219,8698.92,debit,payment,AU00000,2023-06-03T23:11:16Z
transaction,93e1f182-c33b-435d-8280-e04f7358ce7e,posted,Wdl ATM WESTPAC IGA BALGOWLAH BALGOWL AU,-1002.44,caf51b8c-253f-4220-83b4-3c0c6934cebb,7696.48,debit,cash-withdrawal,AU00000,2023-11-26T05:34:25Z
transaction,a442763a-7855-491e-9927-b1ec69bf6871,posted,Online Gaming Purchase,-4201.18,2c7a1bd3-e4ab-4d40-8246-7e182da51ad6,3495.3,debit,cash-withdrawal,AU00000,2024-03-13T08:29:40Z
transaction,a8265eb6-017a-4033-aa18-ddcf593ad96d,posted,Mobile Phone Bill Payment,-3678.15,bc4271ee-2713-4a87-92ba-8b48f61e3f4d,-182.85,debit,cash-withdrawal,AU00000,2023-06-08T00:10:31Z
transaction,893d4ce4-c996-466c-a1b5-df7d9882a519,posted,Payroll WFRMS 15439393,10326.17,166a6cbf-60d5-401c-a10c-62917124992e,10143.32,credit,transfer,AU00000,2023-05-12T10:49:36Z
transaction,4e3439a3-dffa-46b0-8a91-689c96e67341,posted,Music Streaming Subscription,-4442.77,6208b34d-c867-46ff-89e0-21022b40d34b,5700.55,debit,cash-withdrawal,AU00000,2024-04-03T17:52:57Z
transaction,9f5c3f1b-3b09-4982-9627-181a0c8978b4,posted,Travel Agency Booking,-2047.89,e315037f-e850-46ae-b11e-76fb66561498,3652.66,debit,cash-withdrawal,AU00000,2023-06-17T19:12:29Z
transaction,5690a685-596c-4008-9f29-94160f2b06d9,posted,Restaurant Dinner,-3830.86,52190dc5-d4bb-43c0-b709-5a080858c9fc,-178.2,debit,payment,AU00000,2023-05-22T22:01:40Z
transaction,c2dac2aa-c99d-453b-b71b-d5069601527b,posted,Travel Agency Booking,-2698.72,937eb72d-0f44-4def-bfcc-943f46ce70f5,-2876.92,debit,bank-fee,AU00000,2023-05-29T20:47:51Z
transaction,34c6c768-63bb-47bc-b6fa-f633790d6408,posted,Mobile Phone Bill Payment,-4093.87,34b92535-dace-4cfb-98c6-fe700fe3e3b3,5146.52,debit,payment,AU00000,2023-10-13T10:20:29Z
transaction,f46dd4e5-59cb-4dd7-8b70-5012d260f7b9,posted,CTRLINK CARERS Ref: 998R6789201610974V,-1853.78,28660b0c-04cc-4e18-a5d7-72b977598a66,3292.74,debit,bank-fee,AU00000,2023-11-25T02:44:45Z
transaction,4835e28d-5c4a-404e-a5f4-24878717dac7,posted,Gasoline Purchase,-4599.14,01744731-574d-41c2-ad27-df617c8115ee,-1306.4,debit,cash-withdrawal,AU00000,2023-12-28T14:16:26Z
transaction,6eb4db22-63d2-4479-8d02-81896557c79e,posted,Restaurant Dinner,-831.6,cb187359-9646-42e2-b350-068495bfd271,-2138.0,debit,cash-withdrawal,AU00000,2024-02-01T04:19:50Z
transaction,2cdee3e8-e494-4d0f-b4bf-91781d94496f,posted,CTRLINK CARERS Ref: 998R6789201610974V,-857.14,7f1673aa-b4f8-4ec3-96f6-1a28a6ddc22e,-2995.14,debit,bank-fee,AU00000,2023-10-27T20:44:12Z
transaction,fe900292-c152-4407-88e8-ad71685f0585,posted,Restaurant Dinner,-2664.52,f14b5f91-6476-461c-b009-b3026bbb02a0,-5659.66,debit,bank-fee,AU00000,2024-03-03T20:52:31Z
transaction,441149bd-5bcd-4bb1-9741-d9034a467cf5,posted,AGL RETAIL ENERGY LTD (GAS),-3672.87,2efa9fbb-6545-47af-b523-85fe805512be,-9332.53,debit,bank-fee,AU00000,2023-12-17T19:55:01Z
transaction,0e770d69-29c9-4855-8435-6c0a3559a632,posted,Non Hooli ATM Withdrawal Fee,-2301.57,75dd7f20-7362-4d88-aa2d-e0a08f24ab2c,-11634.1,debit,cash-withdrawal,AU00000,2023-10-08T12:27:22Z
transaction,634cb29c-c11d-4144-b46a-508cf07aa8eb,posted,Clothing Store Purchase,-1902.85,7ef7a2b7-e283-4e56-b4a5-d43ffc50f5df,-13536.95,debit,cash-withdrawal,AU00000,2023-12-24T12:34:30Z
transaction,4e8b11c5-6588-4d84-a114-28bcafa68ed3,posted,Netflix Subscription,-2080.49,2f7faad5-3300-49f5-8d83-3df66c2501b0,-15617.44,debit,payment,AU00000,2023-08-02T06:19:11Z
transaction,0c748ef3-484a-4039-9695-c2d4ea74c400,posted,Non Hooli ATM Withdrawal Fee,-4974.1,1a6a9626-7d38-4dfc-97d1-edf7ce76f8a1,12168.76,debit,bank-fee,AU00000,2024-03-05T18:31:56Z
transaction,d60f664a-652e-4a4a-b1f9-a9366401fc0b,posted,Bookstore Purchase,-4857.85,5ed66ee7-f977-40e7-ab2c-df22d4b526f4,7310.91,debit,payment,AU00000,2024-04-27T16:22:20Z
transaction,87e1bb14-83ed-466d-b0ad-3f72f3fccef3,posted,Uber Ride,-4101.61,88265722-2f68-4e06-a372-9e0b8e9f3912,3209.3,debit,bank-fee,AU00000,2023-11-17T15:53:34Z
transaction,5330eae4-0126-4ddd-bc99-95a274365828,posted,Restaurant Dinner,-4855.8,1dd161db-323b-4952-8c5b-7a50f0fb8de0,-1646.5,debit,payment,AU00000,2023-10-12T05:21:00Z
transaction,a9a345a0-5a02-40b9-ad7c-0a1a7d5176f8,posted,Car Maintenance Expense,-4905.7,6df247fd-5a3f-4511-b549-f7ab238601e7,-6552.2,debit,cash-withdrawal,AU00000,2024-04-29T07:15:13Z
transaction,a1ce7474-f336-4356-90ab-7ebaf376a3ec,posted,Pharmacy Purchase,-4700.65,5f5bae80-6ae3-47fe-8ad7-14be6552a55e,-11252.85,debit,payment,AU00000,2024-02-25T10:36:48Z
transaction,be6836ca-0dcd-4ad0-9fd2-45815abd6f3b,posted,TFR Acc14000 TO 12389,-1570.87,5c59f6aa-68b0-4531-848f-3628c47d882c,-12823.72,debit,cash-withdrawal,AU00000,2024-02-24T20:55:18Z
transaction,eac953ef-9383-4864-bf41-2c5f4989beb5,posted,Hair Salon Appointment,-2302.24,e5ef1e32-2f3e-435f-b10b-c67c4b4391f2,-15125.96,debit,payment,AU00000,2023-12-31T23:42:54Z
transaction,5282c9fa-3064-4c8a-8b81-4f8d1e97d93f,posted,Manly Maths Tutor Wages,-1438.58,2ecc4fbd-99ad-4294-ae19-d5a7c5ffe971,-16564.54,debit,payment,AU00000,2023-11-16T03:41:50Z
transaction,d2401049-317f-44d6-90a7-93d648282940,posted,Gasoline Purchase,-3270.26,81233202-a83f-45fe-812b-a207e1c2875f,-19834.8,debit,payment,AU00000,2023-09-21T07:12:25Z
transaction,ecc3e8ba-8df6-4478-b3ad-9496772cd0d0,posted,Gasoline Purchase,-4651.63,62adf62d-4ec8-4e57-9274-4d05741eba3a,10412.85,debit,cash-withdrawal,AU00000,2023-08-06T05:13:09Z
transaction,c9d8017d-e4d1-42f5-8dc5-d2dd0ee42328,posted,Bookstore Purchase,-2390.73,6d60c939-ad16-4e1c-bddd-8fa0aafc7d20,8022.12,debit,cash-withdrawal,AU00000,2023-11-23T13:57:09Z
transaction,5d8d23a5-2c97-43c0-b285-d34634fbdbe9,posted,Travel Agency Booking,-263.39,45b53773-20f1-4787-af3c-e53e20a8c900,7758.73,debit,bank-fee,AU00000,2024-02-20T09:31:23Z
transaction,28bb673d-ea7d-4269-8554-e8c192c05518,posted,Public Transport Fare,-2247.2,967ef26a-b31c-46b9-ac5e-9a07aad5e136,5511.53,debit,cash-withdrawal,AU00000,2023-09-28T01:32:20Z
transaction,11b68ddc-a49e-4b89-8daa-39b62f9e6d8e,posted,Gym Membership Fee,-897.07,ca4d8fb0-f496-4552-b397-0c04f7c8e2fc,4614.46,debit,cash-withdrawal,AU00000,2023-07-18T19:09:06Z
transaction,dabe4b11-42b4-46a6-94b7-f1e23807ea78,posted,Restaurant Dinner,-1388.7,90e63f5c-b4fd-482e-9928-b6c94fa38985,3225.76,debit,cash-withdrawal,AU00000,2024-04-08T07:33:56Z
transaction,0653c772-8ca4-4acc-b50c-60fc6bf7fd6a,posted,Manly Maths Tutor Wages,-3439.54,58bef2ba-b289-4315-992d-434412e494a9,-213.78,debit,cash-withdrawal,AU00000,2023-10-20T16:01:48Z
transaction,38b8538a-d005-47a5-b12c-c38b594e27f8,posted,Uber Ride,-3475.75,ad6eb745-d182-4288-b886-50144f26c55f,-3689.53,debit,cash-withdrawal,AU00000,2024-02-05T05:53:58Z
transaction,87baec12-1c7b-412c-b269-0a5ca068accf,posted,Bookstore Purchase,-1151.79,5665b488-def1-4d79-9828-a21c565d187a,-4841.32,debit,cash-withdrawal,AU00000,2023-12-06T23:39:19Z
transaction,6a394405-06e8-470f-915b-921703f0bd6d,posted,Coffee Shop Purchase,-265.57,96ec59d0-b920-4edb-89c1-63652bd5ef6a,-5106.89,debit,payment,AU00000,2024-02-03T15:49:02Z
transaction,e621ab53-1296-4ff1-b17f-7fa781a80a4c,posted,Public Transport Fare,-667.06,b688abf5-b254-4396-a2d7-ca596cd56e5c,6007.73,debit,payment,AU00000,2023-12-02T12:55:29Z
transaction,b1628767-6d67-4b99-9161-3eefb03287e3,posted,Hair Salon Appointment,-4882.63,284a348b-3208-4a4e-8e8b-404ebccd7f76,1125.1,debit,payment,AU00000,2024-01-26T04:40:51Z
transaction,85b2195c-72d5-40de-8e0f-8e2116c3395f,posted,Amazon Online Shopping,-937.59,aa8cce5b-3879-4a36-a1a4-bcfac490aa15,187.51,debit,bank-fee,AU00000,2023-05-17T12:51:53Z
transaction,e9484d6c-01a7-406c-97ac-49c28e4dafd0,posted,Mobile Phone Bill Payment,-1547.05,20393067-ae85-4a3b-a762-f1d6771e8e1d,-1359.54,debit,bank-fee,AU00000,2023-11-20T11:52:56Z
transaction,23c7d30c-17d3-4742-96d6-77299896388f,posted,Mobile Phone Bill Payment,-3309.57,371149b0-113e-4ff2-b711-833bdb5d3467,-4669.11,debit,cash-withdrawal,AU00000,2023-10-07T10:21:17Z
transaction,6dae6efe-2253-4015-9079-11aee3fe3f3c,posted,Public Transport Fare,-529.87,846c45d3-80fb-467b-b1f5-c515b0e01182,-5198.98,debit,cash-withdrawal,AU00000,2024-01-10T12:23:53Z
transaction,a8013dd1-f2a7-496d-885e-b9dfc93b0946,posted,TFR Acc14000 TO 12389,-2883.07,bd12b94a-1f6e-4898-b546-ec158580f9d8,-8082.05,debit,payment,AU00000,2023-12-03T13:21:13Z
transaction,55ed402b-385d-4859-a14b-0bfbd5bd04d1,posted,Clothing Store Purchase,-4824.12,c743f84d-c883-4616-bc1a-5d05025ac7a0,-12906.17,debit,cash-withdrawal,AU00000,2024-04-12T02:34:31Z
transaction,646fba5c-9e34-43aa-b60a-1e35e9606909,posted,AGL RETAIL ENERGY LTD (GAS),-4132.95,18995784-c9e9-44b3-a5c9-2b39782f3cf4,-17039.12,debit,bank-fee,AU00000,2024-04-13T07:56:31Z
transaction,36cdccee-a980-4923-a4a6-60d5017b1084,posted,Netflix Subscription,-4984.78,61bf8825-5555-4a0e-b354-15585b837538,-22023.9,debit,cash-withdrawal,AU00000,2024-01-18T22:59:16Z
transaction,db5358b0-d4c3-4762-8380-b853b97a73a1,posted,Travel Agency Booking,-4656.47,da7c06f8-13ba-4a84-8fbf-3946f778283b,14836.66,debit,cash-withdrawal,AU00000,2023-06-05T09:50:15Z
transaction,b22bbf55-8c08-43a7-8bd6-aac5f1f16437,posted,TFR Acc14000 TO 12389,-1570.19,390ca65d-48c4-4c23-ad3e-144ca34bd145,13266.47,debit,cash-withdrawal,AU00000,2023-07-19T19:12:16Z
transaction,8b5bb4aa-837e-4ddb-ae44-c2ddc8c882e4,posted,Bookstore Purchase,-4179.41,4bf6b3c2-d802-4fb1-87e8-8103f15f7f0c,9087.06,debit,payment,AU00000,2023-07-05T06:43:25Z
transaction,4853e6cb-ec96-4505-9fcd-712f4b14e79e,posted,Travel Agency Booking,-3480.84,0f19af76-b38f-4f1b-92a4-db3d03eba547,5606.22,debit,cash-withdrawal,AU00000,2023-10-01T13:28:28Z
transaction,ed7a14d5-958e-4d33-94fc-081e0946cb34,posted,Car Maintenance Expense,-1098.92,af55df93-bee8-4068-a3e6-efea48014462,4507.3,debit,bank-fee,AU00000,2023-06-12T22:29:19Z
transaction,9b213248-5e4d-456a-9148-eb3a262f0d3c,posted,Gym Membership Fee,-2087.58,2b06c2ce-a51b-4182-a1b8-23174dca4164,2419.72,debit,cash-withdrawal,AU00000,2023-06-19T22:16:57Z
transaction,3d443d5c-fdae-4215-87a9-adcfb3963def,posted,Mobile Phone Bill Payment,-493.59,540790d2-c621-4430-b13e-b77b3b5b35fb,1926.13,debit,bank-fee,AU00000,2023-10-27T20:26:08Z
transaction,5ff65549-b2e6-4da1-aa52-b535bf8ea8d7,posted,Clothing Store Purchase,-3425.97,509bca0c-7782-490f-a2c5-01594266d4d3,-1499.84,debit,cash-withdrawal,AU00000,2023-08-29T16:17:00Z
transaction,27038d6e-9a39-42ae-8fb9-3668d091de91,posted,Netflix Subscription,-2320.33,c6caa2c2-31ce-44c6-991c-4ec727ad853c,-3820.17,debit,bank-fee,AU00000,2023-12-17T09:04:09Z
transaction,83b20fdf-6276-4568-9284-d066ac149d36,posted,TFR Acc14000 TO 12389,-3347.94,e2090869-b744-4b07-b59a-a6acf65538d1,-7168.11,debit,bank-fee,AU00000,2023-07-09T12:19:48Z
transaction,c96a83f9-256b-4d99-b1b5-a927b004729b,posted,Amazon Online Shopping,-1587.8,96402894-3890-4f52-a960-ad44db739a14,10889.09,debit,cash-withdrawal,AU00000,2024-03-17T07:39:54Z
transaction,2086de65-1ce4-4e2e-a51e-43be655b702d,posted,Manly Maths Tutor Wages,-3056.0,87d40d6a-ec39-4e22-8ecb-f69b8c63ea3b,7833.09,debit,cash-withdrawal,AU00000,2023-06-05T14:12:11Z
transaction,564b025d-0e08-4bf2-a906-0d7edc3ffbec,posted,Transfer Platnm Homeloan 346454,-4775.78,a1dfdc64-2e3c-412e-9a05-9c40b110222b,3057.31,debit,payment,AU00000,2023-09-12T04:28:09Z
transaction,2f8d78a3-cdc1-4920-9278-3d6c31d5742a,posted,Netflix Subscription,-3249.06,11d99637-e639-4220-bc98-0aa8e2d1f5d7,-191.75,debit,bank-fee,AU00000,2023-09-24T16:31:00Z
transaction,8c3a014f-c64d-44df-a2db-362e7e2bed3d,posted,Amazon Online Shopping,-4668.02,dd0ebba9-4aae-463d-a775-689ab4224919,-4859.77,debit,cash-withdrawal,AU00000,2023-12-26T08:30:27Z
transaction,d753594a-9c44-47db-84ee-dd6d5a6604b4,posted,Transfer Platnm Homeloan 346454,-2125.21,66c9022e-f6a7-490e-bbc6-db58b3501c66,-6984.98,debit,bank-fee,AU00000,2023-10-29T15:28:14Z
transaction,77166b85-2ebd-4cee-916c-a228235eaa17,posted,Restaurant Dinner,-2431.98,b7f46e13-afff-4213-88d4-01a86b7b9a8b,-9416.96,debit,bank-fee,AU00000,2024-03-23T03:10:35Z
transaction,e87afbed-8cb9-4a1b-9e33-b2b32aff607f,posted,Uber Ride,-4443.54,5b932d7d-8a60-4026-8332-bf546756c919,-13860.5,debit,bank-fee,AU00000,2023-10-29T11:15:45Z
transaction,827861e9-f73a-4737-9fb9-93acb1085356,posted,CTRLINK CARERS Ref: 998R6789201610974V,-2643.08,7bba04a5-883a-4283-8e80-c5c1b46bb936,-16503.58,debit,payment,AU00000,2023-08-10T04:40:48Z
transaction,2a5055b9-4af7-435b-a4dd-ea590e752898,posted,Home Improvement Store Purchase,-1454.62,76615339-4494-4d91-9d0e-51e028e62589,-17958.2,debit,payment,AU00000,2023-12-19T18:51:00Z
transaction,1a414e70-c60f-4b9c-a7da-2beaa06c33e8,posted,Manly Maths Tutor Wages,-4490.4,e8c55837-3ffa-4ea0-bcbc-c31f4d15a0fd,10084.32,debit,payment,AU00000,2023-08-27T00:00:53Z
transaction,de5e167c-24d4-493e-8175-1cc314d7bbaf,posted,Payroll WFRMS 15439393,11082.67,9f810164-0074-48f1-8128-fbea1c5c5da6,21166.99,credit,transfer,AU00000,2023-11-21T10:02:12Z
transaction,43b640f3-d361-4b09-b644-5094cba43e66,posted,Bookstore Purchase,-1369.7,a5495d67-1121-405e-a084-0cdee0fbec88,19797.29,debit,cash-withdrawal,AU00000,2023-06-02T11:16:46Z
transaction,74426a6d-1698-4c84-82e1-9e36bc944e7c,posted,Pharmacy Purchase,-2177.26,d1415524-5f14-42c7-b8d6-e3d290a97100,17620.03,debit,payment,AU00000,2024-04-30T11:03:25Z
transaction,da30933a-8d3e-4744-b486-031f274d3861,posted,TFR Acc14000 TO 12389,-308.88,2983fcff-52a3-4590-9f52-2c366c621639,17311.15,debit,payment,AU00000,2023-11-27T13:35:53Z
transaction,9601c465-bdc6-4f16-bc24-11eace69bcd2,posted,Bookstore Purchase,-3413.14,10177ad4-0dc2-47c7-a269-67f07520fdd2,13898.01,debit,cash-withdrawal,AU00000,2023-09-23T10:35:55Z
transaction,e7ec3778-d42d-403a-94a9-27ccc4c3c9a0,posted,Amazon Online Shopping,-1814.34,0dc92625-7bd3-4d1f-bf7a-a6521f64f1b2,12083.67,debit,cash-withdrawal,AU00000,2023-06-10T17:06:26Z
transaction,8afae14c-753b-460e-910c-9816e9289765,posted,Gasoline Purchase,-863.98,d4bba6d8-696e-4f5a-a0e7-c79b0f72c8d4,11219.69,debit,payment,AU00000,2023-05-31T22:05:03Z
transaction,3a7d9adf-b8cc-4016-bd56-ac4b853e0e04,posted,Coffee Shop Purchase,-2385.97,d4da7cd1-1a5e-4cf7-ab7c-222c1606dfa4,8833.72,debit,bank-fee,AU00000,2023-07-26T03:25:37Z
transaction,1b6e5257-c10e-4143-8f08-edebe0694030,posted,Transfer Platnm Homeloan 346454,-765.79,7de0b8fe-8d06-4d86-95e1-c44fcdb17adf,8067.93,debit,bank-fee,AU00000,2024-03-28T15:59:03Z
transaction,06c6fd05-0ad2-4ede-b21b-7e2d78e3df7a,posted,Uber Ride,-4820.58,c6c4f4be-0832-4ca9-844f-b22081c50947,9304.41,debit,cash-withdrawal,AU00000,2024-03-30T03:35:50Z
transaction,ec08ff49-fd52-4b56-92ee-1247c3e353a5,posted,Bookstore Purchase,-1636.69,ec54318f-9aee-45c8-b05c-1bff1738119c,7667.72,debit,bank-fee,AU00000,2023-10-25T07:24:41Z
transaction,75ee493a-6cf0-4c56-a630-9f0d2481ebea,posted,Hair Salon Appointment,-806.6,a1f93247-aa84-4eb5-b2be-ce0807638a04,6861.12,debit,payment,AU00000,2023-07-16T02:42:09Z
transaction,f93f47f7-a1d6-4520-a19f-899f3067bc4b,posted,CTRLINK CARERS Ref: 998R6789201610974V,-1050.38,2c85d1f3-6f93-43c9-b7d6-6ba37efba0f4,5810.74,debit,bank-fee,AU00000,2023-12-19T09:17:19Z
transaction,26c3ca69-37c8-4878-adff-6dd9897d9061,posted,Hair Salon Appointment,-859.16,67bdea87-d8b6-40d8-a812-86993dd603db,4951.58,debit,payment,AU00000,2024-03-02T11:06:34Z
transaction,10de9c13-50ac-4fd9-b8a3-adce29cb70dc,posted,Amazon Online Shopping,-3654.41,e0a8a947-75e3-4803-98c3-e4f56524a111,1297.17,debit,cash-withdrawal,AU00000,2023-12-13T19:01:26Z
transaction,d3ac7b80-77c4-4b39-bb83-a12f0bbfecb4,posted,CTRLINK CARERS Ref: 998R6789201610974V,-4859.82,3a1edd92-0aa8-4a03-8570-e10db56ba65e,-3562.65,debit,payment,AU00000,2023-06-21T07:30:21Z
transaction,260cb8b6-5364-4e58-bd94-fc0fe3126972,posted,Online Gaming Purchase,-2211.58,e8b70ec6-f6d1-4893-b720-3625ef2c616a,-5774.23,debit,payment,AU00000,2023-10-07T15:10:34Z
transaction,471c525b-f42b-4b3a-a62b-e87d64f0df25,posted,AGL RETAIL ENERGY LTD (GAS),-1219.77,e7afab2e-647a-4fc6-9cdc-ca4d539653fb,-6994.0,debit,bank-fee,AU00000,2023-11-04T11:44:07Z
transaction,2471c5ea-8129-4e7e-926d-ee9e2e58e5f8,posted,Public Transport Fare,-2229.18,9caa89ef-ed76-40fc-a270-348efb9a0a67,-9223.18,debit,bank-fee,AU00000,2024-01-28T13:23:57Z
transaction,09cfdb6d-3827-4f3a-8b61-5f1bd781cefb,posted,TRANSFER TO JOANNA SMITH CAMPING,-4620.11,fcefdd3c-2a73-48f0-954d-d53136d97cb1,7804.75,debit,bank-fee,AU00000,2023-12-26T20:17:47Z
transaction,e4ef91c3-3bc1-4058-adec-78d0e9caff61,posted,Car Maintenance Expense,-198.37,d9a87f9e-87a7-4eb5-b011-96ed3fa1fcc2,7606.38,debit,payment,AU00000,2023-10-20T00:02:37Z
transaction,79d3125f-864a-465f-89c7-1c52e91c732f,posted,Gasoline Purchase,-4306.2,d480ae2b-254d-48c8-8510-f87434064c89,3300.18,debit,bank-fee,AU00000,2023-12-30T10:30:58Z
transaction,0e5b3be8-488f-4e20-a6be-aea142805cb6,posted,Clothing Store Purchase,-4768.2,9d2ac860-6b41-4fac-bca2-f30d717bde34,-1468.02,debit,cash-withdrawal,AU00000,2023-10-01T12:47:35Z
transaction,9e528abb-794a-4b73-9658-8131464cc7dd,posted,Amazon Online Shopping,-1785.32,3e917654-e5e0-427d-af44-5c684c16e448,-3253.34,debit,bank-fee,AU00000,2023-08-24T13:31:39Z
transaction,ab86f512-def2-41d3-bbb7-2186f1a92b5a,posted,Gym Membership Fee,-697.52,983db18a-e35f-4a21-871f-b00768b1805e,-3950.86,debit,bank-fee,AU00000,2024-04-03T09:23:23Z
transaction,bae6b9fa-bf57-44c0-8c5d-91e93a1ab5fb,posted,Movie Ticket Purchase,-3590.38,73e8db55-f80c-4d50-82c4-404f850ce65e,-7541.24,debit,payment,AU00000,2023-08-24T01:55:20Z
transaction,75f40642-3036-4ff1-a007-b8e731b91837,posted,Online Gaming Purchase,-186.35,7fe647a1-7b98-4752-a3a0-1d28894d307c,-7727.59,debit,cash-withdrawal,AU00000,2024-01-27T01:16:46Z
transaction,fa9dfd7d-b070-41e2-a6f0-889de9621085,posted,Wdl ATM WESTPAC IGA BALGOWLAH BALGOWL AU,-4731.55,1c4cc22a-a037-4fd8-af58-14fa4c18eed0,-12459.14,debit,payment,AU00000,2023-09-18T22:03:17Z
transaction,b5cf49c4-868f-4f3b-a556-bf496e82f4b0,posted,Clothing Store Purchase,-665.05,38dd2013-ee85-4445-ab64-740587726faa,-13124.19,debit,cash-withdrawal,AU00000,2023-11-28T00:24:10Z
transaction,b50b7c49-9688-4d27-9411-c1886d958ea0,posted,Coffee Shop Purchase,-432.1,e5031375-db92-4532-ba9f-2a0b5a708968,9961.1,debit,bank-fee,AU00000,2024-01-02T22:07:56Z
transaction,73efe73f-e9f7-4ed9-89c5-b59aafd04b5b,posted,Manly Maths Tutor Wages,-1131.46,2019d31e-4f58-4be7-ae92-c8a36036bec6,8829.64,debit,payment,AU00000,2023-09-06T19:55:09Z
transaction,6604001a-ddcb-492d-8579-e456ba31a8a0,posted,Music Streaming Subscription,-4757.86,84c7f632-4355-4fed-b6a4-74ff5704b045,4071.78,debit,payment,AU00000,2023-07-22T10:27:06Z
transaction,6676945e-76ed-4484-b0a3-d9e47033b41e,posted,Coffee Shop Purchase,-1007.86,83437c87-2059-4db4-8420-a410f82a9bf4,3063.92,debit,bank-fee,AU00000,2023-12-03T02:11:16Z
transaction,95eec4bd-1941-4d9d-8da2-e926cd4ea9f3,posted,Clothing Store Purchase,-3683.32,fb317432-b381-464d-95d2-45aa174a0965,-619.4,debit,payment,AU00000,2023-10-17T06:48:40Z
transaction,9b59c0bc-5759-4a67-8ca0-d91bc8ea07a1,posted,TFR Acc14000 TO 12389,-1240.88,c3d54832-a609-4d4c-81bd-60eea2e95e73,-1860.28,debit,payment,AU00000,2024-03-04T05:38:57Z
transaction,adf5a132-c1f3-48d6-bc90-3f6ba8eb4578,posted,Clothing Store Purchase,-4317.25,495c0291-c048-4148-be3c-dac6e779f6db,-6177.53,debit,payment,AU00000,2024-02-23T06:02:07Z
transaction,4e494490-7b50-40a8-b742-2a00c92e8e6f,posted,Music Streaming Subscription,-701.05,5673e7b8-6217-459a-a9fb-2ddcd446e7b4,-6878.58,debit,cash-withdrawal,AU00000,2023-12-07T09:04:14Z
transaction,69959182-a3a3-447c-86b8-1e898c0803de,posted,Netflix Subscription,-1331.08,9f6a935d-af8a-4d8e-87ba-a842e8666ebd,-8209.66,debit,bank-fee,AU00000,2024-04-22T06:55:25Z
transaction,e8c5d798-c313-42d5-8386-4d2bce35c439,posted,Car Maintenance Expense,-2354.63,d72a2f92-076e-4884-9290-896fa1ca2423,-10564.29,debit,bank-fee,AU00000,2023-10-22T21:05:53Z
transaction,37d01ba9-7b26-4295-97ef-4107afaf5aa9,posted,Wdl ATM WESTPAC IGA BALGOWLAH BALGOWL AU,-4790.43,092903a3-e772-4076-a4a0-a0d2e69f098c,8912.08,debit,cash-withdrawal,AU00000,2024-03-21T19:34:28Z
transaction,e4d93b21-7306-4e7a-91de-37e6629f0402,posted,Uber Ride,-3757.53,7c4f55b0-642a-4df0-b6ae-75e927911a74,5154.55,debit,cash-withdrawal,AU00000,2023-05-22T13:02:41Z
transaction,8dac7b6e-45f1-48ee-943c-cf8b81db3ab2,posted,AGL RETAIL ENERGY LTD (GAS),-2091.26,7ca4258b-39a6-434a-8d1b-d0eae56e26c6,3063.29,debit,bank-fee,AU00000,2024-04-05T14:24:54Z
transaction,ce33c17f-af82-478e-acb7-b448138c247c,posted,Mobile Phone Bill Payment,-4747.06,87512b0d-b62d-4a64-80ee-98deb09b09bb,-1683.77,debit,cash-withdrawal,AU00000,2024-04-11T19:24:03Z
transaction,7d494976-5395-4952-9901-c04a15c4fea3,posted,Amazon Online Shopping,-3884.14,68dbac13-751e-4ed7-9a72-fc2657ebbda1,-5567.91,debit,bank-fee,AU00000,2024-01-02T08:18:51Z
transaction,3cf00887-b124-4ce0-b8c4-5c936bbba271,posted,Public Transport Fare,-2812.96,029858f5-11b6-4b73-a087-624b0940f73c,-8380.87,debit,bank-fee,AU00000,2023-11-15T12:55:43Z
transaction,33853d5b-3b45-472e-a657-7730b8c1abad,posted,Electricity Bill Payment,-3117.92,743d4a43-8666-4136-ac78-e89a285460ff,-11498.79,debit,payment,AU00000,2023-06-06T08:20:33Z
transaction,c24d46ac-62ef-4c08-af6e-7e1560539f6e,posted,Online Gaming Purchase,-2983.32,cb143b9b-8bce-4c40-a165-d21e3c721bc1,-14482.11,debit,bank-fee,AU00000,2024-01-26T14:09:15Z
transaction,ceb0dc46-1cc8-427a-b667-ac888c6a9efd,posted,CTRLINK CARERS Ref: 998R6789201610974V,-4356.58,45b57691-ccca-48a2-9637-cc12a1474841,-18838.69,debit,bank-fee,AU00000,2024-04-02T15:48:01Z
transaction,4099b5ed-8ebb-4fc5-b6be-48a7354b823a,posted,Netflix Subscription,-4657.32,068f40e2-0953-45af-9da4-60eeca3c999f,-23496.01,debit,cash-withdrawal,AU00000,2024-04-18T21:12:11Z
transaction,026178fd-fc24-49da-9863-0e5527e581df,posted,Coffee Shop Purchase,-4778.52,567bf2ed-337f-44cc-b663-ae7c7d665bf7,1282.8,debit,payment,AU00000,2023-08-25T15:19:09Z
transaction,57f1ff07-4eea-4c2f-9c9a-3de871a25b2c,posted,Music Streaming Subscription,-3289.99,a6930760-d81e-4b52-a932-858bed9f7b57,-2007.19,debit,payment,AU00000,2023-08-25T16:16:07Z
transaction,3b373c36-2e35-40e7-922a-c2693d7fa773,posted,Amazon Online Shopping,-263.57,352ec72f-e8fc-4292-a373-5c336a5d3fd3,-2270.76,debit,bank-fee,AU00000,2024-04-28T22:51:31Z
transaction,0857cff3-b590-4d6c-8061-e9d957a72949,posted,Non Hooli ATM Withdrawal Fee,-602.29,ff6789ee-6502-425e-9a21-403b5d6528a5,-2873.05,debit,cash-withdrawal,AU00000,2023-09-10T09:33:28Z
transaction,6928c781-e348-4269-a91d-bbc06b46f46a,posted,Pharmacy Purchase,-4504.46,bdf2d39d-014c-4001-a619-af324651c1f7,-7377.51,debit,payment,AU00000,2023-06-14T22:56:39Z
transaction,8c3b3d8f-d020-49b2-be04-e2dabb86e960,posted,TRANSFER TO JOANNA SMITH CAMPING,-740.02,bca30917-4453-4a2a-b517-4d804fb71757,-8117.53,debit,cash-withdrawal,AU00000,2023-07-28T20:28:53Z
transaction,c3dea365-e3d1-4243-b48d-12de97af346f,posted,Online Gaming Purchase,-2096.65,bd2d4d09-692c-41e7-b37b-06e927e6ade0,-10214.18,debit,payment,AU00000,2024-02-12T10:34:13Z
transaction,8f491e67-110b-426c-87ae-54fd37dfdcbd,posted,Netflix Subscription,-1544.98,a04cda79-33cb-4727-9efb-d7269c9650b6,-11759.16,debit,cash-withdrawal,AU00000,2023-12-10T18:00:49Z
transaction,bf12fded-8e09-4aef-abf1-42935b1b25cb,posted,Clothing Store Purchase,-3833.73,ab5cc629-a37b-4dcf-bcd9-7036dbf7390d,-15592.89,debit,cash-withdrawal,AU00000,2023-08-19T10:19:49Z
transaction,eaea6129-638c-4eae-815e-5520e9662d81,posted,Gasoline Purchase,-73.52,26a88afb-b4e5-43e4-9968-12b1df12d607,-15666.41,debit,payment,AU00000,2023-07-25T06:01:17Z
transaction,1177629a-2582-4089-a093-c1c00eaccf56,posted,TRANSFER TO JOANNA SMITH CAMPING,-2997.05,69d385b0-fc3e-4092-9ffb-b7d934290a41,5974.92,debit,bank-fee,AU00000,2023-10-09T15:45:25Z
transaction,f52a34e2-52cd-4c0b-bb10-a5837bc6b165,posted,Hair Salon Appointment,-2828.97,81b077e9-d65b-41af-b91a-df12e6ebe1c5,3145.95,debit,bank-fee,AU00000,2024-02-05T20:38:53Z
transaction,b7dfebfd-465a-4c24-9adf-667ab2facc39,posted,Gasoline Purchase,-1904.27,bb0a444e-6449-447d-a11d-3dd8aa55d1cb,1241.68,debit,payment,AU00000,2023-09-28T08:00:51Z
transaction,e3d81591-2f33-4e78-8659-7679a541bed6,posted,Music Streaming Subscription,-3253.27,b30a75fa-485a-40cb-8352-02a2f6ec0e27,-2011.59,debit,bank-fee,AU00000,2024-04-06T11:14:06Z
transaction,2652d734-c0f7-4dd9-a912-4e346a42d50a,posted,Uber Ride,-2118.24,d1988d21-d17c-4833-b068-7966975d4726,-4129.83,debit,bank-fee,AU00000,2023-07-24T04:28:48Z
transaction,9999c6cd-210b-486d-a2f2-cb4c47e391b0,posted,Restaurant Dinner,-2116.61,1bdd7d27-541d-4133-849b-8b5158291ad0,-6246.44,debit,bank-fee,AU00000,2023-10-05T15:34:54Z
transaction,67ba5677-edbe-49af-8bd9-e206edcd1d28,posted,Pharmacy Purchase,-1534.59,0859a933-fcb4-4c1d-9f8f-a31ca787dece,-7781.03,debit,cash-withdrawal,AU00000,2024-04-07T03:55:29Z
transaction,75773a7f-a499-4452-8edf-9d11496f7024,posted,Non Hooli ATM Withdrawal Fee,-4743.38,11b03969-973a-4157-82bf-6e02b5b44e52,-12524.41,debit,payment,AU00000,2024-01-08T23:10:51Z
transaction,d09c3c7e-d4e3-421b-9a85-cf0191dc65df,posted,Amazon Online Shopping,-2345.18,dfb905f9-aacb-4f9d-8e60-7fe708b64236,-14869.59,debit,payment,AU00000,2024-02-27T00:27:46Z
transaction,c0038a01-979b-4e03-b285-048e0fab40ac,posted,Wdl ATM WESTPAC IGA BALGOWLAH BALGOWL AU,-4677.02,de8ffa1c-9156-4ee9-a869-9cf7dfd01e4d,-19546.61,debit,cash-withdrawal,AU00000,2023-08-11T05:20:43Z
transaction,d7543391-a42e-4813-ba19-65e327477ee0,posted,Mobile Phone Bill Payment,-342.73,04cf968c-f5df-4115-8412-a0c2f04b242f,16054.86,debit,cash-withdrawal,AU00000,2024-04-26T19:19:36Z
transaction,9a3ad798-a716-4ba7-b018-b10788f2530b,posted,Payroll WFRMS 15439393,10199.45,d9aa4e2e-8b8c-4665-9077-d53bfd3182ce,26254.31,credit,transfer,AU00000,2024-02-21T16:38:25Z
transaction,cdade604-8ec6-4c73-a7e8-eb98e02afb3e,posted,Restaurant Dinner,-4991.61,db82b67a-c952-4086-a38b-5bace2026367,21262.7,debit,payment,AU00000,2023-12-21T18:20:09Z
transaction,6ace1b0a-526d-4878-87a0-369b1a6775a2,posted,Gym Membership Fee,-3831.54,bfc1e2d6-97fe-430b-b936-2349afadb96d,17431.16,debit,payment,AU00000,2023-12-22T00:47:42Z
transaction,9bc30840-c10b-4345-9286-f40bb52b84a7,posted,AGL RETAIL ENERGY LTD (GAS),-3014.07,cab1f0eb-66df-42b4-979d-1925425809d9,14417.09,debit,payment,AU00000,2023-11-17T14:59:48Z
transaction,c8e6434d-eff5-41de-b09a-4d173f6811bd,posted,Gasoline Purchase,-1798.36,9b0a3adf-e5a6-4367-9625-eb16463c0d04,12618.73,debit,payment,AU00000,2024-01-18T02:40:49Z
transaction,f7c531b9-446f-4069-ac6d-1695baccf1a6,posted,Manly Maths Tutor Wages,-3092.81,647cba08-e136-483d-8ac8-b59586303033,9525.92,debit,bank-fee,AU00000,2024-02-22T22:30:47Z
transaction,4afb390a-1529-4d52-8226-f994c307f84e,posted,Public Transport Fare,-4727.6,560a7586-fdbd-40c0-884a-b036f5974bd4,4798.32,debit,bank-fee,AU00000,2023-09-12T04:37:27Z
transaction,ae264a31-79ca-4dfc-8ad7-1b5f97de39e9,posted,Payroll WFRMS 15439393,10878.66,3d1f214a-1131-42b9-9d0c-c52df455619d,15676.98,credit,transfer,AU00000,2023-10-25T11:20:02Z
transaction,b6fde564-ddba-4188-8436-bc07544007a3,posted,Gasoline Purchase,-3988.4,31215cb9-2f1d-4b8e-82fb-e8ab4119ca75,11688.58,debit,bank-fee,AU00000,2023-11-12T12:09:42Z
transaction,670e30dc-2003-4661-bcf2-307eeadf3dd0,posted,Pharmacy Purchase,-4235.8,ba2a9d94-ba31-4a94-b220-0a8305e8a6ad,6451.47,debit,bank-fee,AU00000,2023-12-07T15:29:52Z
transaction,96baa0c4-05e9-4fc9-bfca-73c84110921f,posted,AGL RETAIL ENERGY LTD (GAS),-3434.12,84b41b31-2ad8-44e5-9ad2-6a6b30c96ded,3017.35,debit,payment,AU00000,2023-05-31T03:03:30Z
transaction,b5b18745-787c-47ce-87cc-ca1c62f2d4e7,posted,Public Transport Fare,-758.83,9cbd00b5-e40c-4af1-8748-b8575e939010,2258.52,debit,cash-withdrawal,AU00000,2024-02-21T10:50:59Z
transaction,aa64bfae-64ab-45aa-aaa6-e4dae3c95c20,posted,Public Transport Fare,-3086.17,84cac5bb-1584-447e-94e2-e75d93ce1d47,-827.65,debit,payment,AU00000,2023-06-17T04:08:56Z
transaction,179e33b7-fb09-48ca-a9c0-8374409e8592,posted,Transfer Platnm Homeloan 346454,-1197.97,c07f5d80-dedf-4f20-afc1-7f653b2292a2,-2025.62,debit,cash-withdrawal,AU00000,2023-11-06T21:00:35Z
transaction,fa67fa02-49e7-49fa-8896-c57608d75e3d,posted,Non Hooli ATM Withdrawal Fee,-2411.13,fcb3eb06-2cd8-4d9a-b213-53de723dc8de,-4436.75,debit,payment,AU00000,2023-09-03T18:18:02Z
transaction,9e6655fb-531a-49e2-ae33-190c0106f3fd,posted,Home Improvement Store Purchase,-4598.91,1903dd03-38ef-4e7c-a0c8-b908d43ecd78,-9035.66,debit,payment,AU00000,2024-03-14T01:28:57Z
transaction,d647f60d-1f15-422a-940c-e67c7a84389f,posted,Wdl ATM WESTPAC IGA BALGOWLAH BALGOWL AU,-558.86,b70d081d-c56d-49c5-92f6-88cbbfa38517,-9594.52,debit,bank-fee,AU00000,2023-12-21T19:26:58Z
transaction,c70dcc7b-3889-4a7f-9e3c-bf8290545891,posted,Hair Salon Appointment,-1256.81,67412b69-6407-4f44-8483-063cabcd651e,-10851.33,debit,payment,AU00000,2024-01-16T16:34:57Z
transaction,5e1d74dd-0514-4618-9d17-261648e4150d,posted,Home Improvement Store Purchase,-590.86,c50970fc-ab76-4f78-933c-493fe69de260,-11442.19,debit,payment,AU00000,2024-05-03T01:52:51Z
transaction,fb53c816-bdd1-4577-8620-bf561b588686,posted,Hair Salon Appointment,-4185.98,e5a61833-715f-4f23-98d0-61685397eb66,15415.56,debit,payment,AU00000,2023-10-01T16:29:50Z
transaction,82a0d008-e713-4916-9f5c-b302fac7631b,posted,Clothing Store Purchase,-1255.03,e061a350-0357-4e45-98ee-4ea8b6fcb26e,14160.53,debit,cash-withdrawal,AU00000,2024-01-18T18:22:14Z
transaction,2b1bdd93-6da0-4fa3-a6dd-f1869862d6bf,posted,Wdl ATM WESTPAC IGA BALGOWLAH BALGOWL AU,-1874.07,02e424fd-1021-45cb-82f2-0cf64195b38f,12286.46,debit,bank-fee,AU00000,2024-03-26T01:05:18Z
transaction,11213a67-04ad-48d9-a18e-6589b33e4be7,posted,Bookstore Purchase,-294.66,cc2a4c8d-cf46-454b-b931-836a05ac4f3b,11991.8,debit,cash-withdrawal,AU00000,2023-09-03T21:05:31Z
transaction,7a4035fd-c1f8-48a6-a1d0-645000486ffb,posted,Payroll WFRMS 15439393,10812.89,5ffe6f06-211a-4d2a-b995-b0a3e6949fbb,22804.69,credit,transfer,AU00000,2023-12-12T14:42:28Z
transaction,0a0c9b5d-fcfb-4c48-a1da-1c014b85b196,posted,Home Improvement Store Purchase,-3054.17,17f87d19-3ed5-4dce-904b-61c0b1dede0c,19750.52,debit,cash-withdrawal,AU00000,2024-02-12T17:58:00Z
transaction,6fea6180-8497-4227-b9c6-6272ffbb0d58,posted,Bookstore Purchase,-2862.57,b053d54f-c285-4567-ac7c-14a3854c495f,16887.95,debit,bank-fee,AU00000,2023-07-24T20:25:05Z
transaction,5dc60f60-1a09-4cf4-a70c-c185c71d1fb2,posted,CTRLINK CARERS Ref: 998R6789201610974V,-1171.57,c303d97b-c408-43cc-9a79-8ece8408df36,15716.38,debit,cash-withdrawal,AU00000,2023-11-17T10:49:45Z
transaction,045b519d-26b9-4705-a0fd-33434fc6b3dd,posted,TRANSFER TO JOANNA SMITH CAMPING,-2888.58,4bc699b7-6a5c-41a6-b614-16fe5ceec656,12827.8,debit,cash-withdrawal,AU00000,2023-07-07T19:41:28Z
transaction,810ed7df-fc14-4180-8d6f-ab42bedafd01,posted,Mobile Phone Bill Payment,-1103.21,8bf4ea11-720e-4ece-a904-24efcd7c2251,11724.59,debit,payment,AU00000,2024-01-08T09:36:05Z
transaction,1562bf24-4e4d-41ac-b9e9-644da333c8b4,posted,Mobile Phone Bill Payment,-906.51,937a8348-62a7-49d6-97ef-5260bc92848c,12119.06,debit,payment,AU00000,2023-06-01T17:18:43Z
transaction,c1ffb2f4-bbd9-4d26-aff1-1525434fa260,posted,TRANSFER TO JOANNA SMITH CAMPING,-4575.15,0a3092d4-3cba-4d85-9071-dd9146ee9995,7543.91,debit,cash-withdrawal,AU00000,2024-04-24T19:43:43Z
transaction,a4584d50-0cc9-4d46-a0f0-4ce051009ac2,posted,TRANSFER TO JOANNA SMITH CAMPING,-1295.94,c9ba8a4a-d5c9-4a2c-8827-2fc15dc8e9aa,6247.97,debit,bank-fee,AU00000,2023-06-22T10:02:18Z
transaction,88386215-c8f1-4251-bd27-8129e72bd4a0,posted,Manly Maths Tutor Wages,-3836.95,90fe73c0-da82-43db-accc-d7127cf842ff,2411.02,debit,cash-withdrawal,AU00000,2023-10-04T17:13:31Z
transaction,3f83f2ef-a42a-437a-b2c2-734e4a4df083,posted,Netflix Subscription,-857.32,889a88ce-bf9c-4559-8ca8-d249039434ae,1553.7,debit,cash-withdrawal,AU00000,2024-04-29T05:28:44Z
transaction,f8a8ed33-ac89-4637-bc23-a6a2c56c7623,posted,AGL RETAIL ENERGY LTD (GAS),-4974.93,f5e69f90-a5a7-4fde-8150-9ffca7fc9527,-3421.23,debit,payment,AU00000,2024-03-18T19:43:59Z
transaction,9c77cf8a-dad4-49d5-8eb7-38efc7f1383b,posted,TFR Acc14000 TO 12389,-3966.7,9c1a0347-c3be-4204-a6f8-636c11877e91,-7387.93,debit,cash-withdrawal,AU00000,2023-08-27T21:33:29Z
transaction,6f0665d0-554e-49bf-bed6-1263ae47cd02,posted,AGL RETAIL ENERGY LTD (GAS),-4294.08,315061a4-7542-4558-9454-ab70f0c35504,-11682.01,debit,payment,AU00000,2024-02-04T08:29:11Z
transaction,974b8e67-5cfc-49a6-abf7-50203ff87992,posted,AGL RETAIL ENERGY LTD (GAS),-806.9,e68ecfd4-712a-45fa-9b60-5cd806e9a6d7,-12488.91,debit,payment,AU00000,2024-03-26T15:31:52Z
transaction,90e18bb2-f017-4dfc-b9e5-a61de606f9fe,posted,Payroll WFRMS 15439393,11883.42,00752a94-f7cc-4f28-9545-fbcc79398b95,-605.49,credit,transfer,AU00000,2024-03-17T16:07:52Z
transaction,99e7a6e8-5d05-4fa5-abe7-d46e6de95d5e,posted,Clothing Store Purchase,-4760.56,a917edad-e545-4c86-bc4c-434c6723576d,942.37,debit,payment,AU00000,2024-04-11T23:44:54Z
transaction,e8bb0bf2-b580-4b3b-ba29-bd5d1f69f136,posted,Restaurant Dinner,-1307.33,3b068a86-c880-4d89-9167-1f0e0af3db1a,-364.96,debit,cash-withdrawal,AU00000,2023-12-02T04:37:13Z
transaction,5987bdcd-061f-4092-b7a1-f6f59f1c9179,posted,Home Improvement Store Purchase,-908.31,a4806894-73cc-4523-bd84-4703da6e1da6,-1273.27,debit,payment,AU00000,2023-06-09T23:11:47Z
transaction,dfaa3ef4-8350-4801-8dcc-a65ec5c2513f,posted,Mobile Phone Bill Payment,-41.25,cb0c82d4-d3fb-4097-abea-47efb5e5f2e4,-1314.52,debit,cash-withdrawal,AU00000,2023-10-07T12:13:09Z
transaction,c4341695-8853-4a93-be13-995879e32f06,posted,Non Hooli ATM Withdrawal Fee,-4624.0,82d6e67f-1726-476b-96ae-a030613e8a32,-5938.52,debit,cash-withdrawal,AU00000,2023-07-27T12:53:42Z
transaction,df2262dd-3f2e-42ba-beb8-8a583a30cb85,posted,Coffee Shop Purchase,-1774.46,8c5f3070-183e-483b-b504-286d9640359e,-7712.98,debit,payment,AU00000,2023-07-15T23:51:19Z
transaction,6b9b8c6d-4ce7-4831-9ce8-7c380a889f64,posted,Netflix Subscription,-139.66,1f0442a9-fc16-4a83-86eb-aef0e7164b7a,-7852.64,debit,bank-fee,AU00000,2023-07-10T21:43:31Z
transaction,3fbe36a4-057b-4f87-b216-f8e79cf4362f,posted,Public Transport Fare,-745.02,f988f62e-611d-45be-b726-4bb0198e81a2,-8597.66,debit,payment,AU00000,2023-07-28T05:39:44Z
transaction,eafb468c-c493-49ee-a48f-4d268f3be113,posted,Coffee Shop Purchase,-2608.07,38d35420-0022-4061-a861-5d92b62e7e06,-11205.73,debit,bank-fee,AU00000,2024-03-10T17:23:42Z
transaction,a197b83f-a9b5-4bcf-bcdd-c105dc948a27,posted,Clothing Store Purchase,-4257.56,4680cd4b-9ded-4b72-b586-c17c87740f09,-15463.29,debit,payment,AU00000,2024-05-10T00:37:10Z
transaction,f4cd2b72-4dda-4cd3-aa6a-c28bd1c02986,posted,Non Hooli ATM Withdrawal Fee,-2477.98,f55234bb-e10b-4f8d-bfba-265af4c5fa9b,13754.72,debit,payment,AU00000,2023-05-20T23:21:48Z
transaction,3ab78c92-19ad-49c8-a2ed-ee744a9c4ceb,posted,Transfer Platnm Homeloan 346454,-728.34,c6490b5a-dd81-4f03-8459-b9f598d113fc,13026.38,debit,bank-fee,AU00000,2023-09-02T16:05:21Z
transaction,b1d6e115-aea1-4795-b167-7484a696263a,posted,Non Hooli ATM Withdrawal Fee,-3887.82,012d7f7a-cb64-4e34-9649-2b9845189def,9138.56,debit,cash-withdrawal,AU00000,2023-11-04T18:57:23Z
transaction,a25345ec-29f2-45ac-8421-f3870ce8d55d,posted,Public Transport Fare,-2014.9,0fa0055d-ffa2-410d-bdf4-7471f91d94e7,7123.66,debit,payment,AU00000,2024-05-07T23:45:17Z
transaction,ccf41a35-a04f-4097-892a-848c8693c9ae,posted,Movie Ticket Purchase,-3147.63,c7e02dcb-d69f-4011-9ea2-26443a347d2e,3976.03,debit,payment,AU00000,2023-12-24T18:32:38Z
transaction,62a52f27-bc0f-4a25-8a17-b553b32c3662,posted,Uber Ride,-2747.3,9b490f53-e763-4c5c-9bec-16ee90ddfad1,1228.73,debit,cash-withdrawal,AU00000,2024-03-24T09:43:24Z
transaction,4b02bb1b-9d38-46e5-aec6-b379e092949d,posted,Electricity Bill Payment,-1319.54,8f492578-25cd-46cf-94a6-8960d87e3eb1,-90.81,debit,bank-fee,AU00000,2024-04-12T04:10:26Z
transaction,4b3902f5-8247-4e36-a575-6f4ec02d047a,posted,Coffee Shop Purchase,-1469.89,14b58fd0-3adb-4c38-bab9-c16858d6f2ea,-1560.7,debit,cash-withdrawal,AU00000,2023-08-10T05:13:44Z
transaction,d603e805-6b56-4bbc-8373-52e1b8f87823,posted,Home Improvement Store Purchase,-4249.0,ff03e809-c321-4ac2-9e25-d58d8113fa45,-5809.7,debit,bank-fee,AU00000,2024-05-04T23:38:47Z
transaction,b3a14cbc-9069-422d-9b62-22b1e7815038,posted,Gym Membership Fee,-4146.97,9eee0ec7-3b19-45b7-a2bf-00d104eed0d1,-9956.67,debit,bank-fee,AU00000,2023-07-24T15:25:06Z
transaction,816afda0-2e95-4b64-acaa-49c0daae91cf,posted,Bookstore Purchase,-4249.52,1cd7131c-1f1a-4034-8617-932910661642,9767.81,debit,bank-fee,AU00000,2023-06-08T15:12:17Z
transaction,0e573a6b-a3a8-494f-9ee7-5e7c5f610789,posted,TRANSFER TO JOANNA SMITH CAMPING,-1199.76,9bb02a0b-a03b-47d2-801b-f87a836bbb76,8568.05,debit,payment,AU00000,2024-01-16T02:58:44Z
transaction,bbddfc87-9a2f-4456-af75-72749c15becd,posted,Online Gaming Purchase,-2946.83,c172b321-afc3-452e-b010-339d42e75f04,5621.22,debit,bank-fee,AU00000,2024-03-26T21:42:32Z
transaction,a361be6c-7c8a-4977-b674-db7fe07d60ac,posted,Travel Agency Booking,-2606.54,e3068f9b-0744-4d55-bb24-e9264518c382,3014.68,debit,payment,AU00000,2024-03-01T11:45:39Z
transaction,3a0010e6-70a6-456c-8acf-fc733c7b8e25,posted,Hair Salon Appointment,-262.77,fb17350f-8f7c-43c8-877d-f27efb46e7c5,2751.91,debit,bank-fee,AU00000,2023-12-30T01:03:59Z
transaction,bfc338dd-5a05-4ce9-9294-6310acff4d81,posted,Travel Agency Booking,-4475.72,e5f22cfc-a6c2-4b4a-9adb-f2d1e07ed310,-1723.81,debit,bank-fee,AU00000,2023-09-21T12:48:21Z
transaction,07dd875d-9005-4754-b57e-c206db1eb6f8,posted,Coffee Shop Purchase,-1733.49,99a333bb-15af-4da3-9172-2f8cabbae5ab,-3457.3,debit,cash-withdrawal,AU00000,2023-06-22T23:37:13Z
transaction,093dcc65-2d23-4f9d-8494-fdf1480e4d6b,posted,Uber Ride,-526.07,27a41b25-788f-426b-b49c-76bd01b7e5c4,-3983.37,debit,payment,AU00000,2023-08-14T21:19:59Z
transaction,67bb6b0c-c5cf-49e9-aa39-f483e6a49d35,posted,CTRLINK CARERS Ref: 998R6789201610974V,-898.62,0e597387-c841-4f12-976e-c9e601ab9aec,-4881.99,debit,cash-withdrawal,AU00000,2023-07-18T13:39:02Z
transaction,2619a8b8-77f4-4739-9769-3ac6a9e162b5,posted,Mobile Phone Bill Payment,-413.71,3d1aabbb-03ea-42e8-a7c0-8748f2752bb2,-5295.7,debit,cash-withdrawal,AU00000,2023-08-19T17:43:47Z
transaction,f777b074-95ba-44b2-88aa-36de90bf8fb1,posted,Wdl ATM WESTPAC IGA BALGOWLAH BALGOWL AU,-1072.96,566a2df0-517b-4aa8-bb60-1f474a403c3e,4930.26,debit,payment,AU00000,2024-01-13T22:53:40Z
transaction,a3242b62-42d3-4ba1-85c1-fc7169c6ab9d,posted,Pharmacy Purchase,-928.29,ab27f6ac-3453-4fdc-ab5e-58b6d4bb0a38,4001.97,debit,payment,AU00000,2023-08-03T13:19:19Z
transaction,de8fc9e4-9aae-4721-a898-c61687f86680,posted,Amazon Online Shopping,-4617.09,c8c411d0-7bcb-461b-a0ec-8cae83ce2837,-615.12,debit,cash-withdrawal,AU00000,2023-11-21T07:43:01Z
transaction,19d8b023-fd04-4d67-846f-d08135a8b134,posted,Uber Ride,-2566.19,bd93b0c9-a419-47be-a7b1-a7e5d6301402,-3181.31,debit,payment,AU00000,2023-07-27T17:14:11Z
transaction,317d2c81-70cb-4329-8613-c8fa101f9aa4,posted,Car Maintenance Expense,-1165.05,0bd19b01-e91c-4b28-9d7f-63a747847d58,-4346.36,debit,cash-withdrawal,AU00000,2023-09-14T10:52:24Z
transaction,6ff69069-3214-4d91-9ca1-30407a9ad986,posted,Public Transport Fare,-3622.65,a337fe46-626b-4f3d-8ca5-b036542f2608,-7969.01,debit,cash-withdrawal,AU00000,2023-08-08T17:08:56Z
transaction,57c44b76-8168-4af9-9eab-aeb8fbdb4c68,posted,Mobile Phone Bill Payment,-4209.9,439044a4-add1-4625-9b7d-e12970a16e22,-12178.91,debit,bank-fee,AU00000,2024-03-09T19:33:22Z
transaction,c2ac8d7e-b49d-4487-9530-ca67adccf4c8,posted,Music Streaming Subscription,-3982.47,902ecfeb-c3d7-4c9e-ad3d-ead6c8589d02,-16161.38,debit,cash-withdrawal,AU00000,2023-11-05T06:21:50Z
transaction,110077cd-2e62-45f3-b8f2-75d0c77c1e2a,posted,Uber Ride,-2862.91,28934cd2-3c4d-406e-9f78-b67054cc732c,-19024.29,debit,payment,AU00000,2023-06-05T13:58:52Z
transaction,d6e06258-c272-43a5-90b6-cca743b77b21,posted,Movie Ticket Purchase,-1168.98,3b8c9a1e-4218-478e-a7ec-bba8c271a63a,-20193.27,debit,payment,AU00000,2023-05-25T20:05:44Z
transaction,59c217e6-3868-45f4-9889-fef94cf6bc6c,posted,Restaurant Dinner,-1240.0,2c8b1043-1e9b-47ca-b51a-d5671613fc7c,3789.23,debit,cash-withdrawal,AU00000,2023-12-20T09:46:14Z
transaction,03dbea63-9a1c-4fce-bf86-5e861607e5d5,posted,Gasoline Purchase,-2613.06,538b474c-1475-4ec7-9d70-7f951d0c3083,1176.17,debit,cash-withdrawal,AU00000,2024-02-01T19:22:08Z
transaction,4ad764a1-9de2-49d0-82aa-51b26f5ae802,posted,Uber Ride,-4148.73,4b5a2384-df84-4021-97ae-fae155db6fe6,-2972.56,debit,payment,AU00000,2023-11-04T12:34:18Z
transaction,1be8d5e2-49d0-4a72-8d6c-bac8e9b1679f,posted,Public Transport Fare,-1514.09,13f9080f-65bf-4291-9e28-03bfdb579966,-4486.65,debit,cash-withdrawal,AU00000,2023-07-26T20:48:45Z
transaction,45edc4c4-869a-42ed-97d4-05f61b6ff7a1,posted,Restaurant Dinner,-3260.22,4378fefe-0b5e-4826-8fbb-57143b17e5da,-7746.87,debit,bank-fee,AU00000,2023-12-22T01:10:23Z
transaction,1fbd713b-48e2-4bc2-8ec8-25b75e389350,posted,Gasoline Purchase,-623.37,ceeaee6b-7755-4832-a818-befd922678dd,-8370.24,debit,bank-fee,AU00000,2024-03-07T02:33:36Z
transaction,4a26dfa3-f942-4517-a115-ec19474ed4b9,posted,Amazon Online Shopping,-183.07,314b84f3-834f-4915-a846-a185393a74c8,-8553.31,debit,payment,AU00000,2023-05-20T18:44:02Z
transaction,c95b2e2f-74b4-4404-81ad-e7f3ed000d03,posted,Payroll WFRMS 15439393,10968.16,625ee053-84b1-4c2c-8ea6-ccfea459e4d7,2414.85,credit,transfer,AU00000,2023-09-21T14:12:19Z
transaction,6a69a150-2634-408c-95d3-f72415295816,posted,Manly Maths Tutor Wages,-3919.43,29f8093d-d1d6-44be-8614-432e6f9660b7,-1504.58,debit,cash-withdrawal,AU00000,2024-04-30T02:12:14Z
transaction,2742f2b8-4e2c-461b-8fa1-79e3f0395349,posted,Hair Salon Appointment,-4575.14,26570a03-0a2b-4fcb-91d1-2cd07cff8505,-6079.72,debit,bank-fee,AU00000,2023-09-26T08:15:35Z
transaction,2a9422c5-fd0b-44da-9f73-cd3e4d6f830d,posted,Car Maintenance Expense,-184.8,4d065327-9efe-4a1d-b6d4-daf2cf4e7870,8154.71,debit,bank-fee,AU00000,2023-11-08T22:42:14Z
transaction,26a7facd-5742-4c6d-a512-58c16796fb9b,posted,Pharmacy Purchase,-725.03,626752d7-0b0c-4ab7-9031-80ebddd1960b,7429.68,debit,bank-fee,AU00000,2023-11-23T09:22:49Z
transaction,b97dc490-6fb0-46eb-9fee-9c4867033c0c,posted,Movie Ticket Purchase,-3740.19,2c0e7ad0-a2d8-4945-acb2-88c753e4839e,3689.49,debit,cash-withdrawal,AU00000,2024-03-10T10:35:38Z
transaction,930d6373-54dd-4194-a148-26746e0a9cbc,posted,Travel Agency Booking,-2438.51,884a140d-65a6-4267-92ce-907f3b9d2322,1250.98,debit,bank-fee,AU00000,2023-09-11T00:54:43Z
transaction,86a7fd17-f904-450a-befc-b1b739f87ce4,posted,Public Transport Fare,-2412.16,3b929a1a-2eeb-4796-a6ec-27fcecd11175,-1161.18,debit,payment,AU00000,2024-01-04T00:08:34Z
transaction,14d1c13c-2812-44a2-a37d-943769ca687a,posted,Music Streaming Subscription,-4052.37,bc679832-2432-436d-8aea-6d5128cd97be,-5213.55,debit,payment,AU00000,2024-02-16T16:35:41Z
transaction,0a9d17df-30eb-4b1e-a376-4231e59a65df,posted,CTRLINK CARERS Ref: 998R6789201610974V,-2442.96,10cbe047-d079-4030-88ae-a09c6aa9d30a,-7656.51,debit,cash-withdrawal,AU00000,2024-02-11T20:55:58Z
transaction,78030a0d-8f73-42c4-a1fc-082583cd61e7,posted,Hair Salon Appointment,-4403.26,d6862935-dc8d-44fb-8adf-d1f235b9542a,-12059.77,debit,payment,AU00000,2023-07-03T00:40:29Z
transaction,219fdcf9-8182-4a87-acd7-e177a1f2c1fc,posted,Non Hooli ATM Withdrawal Fee,-202.96,2a02be2c-db6f-4e13-a15c-883d81182835,-12262.73,debit,cash-withdrawal,AU00000,2023-10-06T17:21:22Z
transaction,9fee7f34-5c7d-4bc6-88fd-8fd01ddfccd6,posted,Hair Salon Appointment,-3569.25,d194537e-6f1d-4332-9c69-4db76d8470fe,-15831.98,debit,payment,AU00000,2023-06-30T12:57:00Z
transaction,6bb6c2e1-45f5-403d-9a4d-a05b18047c8b,posted,Gasoline Purchase,-1797.77,951638e8-5131-4297-81e2-464920352914,14461.83,debit,bank-fee,AU00000,2023-10-04T09:32:47Z
transaction,8dd941d3-a8ac-4b74-9883-cc125438afb3,posted,Payroll WFRMS 15439393,11572.48,6e3a0505-0401-4025-9916-e05982d6bbc6,26034.31,credit,transfer,AU00000,2024-02-26T19:48:42Z
transaction,9ea9a92b-cf6e-4d37-aa5d-e46093bab721,posted,Travel Agency Booking,-2531.21,359ce3df-8046-46ee-958d-2155e47a737b,23503.1,debit,bank-fee,AU00000,2024-02-03T08:25:46Z
transaction,dd42f247-11bb-4768-96b1-2b7ea4adf015,posted,TFR Acc14000 TO 12389,-760.15,888317e8-f1ba-4b3c-b517-eca33d6593cd,22742.95,debit,payment,AU00000,2023-08-11T19:11:30Z
transaction,29d5961f-738e-4ba2-bac4-8108cc9de363,posted,Hair Salon Appointment,-4378.07,425933be-0dfb-4be3-b365-571ef70abe3a,18364.88,debit,bank-fee,AU00000,2024-03-29T19:43:53Z
transaction,9709b7c8-5061-49e5-ac2c-bc7422953415,posted,TFR Acc14000 TO 12389,-2371.53,9d008cb4-d883-437f-a411-f71284086507,15993.35,debit,payment,AU00000,2023-08-13T14:52:59Z
transaction,4f5b5dea-9891-4c87-a479-0914487c9344,posted,AGL RETAIL ENERGY LTD (GAS),-1853.51,26a4f50d-f105-4a35-80ff-d7c071afbdad,14139.84,debit,bank-fee,AU00000,2023-08-02T23:25:14Z
transaction,8044c7f8-8ae7-4db9-8409-08778ed05b0f,posted,Uber Ride,-2639.65,1689a834-c996-4f3d-8d49-165290677ee5,11500.19,debit,payment,AU00000,2023-06-23T23:10:58Z
transaction,50b3f625-4834-44aa-a678-f91a933abab0,posted,Home Improvement Store Purchase,-729.92,de83c32f-2cfe-4446-9813-7671d76f103b,10770.27,debit,cash-withdrawal,AU00000,2023-10-26T19:47:23Z
transaction,728583b9-80d5-4123-b8af-56dd0cb1b411,posted,Transfer Platnm Homeloan 346454,-777.51,d2bed681-7147-45db-b3cb-1d8f81fa486d,9992.76,debit,bank-fee,AU00000,2023-08-13T21:13:08Z
transaction,2f52967d-7bd1-4eca-9eed-fbc9bf9f5579,posted,TRANSFER TO JOANNA SMITH CAMPING,-2941.04,1d94ba6c-b7d0-48ba-84ff-91fc5487d8d9,8130.31,debit,bank-fee,AU00000,2024-02-14T20:19:52Z
transaction,a3a86f32-c549-4df3-ab28-75a512a82bbe,posted,Car Maintenance Expense,-3536.61,ac597c5b-160d-447e-8435-ed69cde8fff9,4593.7,debit,bank-fee,AU00000,2024-02-11T15:34:17Z
transaction,51ae58c3-af26-473b-8585-6a13710890c1,posted,Restaurant Dinner,-884.3,027b2d5a-a8c6-42d7-92a8-b5504f97b17f,3709.4,debit,bank-fee,AU00000,2023-05-21T19:31:03Z
transaction,4f206856-6c73-4f6e-b774-746fd003cb10,posted,Mobile Phone Bill Payment,-1583.48,d653281d-70c4-4016-bf5b-e85534a7f131,2125.92,debit,bank-fee,AU00000,2024-03-31T03:32:09Z
transaction,4d7748b0-882b-4593-a702-8e3a64e9a181,posted,Transfer Platnm Homeloan 346454,-4350.93,fa16b6a9-5af0-4d2f-88c2-4b359d5162f0,-2225.01,debit,payment,AU00000,2024-02-18T15:34:58Z
transaction,a942ea52-d7d8-4be5-83ef-00da035032e7,posted,Electricity Bill Payment,-1907.77,2e6b7284-f728-4a18-8803-8a910fe24486,-4132.78,debit,payment,AU00000,2024-01-28T20:19:53Z
transaction,a3aa6e19-e0fd-4e11-b2fd-07da2d1bc15b,posted,Pharmacy Purchase,-132.49,6c93eccf-30a0-49e6-a723-e01106cd9919,-4265.27,debit,payment,AU00000,2024-03-22T08:02:52Z
transaction,ad08def3-4692-4b23-ae40-580841ad6d42,posted,Electricity Bill Payment,-2745.51,d20451e5-2771-431d-917f-1f2c8647e72e,-7010.78,debit,bank-fee,AU00000,2023-08-16T21:40:38Z
transaction,6a73dbfe-d2b8-4b08-b1d9-27fcadf6637e,posted,Non Hooli ATM Withdrawal Fee,-1153.22,f4ff38c9-73f9-4e15-b34e-f2218028acb5,-8164.0,debit,bank-fee,AU00000,2023-05-22T05:41:10Z
transaction,1264f6ce-f0c7-450c-8e7e-c6c26a57b330,posted,Movie Ticket Purchase,-2287.5,ee2218ca-8832-46c5-a2a3-d0d61904d66b,-10451.5,debit,cash-withdrawal,AU00000,2024-03-23T18:28:31Z
transaction,12e61177-0207-4a04-92ba-286ea5a83d4c,posted,Payroll WFRMS 15439393,10021.42,b19db58f-da2e-4061-ac9b-f3e8fb21f235,16875.82,credit,transfer,AU00000,2024-04-04T14:26:33Z
transaction,bce5800b-95fa-4ebc-9ce9-f99a543da8d3,posted,Amazon Online Shopping,-2998.69,2cdeebc5-5e83-4ce1-8f78-cfa79fd559c5,13877.13,debit,bank-fee,AU00000,2024-05-05T22:31:23Z
transaction,42c645f0-1021-4cf9-b583-acd5501292be,posted,Non Hooli ATM Withdrawal Fee,-28.72,fe8e147b-a7e8-491c-89f4-1f42b0537158,13848.41,debit,cash-withdrawal,AU00000,2023-05-29T20:02:51Z
transaction,c8dfb3d6-7c0b-4dcd-b88d-bca7fb6c75d0,posted,Movie Ticket Purchase,-4354.86,66174bc5-6319-43bb-90a3-162eb895bd66,9493.55,debit,payment,AU00000,2023-08-18T01:38:48Z
transaction,1127fd1c-1bd8-4aed-876b-3bf32703012e,posted,Transfer Platnm Homeloan 346454,-1102.0,d102ee1f-0373-4540-9594-8fc470b20f3f,8391.55,debit,bank-fee,AU00000,2024-01-20T00:07:56Z
transaction,a9d1ac34-7f70-460d-a71d-65ea7f415e7e,posted,Gym Membership Fee,-3497.98,c1589be1-bdcd-4c4b-b7ec-b6a1719b7286,4893.57,debit,payment,AU00000,2023-09-11T04:23:50Z
transaction,bd5da67b-11a4-40b4-a8a3-ec2ebf2ee5a7,posted,TFR Acc14000 TO 12389,-4058.57,15b616f0-959d-4f8b-a71c-174931a75bb5,835.0,debit,cash-withdrawal,AU00000,2024-02-23T16:33:45Z
transaction,844b29e6-74de-49e4-8ff0-139b4e65770f,posted,Pharmacy Purchase,-3012.92,d4de750c-6fb7-46b1-8181-fe6ff2ec04a7,-2177.92,debit,cash-withdrawal,AU00000,2023-09-29T15:57:49Z
transaction,2bf5f164-d8bb-4b2d-ab00-49b8dfd444e7,posted,TFR Acc14000 TO 12389,-4114.07,aa4254b9-ee83-4a68-9a56-db5fcad8ef45,-6291.99,debit,payment,AU00000,2023-05-23T17:30:03Z
transaction,f6aa3311-f41c-47de-bc1a-602091bb5d18,posted,Non Hooli ATM Withdrawal Fee,-3795.08,2ef65e08-30d9-43e0-a021-60599510cce8,-10087.07,debit,cash-withdrawal,AU00000,2023-12-15T06:30:58Z
transaction,605fab87-8bcb-4872-953b-aa0271585de9,posted,Coffee Shop Purchase,-1255.9,15018fd3-c7a8-4048-af0c-84d82a944dc5,16570.87,debit,bank-fee,AU00000,2024-03-06T09:48:10Z
transaction,46a83448-3fa2-4cef-bd07-9b44d0882f91,posted,Clothing Store Purchase,-105.37,d87ef105-e8ac-4bc0-8c65-6b592fbe964f,16465.5,debit,cash-withdrawal,AU00000,2023-06-25T00:48:45Z
transaction,268a5190-8de7-4f40-93b0-0038faf2e925,posted,Mobile Phone Bill Payment,-2691.53,e17bb05f-6dbc-45d6-a5bf-459a209907d0,13773.97,debit,cash-withdrawal,AU00000,2023-08-12T20:08:17Z
transaction,94e440fb-ae66-4ecf-b891-622b4ecfdbbe,posted,Wdl ATM WESTPAC IGA BALGOWLAH BALGOWL AU,-732.47,93d603fa-20ee-430e-b98d-39278d42d0ac,13041.5,debit,cash-withdrawal,AU00000,2023-12-11T13:24:06Z
transaction,2d93401a-e5f2-479d-8de4-b1e398e4881c,posted,Amazon Online Shopping,-3831.69,e032e2bc-a0d7-4f64-ba12-df13a1d864b6,9209.81,debit,payment,AU00000,2023-09-29T00:50:44Z
transaction,39d020c1-465c-43f3-a1e0-cb517299d40d,posted,Mobile Phone Bill Payment,-355.69,b2067fc9-1db7-4a54-a6dd-a5e0c5ff7229,8854.12,debit,cash-withdrawal,AU00000,2023-09-04T08:47:48Z
transaction,ccb50070-09c5-4fe4-bf7a-e08ce61090c7,posted,Mobile Phone Bill Payment,-2598.87,536da7c3-a9ce-4949-8ca3-41efc15d355c,6255.25,debit,payment,AU00000,2023-07-13T11:11:13Z
transaction,1ab951b9-9871-4259-b3b6-8e2ba795ae7a,posted,Transfer Platnm Homeloan 346454,-962.03,56a44296-7f4b-4e4b-89de-9fa25c894899,5293.22,debit,cash-withdrawal,AU00000,2023-07-05T21:41:20Z
transaction,961c7e20-4e67-4674-842e-3089246ee4c2,posted,Uber Ride,-4541.03,77e870c4-57da-4085-8781-43b1ce5b412e,752.19,debit,cash-withdrawal,AU00000,2023-05-16T17:06:10Z
transaction,4fbb6fac-3c79-4cf2-9b22-6f94217d38fd,posted,Gasoline Purchase,-3136.68,c86a4dc4-8226-446b-a48a-01a34e072d1c,-2384.49,debit,payment,AU00000,2024-01-22T03:16:01Z
transaction,b82193a7-90b1-4675-ab8e-695a32087c05,posted,Gasoline Purchase,-1116.99,48b02e53-8154-4506-873c-054cd254b79d,16665.69,debit,payment,AU00000,2023-08-21T19:29:53Z
transaction,add86b0b-44c3-4ee9-8d2e-2dd9430665fd,posted,Online Gaming Purchase,-3764.55,212f37fc-86b6-4f17-8162-f17292e0bffb,12901.14,debit,bank-fee,AU00000,2024-04-02T05:58:24Z
transaction,9a175557-16e0-4892-a992-ffb2c28e9ea8,posted,Payroll WFRMS 15439393,11019.24,f3647200-f337-479b-b38a-bf8fcd86750e,23920.38,credit,transfer,AU00000,2023-06-19T05:59:19Z
transaction,bcb40056-96ed-4856-b474-8d93559aed1f,posted,Non Hooli ATM Withdrawal Fee,-300.32,bdc81a68-cee9-4f01-b556-625d376fb792,23620.06,debit,cash-withdrawal,AU00000,2023-06-20T02:47:39Z
transaction,73aa78cb-e4ec-4f84-9e3e-c37a76c3d081,posted,Wdl ATM WESTPAC IGA BALGOWLAH BALGOWL AU,-3829.45,2520606b-7b4b-44af-916b-4bb090a0eb51,19790.61,debit,cash-withdrawal,AU00000,2023-10-22T20:14:09Z
transaction,5100f0c5-c3a2-4110-8e3b-313c666765d9,posted,Mobile Phone Bill Payment,-536.68,c478a93a-2cea-48b3-9afb-08200f1c75e4,19253.93,debit,payment,AU00000,2023-10-13T10:59:13Z
transaction,0c38d97b-3814-4398-b2aa-012f161c8e70,posted,Coffee Shop Purchase,-3252.77,8716ed36-a7ab-4982-ae5d-e7e48674a97f,16001.16,debit,bank-fee,AU00000,2023-08-24T04:46:13Z
transaction,826689e2-e81a-47fa-b9ad-f3a5a0b1cb8a,posted,Manly Maths Tutor Wages,-495.31,e781b3ba-c7a4-4114-bac6-c20e5ef0e7b5,15505.85,debit,payment,AU00000,2023-07-24T04:44:18Z
transaction,330692da-2ccf-41d4-bf64-b009b3be95cf,posted,Music Streaming Subscription,-735.05,460f2eeb-54a7-4ece-8b91-68510810bdef,14770.8,debit,cash-withdrawal,AU00000,2023-06-29T08:37:49Z
transaction,48fcd83e-482b-412b-923a-c083952116f5,posted,TFR Acc14000 TO 12389,-3244.79,8d7c682b-1d9c-42e9-b0c1-89f4a947e454,11526.01,debit,cash-withdrawal,AU00000,2023-12-22T16:12:38Z
transaction,c7beb518-50f0-45a0-bc64-29680bb863d0,posted,Transfer Platnm Homeloan 346454,-4070.57,729f3a83-0d46-4c36-92b0-d479b1e84d99,12313.5,debit,cash-withdrawal,AU00000,2024-03-19T23:20:01Z
transaction,c33e057d-c8a2-4c7a-aac8-ca8d42def2d9,posted,Gasoline Purchase,-405.37,efc501a3-28a5-48b7-b8f7-b42d0eef1e21,11908.13,debit,bank-fee,AU00000,2023-08-19T04:25:37Z
transaction,915abb17-408b-44ec-9f43-4a2c25c1be07,posted,Pharmacy Purchase,-4049.74,a6d886af-46e8-48b4-8d52-e268d8d9a10e,7858.39,debit,cash-withdrawal,AU00000,2023-05-19T04:03:34Z
transaction,c71aae03-dbe2-4d88-9ca3-adb32004e3d2,posted,Gasoline Purchase,-1239.5,c88aa52d-782c-48c8-8f47-e9069b43d8ea,6618.89,debit,bank-fee,AU00000,2023-06-07T14:14:05Z
transaction,f8c35686-15e2-417d-9c3f-de879e706eb3,posted,Music Streaming Subscription,-3853.84,0f224552-7b58-42b7-a9f4-72373ed465a5,2765.05,debit,payment,AU00000,2023-12-27T16:39:08Z
transaction,393a9ad0-e44b-417b-91cd-91e1cf768fa4,posted,Online Gaming Purchase,-883.12,e04411d5-4e9e-462f-8a0c-776108f9f299,1881.93,debit,bank-fee,AU00000,2023-06-17T14:42:28Z
transaction,4efbccf3-5ea6-4bcc-836e-e9603dbaff18,posted,Restaurant Dinner,-1835.49,1a5d8349-29b3-44fe-a1da-bbb560ad93a1,46.44,debit,cash-withdrawal,AU00000,2023-11-08T17:03:45Z
transaction,4f3a803c-d2f7-4bb5-89fd-c624b86bccb3,posted,Online Gaming Purchase,-1763.79,a0d8163b-ea0e-4f8a-b205-6875ca52d3d4,-1717.35,debit,payment,AU00000,2024-03-20T23:25:23Z
transaction,cc3ff947-464a-4900-9687-787bb149707e,posted,Netflix Subscription,-4655.16,bbded29c-a166-4bd7-a7b3-b0b5bcd99d0a,-6372.51,debit,bank-fee,AU00000,2023-07-19T09:08:01Z
transaction,613878ef-21a4-4f7c-81c3-53df4aa1e08a,posted,Electricity Bill Payment,-1806.39,c618a1fd-f312-4deb-9dc6-1d1216422c0b,-8178.9,debit,cash-withdrawal,AU00000,2024-03-26T23:59:52Z
transaction,14ba7090-928e-45c7-8354-b64863708d5e,posted,Uber Ride,-2893.11,b76c979c-dd03-46a3-bd91-4f16280a16b0,10180.75,debit,payment,AU00000,2023-10-19T12:38:40Z
transaction,dbcf6513-70f0-4a5e-9abc-e5dfffe5b89a,posted,Pharmacy Purchase,-1786.75,b3f41cb6-17ec-4b5e-942a-a43672eea19e,8394.0,debit,payment,AU00000,2024-03-31T18:52:03Z
transaction,a95969ab-2907-49e5-9823-bb985a8c52cf,posted,Movie Ticket Purchase,-3933.64,26c6d9c1-ce97-4f53-b86c-ac7d90b15fa4,4460.36,debit,cash-withdrawal,AU00000,2024-04-22T21:02:09Z
transaction,71ae3e0a-2481-4ddf-b5b0-66a212727e76,posted,Amazon Online Shopping,-1395.33,24777ae7-1b3f-4656-9ef7-43c1f06606fa,3065.03,debit,payment,AU00000,2023-05-18T10:09:18Z
transaction,4504496f-eb83-4759-b6fc-f65135a2e295,posted,Public Transport Fare,-2290.07,7d0ccf6e-42ba-42d1-95eb-30d162ddcf3c,774.96,debit,bank-fee,AU00000,2023-08-03T12:22:15Z
transaction,b91414f4-c739-4cf5-a3ca-c1f98e9d05c2,posted,Transfer Platnm Homeloan 346454,-3611.06,0db453c7-4d8a-49f4-9abd-87dc21886e86,-2836.1,debit,bank-fee,AU00000,2023-10-10T17:59:02Z
transaction,6013e3c5-2693-4b3b-8104-e32ee00b5fa7,posted,Transfer Platnm Homeloan 346454,-4861.22,2048ba13-8807-45ca-a069-c3292fb06495,-7697.32,debit,payment,AU00000,2023-05-16T06:37:42Z
transaction,d73ae692-0f87-4ee5-b1e9-7ef3cd5b7c2f,posted,CTRLINK CARERS Ref: 998R6789201610974V,-4250.19,f6d853fe-f2af-4cc4-a5bb-4115eb5b0792,-11947.51,debit,payment,AU00000,2023-10-02T05:02:00Z
transaction,34b5c0e5-c136-4c5f-b966-70bc81d13342,posted,Wdl ATM WESTPAC IGA BALGOWLAH BALGOWL AU,-299.49,4814c2ad-372d-450a-b582-132faddd2706,-12247.0,debit,cash-withdrawal,AU00000,2024-02-17T06:48:36Z
transaction,d1945ab0-2c8c-43b4-be62-7da2c44bc402,posted,Non Hooli ATM Withdrawal Fee,-1335.55,bda3e5d6-b3d6-4130-b24a-c05f0262508c,-13582.55,debit,payment,AU00000,2024-04-09T23:42:24Z
transaction,e81029d8-a0b5-42d7-9260-e2dfaad8afda,posted,Hair Salon Appointment,-4867.68,f65822a4-1c74-4279-89fd-ce1eeb730389,11035.04,debit,cash-withdrawal,AU00000,2023-10-05T14:41:24Z
transaction,26dfd0dd-27d1-4dc4-8016-5dc23ea243de,posted,Clothing Store Purchase,-504.68,0ab07805-c934-4b14-8b6c-33c9635b9900,10530.36,debit,cash-withdrawal,AU00000,2023-10-21T14:11:07Z
transaction,a773415b-b1cb-4175-a8ad-02a904b4c55f,posted,Non Hooli ATM Withdrawal Fee,-244.95,f3f7d53f-6634-4a7c-ad45-8348f2607e67,10285.41,debit,payment,AU00000,2024-03-25T00:49:03Z
transaction,2a78eca5-ff16-4973-a61a-c8ded280b79a,posted,Mobile Phone Bill Payment,-592.31,93420da1-24e1-49c3-ad49-c64d4c1ccaed,9693.1,debit,bank-fee,AU00000,2024-04-10T14:19:37Z
transaction,6a0de3ec-45b7-4bda-a396-13ca3ea1610f,posted,Wdl ATM WESTPAC IGA BALGOWLAH BALGOWL AU,-2146.3,708d3a61-f9c2-487b-92ac-31ffd994fb1a,7546.8,debit,bank-fee,AU00000,2024-02-22T15:57:33Z
transaction,bfd8a532-037d-400e-9387-0a5708f49362,posted,Hair Salon Appointment,-3652.98,b39f48f2-b845-4024-8d91-79f969e47eec,3893.82,debit,bank-fee,AU00000,2024-03-06T04:49:06Z
transaction,5758cac0-9116-49a3-a5ac-3835bdd993c3,posted,Online Gaming Purchase,-3047.87,2aa42fe6-716c-4ff8-a1fd-c57994e10aee,845.95,debit,bank-fee,AU00000,2024-03-22T12:51:44Z
transaction,81449291-e6bf-428a-b44e-4fbd62ab3195,posted,Payroll WFRMS 15439393,11143.64,3494e4e8-ffeb-4cae-844a-c3fceccb18b5,11989.59,credit,transfer,AU00000,2023-10-11T04:16:13Z
transaction,b8e1fd1a-96eb-4c8b-ab0b-60d1b60e9676,posted,Amazon Online Shopping,-4114.88,5887a007-8a4e-41c2-b08b-f8b9015f149f,7874.71,debit,bank-fee,AU00000,2024-04-17T04:43:50Z
transaction,033f92ff-a00d-43a9-abb8-68d4c8d5cdd0,posted,Clothing Store Purchase,-3559.82,9f19d669-826d-49cc-999c-e751a89ca39f,4314.89,debit,bank-fee,AU00000,2024-01-15T07:55:25Z
transaction,9b696c1f-a865-418d-9a14-b767ced8be6d,posted,Bookstore Purchase,-2223.27,a5c0065c-eff9-414f-a3c0-70f8e3efbea0,7176.87,debit,bank-fee,AU00000,2024-03-30T19:07:11Z
transaction,923629a6-1097-44db-b1b2-f9ce8788e85c,posted,Public Transport Fare,-2478.83,87c59461-d539-49f1-9acb-6bc731639569,4698.04,debit,bank-fee,AU00000,2024-03-18T05:04:31Z
transaction,75ba9698-3961-4e4c-849b-765451b61df4,posted,Travel Agency Booking,-865.03,c3d34714-ef9b-4886-bbd1-08436e7b3397,3833.01,debit,payment,AU00000,2023-12-17T10:46:21Z
transaction,b9857708-442a-4ce6-8015-04c6f04ecf7d,posted,AGL RETAIL ENERGY LTD (GAS),-1465.63,27114c06-c0b5-4714-8b9b-b4b5dd0ba2af,2367.38,debit,payment,AU00000,2023-11-06T05:47:04Z
transaction,ddee23ab-3a21-4d1a-9383-dea789e0b57a,posted,Payroll WFRMS 15439393,11719.81,e2a858d8-f096-491a-ad48-57fa545b1654,14087.19,credit,transfer,AU00000,2023-10-25T18:29:26Z
transaction,e2e23176-951f-457f-b8df-2736ba4aa0db,posted,Amazon Online Shopping,-162.76,4eca3e52-2669-417e-8b1b-7f0db0015599,13924.43,debit,cash-withdrawal,AU00000,2024-01-26T23:31:39Z
transaction,2cb04f72-a913-4ef6-a41b-c1a63f53c026,posted,TRANSFER TO JOANNA SMITH CAMPING,-4303.0,9a2dd25f-4f1e-4818-9d57-46f58aeb2bea,9621.43,debit,payment,AU00000,2023-09-30T07:28:11Z
transaction,1b342a00-1010-4440-b689-9ff6b5706f38,posted,Travel Agency Booking,-4135.73,88b408e4-f02b-43fe-a9de-bce3967310b6,5485.7,debit,bank-fee,AU00000,2024-04-19T06:21:31Z
transaction,e2a211d6-b702-450d-bc16-80dd1c80999b,posted,Gasoline Purchase,-2066.52,c0a5650f-5924-4df0-bc02-927284ab9b2f,3419.18,debit,payment,AU00000,2024-04-22T16:05:57Z
transaction,677bee08-3ec7-4864-88c2-36e27217e231,posted,Gasoline Purchase,-1664.88,ed00386f-2838-46fe-9e5c-e42046392c45,1754.3,debit,payment,AU00000,2024-02-25T23:43:59Z
transaction,e86a4816-d2b9-4e58-8cbc-75d30a80f403,posted,Mobile Phone Bill Payment,-1833.35,6872851f-a9d5-40da-abae-b972ae040912,5620.18,debit,cash-withdrawal,AU00000,2023-07-28T04:28:21Z
transaction,4cf8d4d7-7d63-41ed-87ee-cedef4c9bebd,posted,Movie Ticket Purchase,-2466.92,a37e6a6a-45d2-493d-8118-dbcc535dbe47,3153.26,debit,payment,AU00000,2023-06-30T03:29:05Z
transaction,a9d88ba9-577c-42d0-830e-92d0bb80fcbc,posted,Netflix Subscription,-1442.47,36eeb52e-63ee-460c-9242-754ee4ab0df0,1710.79,debit,cash-withdrawal,AU00000,2024-02-28T04:48:10Z
transaction,c595d074-1e10-4b9f-8c41-fc3868dc58d2,posted,Hair Salon Appointment,-2257.31,6aa659cc-caad-4f3a-b9bc-f2f67b0240c0,-546.52,debit,cash-withdrawal,AU00000,2024-03-20T07:53:03Z
transaction,3536f937-7928-4ccd-a101-20dad1eb1f35,posted,Music Streaming Subscription,-1653.27,089ae006-034d-4dd1-9901-25519e4a72d4,-2199.79,debit,bank-fee,AU00000,2023-05-24T18:43:05Z
transaction,1a898d47-d26b-42b0-83a2-ba2579955400,posted,Non Hooli ATM Withdrawal Fee,-2775.8,5e1d98c3-6b6a-4adc-9139-8a96ee45e86e,-4975.59,debit,payment,AU00000,2023-08-09T16:31:24Z
transaction,45a0ab14-14cb-4e3c-8ba1-fc3c9ad67551,posted,Wdl ATM WESTPAC IGA BALGOWLAH BALGOWL AU,-3517.8,653f90c3-0e96-4efa-9bce-5881b2903d21,-8493.39,debit,cash-withdrawal,AU00000,2023-05-12T16:34:49Z
transaction,145a0a17-ca8b-4dbc-bcd0-832e06464375,posted,Home Improvement Store Purchase,-2454.65,5e7c3a59-5204-4f40-9730-2b3d81a1938b,-10948.04,debit,payment,AU00000,2023-07-29T22:12:18Z
transaction,f183b078-a17b-4155-a9b6-d5ae2ea8298c,posted,Restaurant Dinner,-3341.75,3f511a7d-ef0a-4113-b38e-2cb7ccc691d8,-14289.79,debit,payment,AU00000,2023-12-21T11:29:46Z
transaction,e3ad6116-91b2-4866-97ee-04f71ac20c3a,posted,Clothing Store Purchase,-3828.8,b4b314b7-10f3-4d17-b9aa-6013a0896763,-18118.59,debit,payment,AU00000,2024-05-05T05:25:00Z
transaction,4c2b7b4d-ec59-4aa8-8c4a-4ece4b9c9b56,posted,CTRLINK CARERS Ref: 998R6789201610974V,-85.14,0032d876-3ef0-4883-9609-7005e31c2cbb,17274.85,debit,bank-fee,AU00000,2023-12-09T06:26:11Z
transaction,89514ddc-ed03-4f4b-a1af-5db38f2fd5fd,posted,Bookstore Purchase,-1959.94,0339d0a4-c327-461d-aa2f-448d49d7633a,15314.91,debit,cash-withdrawal,AU00000,2024-02-20T03:04:20Z
transaction,f8b56c12-8015-46ce-b454-848fa813fc90,posted,Amazon Online Shopping,-1491.22,ee69edde-83b7-4100-aa05-0b98ca03ae1c,13823.69,debit,cash-withdrawal,AU00000,2023-09-16T15:59:34Z
transaction,d44d0383-7ae9-48a5-af01-e28408e06a11,posted,Clothing Store Purchase,-554.86,ff438c13-2fc9-43cb-bdbb-abd87483f460,13268.83,debit,bank-fee,AU00000,2023-12-08T16:39:11Z
transaction,fa4e0cf3-d2f3-4118-bc6a-2250d835615e,posted,Coffee Shop Purchase,-1449.46,e219ea2e-388c-43b3-8977-7d635ac79315,11819.37,debit,bank-fee,AU00000,2023-09-30T12:24:24Z
transaction,e802eb80-2e43-483b-94dc-188058bab4a1,posted,Restaurant Dinner,-990.74,2fd659b9-80d4-4835-b472-190c62482f6e,10828.63,debit,bank-fee,AU00000,2023-12-03T21:14:10Z
transaction,fecd676e-27a4-4941-b537-69fe1d7322eb,posted,Online Gaming Purchase,-2773.02,e51010b4-119d-4aef-adb1-c3b90d957e43,8055.61,debit,bank-fee,AU00000,2023-12-08T06:53:27Z
transaction,6c87873a-1987-40aa-a0b1-8e3d6a5969f3,posted,Online Gaming Purchase,-2893.41,97a77e51-e7dd-4385-9b65-4ff85bfa878b,5162.2,debit,payment,AU00000,2023-08-29T17:48:23Z
transaction,611506b9-6f75-469f-a6cf-ececcedff084,posted,Gym Membership Fee,-4657.4,84ccf790-7174-4cbe-9be4-71acfc2acf67,504.8,debit,bank-fee,AU00000,2024-02-17T02:47:50Z
transaction,2e926090-3596-4834-ba76-507b25560030,posted,Uber Ride,-981.12,d53cb076-4946-4476-999d-6a079330e401,-476.32,debit,cash-withdrawal,AU00000,2024-01-27T04:34:25Z
transaction,9ca40379-578a-43e1-ada8-4bfd8624c711,posted,Mobile Phone Bill Payment,-3128.12,198718a8-c2a6-4b27-a8b8-dddd0f8351b7,10022.55,debit,bank-fee,AU00000,2023-11-29T05:28:45Z
transaction,bf45da07-0c23-4d8a-a63b-3aa4e069ed4d,posted,Netflix Subscription,-4689.28,9a349b36-644b-439a-98ca-4df35d69e6d1,5333.27,debit,cash-withdrawal,AU00000,2024-02-03T19:09:10Z
transaction,36b2b891-ca25-4816-87a7-2e4e443cd120,posted,Manly Maths Tutor Wages,-1217.18,a4442411-0d03-4f18-8ec7-c88470a993ed,4116.09,debit,cash-withdrawal,AU00000,2023-05-30T23:36:08Z
transaction,222e082d-9f41-42f2-928d-f50426ddff6a,posted,Public Transport Fare,-4677.91,f4b89c1b-80cb-472e-a8f0-6564e2abb90d,-561.82,debit,payment,AU00000,2023-08-06T18:18:05Z
transaction,1ed12cd2-8c1c-4583-b0a3-805d2ae9af9e,posted,AGL RETAIL ENERGY LTD (GAS),-4716.89,1eec5f4c-e74b-4fa8-b224-8bcfac80acb1,-5278.71,debit,cash-withdrawal,AU00000,2024-02-12T05:41:18Z
transaction,8b007fa2-bf52-4391-9d72-46aee47a982b,posted,Transfer Platnm Homeloan 346454,-3167.41,620a5622-fbfb-4a13-9b3c-1c38ad1f8f98,-8446.12,debit,payment,AU00000,2023-09-26T07:46:45Z
transaction,210108b2-ccad-4dca-aa15-82c3a7d4b5fb,posted,Hair Salon Appointment,-1845.22,916d38cf-8e35-4c9e-baef-b49b5403f50e,-10291.34,debit,cash-withdrawal,AU00000,2024-05-07T17:08:25Z
transaction,4eb6431e-59a8-427f-a019-31886ceb948a,posted,Amazon Online Shopping,-3255.19,1c81b03f-a117-45df-aefc-417ad0396269,-13546.53,debit,bank-fee,AU00000,2024-03-23T20:51:51Z
transaction,33b53cfd-0aca-4c4d-b4fe-dc21186e583f,posted,TFR Acc14000 TO 12389,-984.82,9e8ef3e4-a7c9-4c3b-9bdf-cecc87116438,-14531.35,debit,bank-fee,AU00000,2023-07-07T20:32:15Z
transaction,7ac106c1-af8c-42cc-8155-d0af5e627d66,posted,Electricity Bill Payment,-3319.37,8670bd6b-5c11-4913-888f-8f4bb6d7ecfb,-17850.72,debit,bank-fee,AU00000,2024-04-24T01:20:55Z
transaction,dc2bdcf0-70fe-4dd8-ab0d-fe6d3374985a,posted,Clothing Store Purchase,-2386.53,8d6942ae-822b-48db-b237-8ccca837e3e7,4086.64,debit,payment,AU00000,2023-06-06T05:21:59Z
transaction,6113bc76-3504-4a70-8cd2-8d5013018b71,posted,Payroll WFRMS 15439393,11447.65,0d519ca5-d28b-4946-88f6-6dd6533870a3,15534.29,credit,transfer,AU00000,2024-01-21T03:30:40Z
transaction,767f5c37-5daf-4204-92bd-2d5bb466512d,posted,Public Transport Fare,-3319.74,20411513-532b-4414-bf23-9a4d8123eebb,12214.55,debit,bank-fee,AU00000,2023-07-09T15:01:52Z
transaction,3c63015b-0857-4d4b-8685-c8066815e13f,posted,Payroll WFRMS 15439393,11228.33,11505ef1-fd5c-44dc-ae4e-d17c0589ad2f,23442.88,credit,transfer,AU00000,2024-02-18T13:24:26Z
transaction,1a1a5d2e-4d4b-4e4d-89d9-867dbfa12e57,posted,Public Transport Fare,-2253.85,3524e34a-113c-4355-a45b-00dfb521ce4a,21189.03,debit,bank-fee,AU00000,2024-04-20T00:30:04Z
transaction,8823d105-2dda-4962-80b1-ede48ef6cca5,posted,Music Streaming Subscription,-3238.32,3237325a-f6dc-4c05-b255-196d61d976b2,17950.71,debit,bank-fee,AU00000,2024-03-09T12:19:19Z
transaction,bb367fd8-e388-4922-9170-43d0a27bdcaf,posted,Amazon Online Shopping,-3273.0,68285b50-9842-4fe8-8bb3-c4dffe70a94d,14677.71,debit,cash-withdrawal,AU00000,2023-12-17T08:32:56Z
transaction,c92834ff-57d8-40ec-984f-307d301c28b5,posted,Movie Ticket Purchase,-1989.16,830f762e-f604-4321-8ec8-446e061a9e46,12688.55,debit,cash-withdrawal,AU00000,2023-11-17T23:25:02Z
transaction,d409f656-5358-465a-8a77-60c2ec8dee55,posted,Uber Ride,-2530.74,11aac6c9-4b9e-464a-8f8f-a1063f5f2242,10157.81,debit,cash-withdrawal,AU00000,2023-07-31T21:42:29Z
transaction,7e676482-98a1-42ca-b335-8c2765889cf2,posted,Uber Ride,-1326.49,6ea94bfc-d19c-4ad3-adc9-2c902003696a,8831.32,debit,cash-withdrawal,AU00000,2023-12-16T19:08:08Z
transaction,df08c15e-026d-4ed3-a501-0eb19d29398d,posted,Gym Membership Fee,-728.13,8bdb8460-6c01-4e9c-9e59-4f926d2412b4,17209.94,debit,payment,AU00000,2023-07-30T11:56:50Z
transaction,b42a46a2-f7e0-4b86-aa51-5ee6b7fc0468,posted,Gym Membership Fee,-3021.09,593562f0-5f06-47bd-ae5f-64c1f5b0abe6,14188.85,debit,payment,AU00000,2024-03-16T02:06:49Z
transaction,b2d9d193-53e6-42eb-9358-10df36e3a396,posted,CTRLINK CARERS Ref: 998R6789201610974V,-700.21,287a7437-b5e3-4f38-93b1-9db77b117fa6,13488.64,debit,cash-withdrawal,AU00000,2023-07-04T08:02:29Z
transaction,4ce9dd29-c807-4457-a33c-0d032a8d801b,posted,Mobile Phone Bill Payment,-2885.85,d4c2767b-e42e-470b-bc19-9bed8448578e,10602.79,debit,bank-fee,AU00000,2023-11-07T02:54:56Z
transaction,3a42653e-82c7-4072-9046-66f9d4f9a1c1,posted,Coffee Shop Purchase,-4570.79,5b55c116-c0e7-476b-b61c-510de9b3ebc6,6032.0,debit,cash-withdrawal,AU00000,2023-10-03T22:22:04Z
transaction,7bc8a3ea-6a4b-4f4b-b51f-5f36aa494220,posted,Coffee Shop Purchase,-679.52,e5763122-a228-4374-b7dd-40b423a0af4c,5352.48,debit,bank-fee,AU00000,2024-05-03T18:50:22Z
transaction,ad78b83e-963a-4bbf-949a-ff8b52266691,posted,TFR Acc14000 TO 12389,-2796.69,294e1304-6509-4a5a-89e8-56515bd2f334,2555.79,debit,payment,AU00000,2023-08-27T16:30:07Z
transaction,520369ea-6471-4fa2-a22f-8425894c7b90,posted,Gym Membership Fee,-1054.68,d934b3a2-9ad5-4753-b103-6d07b47faeb6,1501.11,debit,cash-withdrawal,AU00000,2024-03-08T18:22:52Z
transaction,1c9ca8f6-2601-4e68-8868-4a5974d44c5a,posted,Home Improvement Store Purchase,-3776.17,b16c9c7f-f0f1-4eaf-9452-21bf15588b26,-2275.06,debit,payment,AU00000,2024-01-04T09:26:39Z
transaction,f6335488-be02-4a2c-8c73-d11ebfd3ed1b,posted,Coffee Shop Purchase,-2234.1,f01ac6ee-cda8-47cb-9094-72126d700f24,-4509.16,debit,cash-withdrawal,AU00000,2024-04-11T21:00:32Z
transaction,aeaea99b-cb16-4ae6-b755-c4812bfb12e6,posted,Travel Agency Booking,-4369.71,47e7cf6a-ab79-4587-baf1-dd84015923b4,10769.49,debit,bank-fee,AU00000,2023-12-31T16:54:01Z
transaction,e5e468e6-a2e8-43ba-a704-31c3e415a1ab,posted,Wdl ATM WESTPAC IGA BALGOWLAH BALGOWL AU,-1502.39,908c699c-b83f-404b-b0d7-5e732b4e65bf,9267.1,debit,bank-fee,AU00000,2024-02-05T21:07:12Z
transaction,99c4cbcd-e9ab-40ac-b8de-4af2b1ba3031,posted,Coffee Shop Purchase,-4996.54,c286a840-377e-435b-9f43-ced6934b2595,4270.56,debit,bank-fee,AU00000,2024-02-22T02:55:28Z
transaction,4eb1caaf-3b3d-4c55-b90a-476f6bc1c700,posted,Car Maintenance Expense,-4732.75,75371f48-360e-42b1-89b6-1df9d93fec2e,-462.19,debit,cash-withdrawal,AU00000,2024-04-08T01:04:26Z
transaction,816b156b-d373-4ba0-a307-f648788fb79d,posted,TRANSFER TO JOANNA SMITH CAMPING,-641.09,7a243b52-514d-4334-a419-c70ab7f41b95,-1103.28,debit,bank-fee,AU00000,2023-10-19T12:12:04Z
transaction,eb73caec-74f7-4a7b-bd05-c34f12bb3924,posted,Online Gaming Purchase,-633.56,4af18f25-64dd-4bed-a8de-155f73e8ffe9,-1736.84,debit,payment,AU00000,2023-08-02T18:20:26Z
transaction,a88bc61d-0bb7-48f8-84a5-a4a06ec8373f,posted,Coffee Shop Purchase,-1287.51,df3fb87d-4728-4944-964c-d40319898715,-3024.35,debit,bank-fee,AU00000,2023-06-12T08:12:42Z
transaction,ef450cba-6781-400c-be96-5e269362cd45,posted,Pharmacy Purchase,-2481.93,7adbcd3d-1df4-4453-b0e2-c0c4d6b0569e,-5506.28,debit,cash-withdrawal,AU00000,2023-11-02T10:49:44Z
transaction,3a32e60a-891b-4d4f-97f9-d704b7320f1f,posted,Music Streaming Subscription,-2730.21,2725b424-4d67-46f9-be18-833c848df6c4,-8236.49,debit,payment,AU00000,2023-12-02T08:05:34Z
transaction,2e2337a0-ab50-45eb-b656-693558ddd17a,posted,Coffee Shop Purchase,-4773.75,49cd3e7a-6238-4168-ae70-207a41f69019,-13010.24,debit,bank-fee,AU00000,2023-11-25T09:05:04Z
transaction,9687f4a4-a05c-4a63-88d9-6784ebfe2f37,posted,Coffee Shop Purchase,-1674.39,d44a697c-7e6f-42e1-a02a-167e155ada54,13011.79,debit,bank-fee,AU00000,2024-04-24T05:03:53Z
transaction,93318c29-1799-4fea-bc7d-8babd55f7257,posted,Gym Membership Fee,-3298.08,3c06f508-a37e-4de8-a9ed-5c860d2f44a6,9713.71,debit,bank-fee,AU00000,2023-05-13T12:45:47Z
transaction,020edb4a-2abe-4f7c-9223-6044d697b0f1,posted,TRANSFER TO JOANNA SMITH CAMPING,-3542.77,7e1d4f7d-15cd-4e1f-ae72-6436e27ee183,6170.94,debit,cash-withdrawal,AU00000,2024-01-16T13:30:33Z
transaction,14eb4168-b932-4871-b259-ba856c7e14dd,posted,TFR Acc14000 TO 12389,-3850.71,67354695-b4c5-4b23-b1a9-878f69706735,2320.23,debit,cash-withdrawal,AU00000,2023-11-21T21:44:09Z
transaction,fd7c12c1-37f4-494f-a249-a717ab11bb0b,posted,CTRLINK CARERS Ref: 998R6789201610974V,-1990.42,ed14841a-f219-4a48-9980-07fe1269dac7,329.81,debit,cash-withdrawal,AU00000,2023-11-03T07:08:57Z
transaction,e55af584-8c15-41e9-a15c-6121ba08f3e4,posted,Electricity Bill Payment,-4217.62,bbf8a6f6-871a-4d29-aeca-1088a701a185,-3887.81,debit,cash-withdrawal,AU00000,2024-05-07T15:56:26Z
transaction,fd77aa88-0b0c-43b2-89fe-721c89f55462,posted,TRANSFER TO JOANNA SMITH CAMPING,-3507.74,a66f4fbb-6755-40bb-8ec0-ae9db70df3e4,-7395.55,debit,cash-withdrawal,AU00000,2023-07-11T22:32:43Z
transaction,361f5c6c-4104-4858-9a2d-2ef6ce4ff923,posted,Online Gaming Purchase,-2556.19,2b96d597-cdc9-4c87-9289-83a97756c221,-9951.74,debit,bank-fee,AU00000,2023-07-14T16:24:49Z
transaction,e9428969-46c1-4852-a63d-daf66c89564f,posted,TRANSFER TO JOANNA SMITH CAMPING,-1346.65,91e84f30-0895-4ba8-9013-0db49e9432c0,-11298.39,debit,payment,AU00000,2023-07-30T00:00:10Z
transaction,5c7113ad-2cbb-4eee-8e9d-2d3a373267c3,posted,Gasoline Purchase,-2220.26,b0986c94-a33e-4a1d-86c5-136baa55972b,-13518.65,debit,cash-withdrawal,AU00000,2023-12-19T12:29:56Z
transaction,8a749fba-22e6-431c-bf04-6a66d3353c7e,posted,Coffee Shop Purchase,-3425.16,42e65b1f-e9eb-4544-8def-8ed810204fdc,13741.22,debit,payment,AU00000,2024-02-13T12:43:37Z
transaction,b516dd65-966f-4b58-9683-5fc6f370accf,posted,Uber Ride,-2601.98,27234771-8932-49f1-8a1e-7533ba31b727,11139.24,debit,cash-withdrawal,AU00000,2023-12-12T23:44:53Z
transaction,d81e340e-9cd3-44a9-b5dd-72fafd5e0b61,posted,Non Hooli ATM Withdrawal Fee,-631.22,2dd4d0b7-6b27-484e-8a3c-b6d70832f846,10508.02,debit,cash-withdrawal,AU00000,2024-03-04T13:48:05Z
transaction,dfdb797b-76bd-47d3-9129-43d7d921ef40,posted,Gym Membership Fee,-3005.54,5f1df46c-81d5-44c0-b215-30e96f97ab71,7502.48,debit,cash-withdrawal,AU00000,2023-10-18T17:06:55Z
transaction,2cb17041-15d8-4ceb-bed1-41f042d94de9,posted,Restaurant Dinner,-3198.65,9968a52e-61db-4315-9221-388a34a11bd0,4303.83,debit,bank-fee,AU00000,2023-08-17T05:40:29Z
transaction,229f4d4d-5ab3-4147-8b0a-26885f92db93,posted,AGL RETAIL ENERGY LTD (GAS),-4525.57,0de66714-5a61-465f-84fa-75e827a32fe9,-221.74,debit,bank-fee,AU00000,2024-04-18T06:57:46Z
transaction,bf2e2c6b-61c3-43af-aba4-979d53de7740,posted,Clothing Store Purchase,-4364.9,4f2249af-6679-44bf-8025-4f4a7d3b19f1,-4586.64,debit,payment,AU00000,2023-07-14T18:17:43Z
transaction,4f43b13c-3d8b-46a5-a907-eb056149a39c,posted,Online Gaming Purchase,-3341.2,38f2d7ef-54e6-4051-8d27-926632f8108d,-7927.84,debit,payment,AU00000,2024-01-16T23:12:22Z
transaction,eef90502-0e08-485b-8e30-02733011c870,posted,Amazon Online Shopping,-2469.22,ba3642d5-5810-42d4-9121-8fa83dea62ee,-10397.06,debit,cash-withdrawal,AU00000,2023-10-19T07:31:27Z
transaction,71b52c84-d64c-4a41-8620-b98123ab6aa5,posted,Uber Ride,-2161.3,b28bdc17-c3a9-40e0-9be6-710b7b7cd5c2,-12558.36,debit,cash-withdrawal,AU00000,2023-10-14T03:38:19Z
transaction,e0b8150e-caeb-4a44-a7ae-33734eec440e,posted,Payroll WFRMS 15439393,11941.84,3612b3dc-b529-4ebb-a81c-5b694e7a4746,27196.47,credit,transfer,AU00000,2024-02-22T06:27:28Z
transaction,ce49698d-0655-4fca-9dca-83444b47b76d,posted,Non Hooli ATM Withdrawal Fee,-4666.38,27ee0a72-4104-4ca3-be09-8b3ae133d191,22530.09,debit,bank-fee,AU00000,2023-12-28T13:08:52Z
transaction,e5bba869-cfd7-4f67-91dd-da6d95a3b93d,posted,Uber Ride,-1609.01,513c8e76-e929-4b28-96ac-73af9817ba34,20921.08,debit,payment,AU00000,2023-12-16T23:35:20Z
transaction,65bbf827-8d7f-4a36-97b6-b8e51892eb2f,posted,CTRLINK CARERS Ref: 998R6789201610974V,-2707.13,1dd9b4b9-88dd-4b80-8a92-347aea0115de,18213.95,debit,bank-fee,AU00000,2024-03-17T05:57:33Z
transaction,13f6c91f-fd45-41d1-98de-2fb8f0ffdb6b,posted,Gym Membership Fee,-3802.35,f23b07bb-c305-473d-a707-62ae99535a7f,14411.6,debit,bank-fee,AU00000,2023-07-06T18:45:47Z
transaction,d5b6a408-e327-4dc3-9340-2c7b324cd40c,posted,Music Streaming Subscription,-523.89,cac0a0d7-3953-4daa-912e-02e494900c05,13887.71,debit,bank-fee,AU00000,2023-10-02T01:46:05Z
transaction,9c3d0e9b-6527-445c-b0d7-613c20cdefcc,posted,Uber Ride,-3162.2,aacd07a4-7170-492f-9767-bd2505d3d124,10725.51,debit,payment,AU00000,2024-01-31T12:23:06Z
transaction,4061fd04-446e-4f4b-a2b6-cbd2d8d67555,posted,Gasoline Purchase,-1626.77,b4c3ca5e-51d3-42b5-8beb-6abecacb0d3a,9098.74,debit,payment,AU00000,2024-04-17T17:32:15Z
transaction,ff8433a0-2790-4a78-9dc1-e532d48b19f3,posted,Music Streaming Subscription,-1525.44,7fdefd0b-9113-473c-aca4-57cdf7faa646,7573.3,debit,payment,AU00000,2023-12-06T03:27:48Z
transaction,f5497f6b-75e9-4070-a9f7-21c7cd77f71d,posted,Payroll WFRMS 15439393,11741.31,95bcf177-1751-46ea-8b8e-d6faa4f6a41b,19314.61,credit,transfer,AU00000,2023-06-15T10:53:32Z
transaction,b259005c-4cb9-48ae-a4cc-8b2ed90bd3e3,posted,Movie Ticket Purchase,-320.57,13b1a3f3-7dbe-4738-b363-1a6641ef86c6,19194.57,debit,payment,AU00000,2023-11-20T03:18:27Z
transaction,2cddcf20-b904-49d1-a301-d8b1c544168c,posted,Restaurant Dinner,-3347.3,9c2468c1-4fab-4209-889c-dc28160fa2ca,15847.27,debit,cash-withdrawal,AU00000,2024-03-06T08:37:54Z
transaction,de4c6539-9b86-46f4-a9ba-35fdecccf3e5,posted,TRANSFER TO JOANNA SMITH CAMPING,-3487.05,45f35d33-6573-4e35-8821-f5bd969894ab,12360.22,debit,bank-fee,AU00000,2023-09-15T22:25:18Z
transaction,90813bd7-e866-49f4-996e-e018c81ed487,posted,Payroll WFRMS 15439393,11882.9,212fe86d-7d5c-48ce-8e5f-3b0eeff9a64d,24243.12,credit,transfer,AU00000,2023-12-10T13:12:43Z
transaction,e44ab379-8a14-44e2-b291-5509e56fd691,posted,Car Maintenance Expense,-1619.02,3c6507fe-272e-48b9-b817-dace4635fe9f,22624.1,debit,payment,AU00000,2024-02-18T17:02:34Z
transaction,bdad1d77-2047-4537-9290-0dba57cb93ee,posted,Home Improvement Store Purchase,-3059.91,6c901db0-0017-4a99-bf9e-86ce56e7e4f1,19564.19,debit,cash-withdrawal,AU00000,2023-05-15T17:29:27Z
transaction,af1d5312-8036-4ab9-8748-02d3306502e3,posted,TRANSFER TO JOANNA SMITH CAMPING,-2438.47,ab967825-5fe4-4918-a2a3-e43a8aeaeb0e,17125.72,debit,bank-fee,AU00000,2023-09-24T16:47:37Z
transaction,049108f4-661a-487d-8cbc-8201941ec2e6,posted,CTRLINK CARERS Ref: 998R6789201610974V,-4767.75,948fc774-b032-4939-bd7d-382887b2ef9c,12357.97,debit,bank-fee,AU00000,2023-08-03T02:53:37Z
transaction,43b6c1fa-2362-4e1d-bdff-9c5a0f4a8a20,posted,Movie Ticket Purchase,-1333.43,166381a1-1950-4de9-8d15-6d311248c7cf,11024.54,debit,payment,AU00000,2023-08-24T08:50:50Z
transaction,600833ad-b761-4158-8e6f-fba86cdf757d,posted,Gym Membership Fee,-1576.18,4e374c9c-8174-4654-91dd-a7c3205844ba,9448.36,debit,bank-fee,AU00000,2023-11-11T05:05:15Z
transaction,b772227b-f86a-4211-976a-30f07b23e72f,posted,Wdl ATM WESTPAC IGA BALGOWLAH BALGOWL AU,-2906.18,3b1c5cb8-0093-4991-938f-3608258bc70d,16119.62,debit,payment,AU00000,2023-07-24T02:32:03Z
transaction,3491b303-17ba-4cc1-8142-0dcaedfc29d7,posted,Hair Salon Appointment,-1568.32,324e101f-d069-4acd-95de-5a019d49cdfb,14551.3,debit,payment,AU00000,2024-04-05T07:53:20Z
transaction,6eb8ba01-ed8b-40e0-8664-f32bebc4ed2e,posted,Home Improvement Store Purchase,-3331.51,940b509d-e120-4074-83ff-e47e46a9178c,11219.79,debit,cash-withdrawal,AU00000,2024-02-16T01:38:44Z
transaction,f1ba2236-b3c1-4034-80f0-c8f179a61b4d,posted,Car Maintenance Expense,-699.22,2caea6b0-206d-4bb9-9e13-27a20bb280e8,10520.57,debit,bank-fee,AU00000,2023-09-09T13:20:17Z
transaction,b1ab89d5-fede-43c3-a4fc-0cefe5200f36,posted,Netflix Subscription,-4629.46,be96dc34-c8ac-4f65-826c-df08dca8ff22,5891.11,debit,payment,AU00000,2023-12-01T19:31:21Z
transaction,310af7ce-0f4c-4800-8f4e-de0ed9ca6205,posted,TFR Acc14000 TO 12389,-489.27,bd82612c-9d65-45ae-bde0-fad5d0d17e33,5401.84,debit,payment,AU00000,2024-01-21T12:25:50Z
transaction,b518904a-f308-496e-9a6e-58471dc81d43,posted,Clothing Store Purchase,-586.5,1b929157-4ae3-4ed5-98a8-cf9b4c9eae54,4815.34,debit,cash-withdrawal,AU00000,2024-02-16T02:34:20Z
transaction,bc9ab2e3-b499-4e7a-9353-152c426880d0,posted,Non Hooli ATM Withdrawal Fee,-1164.94,71c41a27-f013-4a14-98f6-2a1d13d181ef,3650.4,debit,cash-withdrawal,AU00000,2023-09-17T10:11:05Z
transaction,84cf8e4e-52cf-43ea-84b2-4422488fe5be,posted,Transfer Platnm Homeloan 346454,-1385.18,1b922b1b-a0a7-4ad5-9f77-1be0a86febb4,2265.22,debit,cash-withdrawal,AU00000,2023-07-08T03:02:13Z
transaction,a301c858-5b30-4965-872f-3ec4a15ce0a7,posted,Home Improvement Store Purchase,-2121.83,a25d841f-8a2a-43f4-bbf9-f6ff68736605,143.39,debit,bank-fee,AU00000,2023-11-13T17:50:16Z
transaction,4d51abcd-2dde-4f87-8b80-b3918f880fb9,posted,Pharmacy Purchase,-3196.8,8a48fea9-8b0f-4bcb-aafa-4211ff8deab4,9399.7,debit,cash-withdrawal,AU00000,2024-03-26T14:52:42Z
transaction,32d9a8ad-e8b4-4d4c-896f-c9370fa66e2d,posted,CTRLINK CARERS Ref: 998R6789201610974V,-3295.04,2807e108-14bb-45c1-a3f1-d065715254bf,6104.66,debit,cash-withdrawal,AU00000,2023-10-17T10:33:42Z
transaction,33f3519e-a8e1-460e-86cd-d7e024324a56,posted,Mobile Phone Bill Payment,-2871.66,fe527e13-a1e3-4517-b321-63bfc000b905,3233.0,debit,bank-fee,AU00000,2023-12-12T11:58:57Z
transaction,97ffeefb-90ba-45fb-b3c5-c66c2cc1f497,posted,CTRLINK CARERS Ref: 998R6789201610974V,-3645.53,590d9a77-54d8-40ce-a72b-d65d095c7398,-412.53,debit,payment,AU00000,2024-01-22T11:15:39Z
transaction,ff890bec-2d6a-4d66-b4fc-10514ac65c59,posted,Public Transport Fare,-2052.62,71503f57-7392-4376-80da-65317162d53a,-2465.15,debit,cash-withdrawal,AU00000,2024-02-29T16:55:31Z
transaction,386e0a46-356d-4099-8b06-a8713bfab34a,posted,Wdl ATM WESTPAC IGA BALGOWLAH BALGOWL AU,-4466.23,de16915a-d85f-4a19-b7e3-069742b9db94,-6931.38,debit,cash-withdrawal,AU00000,2023-11-30T01:53:46Z
transaction,1333aec9-f067-4a86-81f7-7aeeaa0706f9,posted,Non Hooli ATM Withdrawal Fee,-770.76,ef79ea76-246c-4775-a943-049e23a2d423,-7702.14,debit,payment,AU00000,2023-06-15T01:41:31Z
transaction,16e25c67-cb16-41fd-b899-894567889be1,posted,Online Gaming Purchase,-1936.44,f54426fd-0b0d-4310-97e5-718cc3e73ac1,-9638.58,debit,payment,AU00000,2024-04-12T12:42:42Z
transaction,aa9a3bc1-030e-4d0d-ac1d-c2546eca3e76,posted,Movie Ticket Purchase,-2140.55,b752e79d-9cd7-4dbf-be48-629d56624ebe,-11779.13,debit,cash-withdrawal,AU00000,2023-05-16T16:58:37Z
transaction,ae9eabe6-5fad-4bb2-aa85-41164dd27269,posted,TFR Acc14000 TO 12389,-3077.8,53b762d0-1bfd-4b32-bae6-6d298a7ef092,-14856.93,debit,payment,AU00000,2024-04-19T04:10:01Z
transaction,25a9fd04-4ed6-4423-8200-3cffae4d3060,posted,Clothing Store Purchase,-2446.86,041fdb5f-942a-4196-8295-a16eeff2b578,4757.21,debit,payment,AU00000,2023-09-06T01:29:01Z
transaction,6fa37c27-d682-4fd5-855a-4f6b183514e3,posted,Mobile Phone Bill Payment,-3111.6,6472eaec-8a5b-43ae-98a7-3f8ea496a886,1645.61,debit,cash-withdrawal,AU00000,2023-12-30T06:31:06Z
transaction,f0151ca2-6564-43a5-852e-8308ef2b2b07,posted,Coffee Shop Purchase,-2347.19,13e98e42-48ef-42d2-b711-d97d8057ad15,-701.58,debit,cash-withdrawal,AU00000,2023-11-11T06:50:21Z
transaction,5354c4a1-48a6-4a62-877b-4bc98861f9bd,posted,Transfer Platnm Homeloan 346454,-2204.08,48484a49-31da-4a28-a698-d21a3cc2126f,-2905.66,debit,payment,AU00000,2023-12-29T15:17:20Z
transaction,234acaf7-2bc0-48d8-81f8-8eb11876ec55,posted,Payroll WFRMS 15439393,11755.83,6fffd401-71d3-4975-a75b-5e682d74c6d3,8850.17,credit,transfer,AU00000,2024-05-02T10:11:23Z
transaction,dc536451-51d3-4e54-bdf7-3551f29de996,posted,Netflix Subscription,-1596.12,12e28a74-f73c-4f33-b7b8-896496d2f401,7254.05,debit,cash-withdrawal,AU00000,2023-11-17T14:24:46Z
transaction,c48e2767-7034-439e-99c8-79696d314ba4,posted,Uber Ride,-2530.65,16783ec0-eb6f-46d5-85bc-ed04b950d55e,4723.4,debit,payment,AU00000,2023-11-20T01:37:21Z
transaction,e2333b41-635d-4eaa-b30a-26e7837b3f04,posted,AGL RETAIL ENERGY LTD (GAS),-1000.42,7a620e54-2baf-4c4b-8d80-2491fec3df82,3722.98,debit,cash-withdrawal,AU00000,2023-08-08T18:12:51Z
transaction,5618d8ba-2606-4d50-9d67-5f06f4b0f943,posted,TRANSFER TO JOANNA SMITH CAMPING,-4982.86,0a9ee0bf-49d1-4ef6-89dc-8f4b38a7719a,-1259.88,debit,bank-fee,AU00000,2024-03-03T05:40:54Z
transaction,8a22e809-f5f1-4ac9-aba7-68aaf0c0575d,posted,Gasoline Purchase,-2504.73,bb71e665-b96a-4055-8ae0-6ca07e819da2,-3764.61,debit,payment,AU00000,2024-02-18T22:46:47Z
transaction,f4a85b5e-e507-4418-b1d8-afdfa27febf8,posted,Online Gaming Purchase,-2369.88,4b45dcfc-3486-472d-86f7-02814a8beff5,16667.88,debit,bank-fee,AU00000,2024-02-05T09:44:16Z
transaction,c831cf5b-4ebe-4e55-9942-3a6aab04a583,posted,Gasoline Purchase,-3141.38,55bf432c-b57c-4875-98be-02141d79deca,13526.5,debit,payment,AU00000,2023-08-11T16:26:29Z
transaction,26d4d466-cffd-402f-b26a-047e7b59cf9b,posted,Mobile Phone Bill Payment,-4268.36,eb1d8d21-0d1a-4593-ac78-9246b738292a,9258.14,debit,bank-fee,AU00000,2023-09-17T10:47:04Z
transaction,a7d7a480-37af-47d9-b392-0c220624b9b8,posted,Netflix Subscription,-645.85,33de7980-bdcc-4f6f-8cdd-f9f582f93597,8612.29,debit,cash-withdrawal,AU00000,2024-03-30T05:07:10Z
transaction,48f9bb0f-1fde-491b-bf02-44fdb7f899e5,posted,Mobile Phone Bill Payment,-1624.92,7a3c2534-c180-4bc8-8aa8-e944ba64fd0a,6987.37,debit,cash-withdrawal,AU00000,2023-10-22T22:03:40Z
transaction,3b84cf8c-6618-4873-9927-a6e4505adf76,posted,Online Gaming Purchase,-4822.25,461a1546-7b23-42c9-ba4d-caa47f9eb54e,2165.12,debit,cash-withdrawal,AU00000,2024-04-09T02:25:32Z
transaction,9d9f19a7-863c-4aad-a8de-c338a08fa37d,posted,Car Maintenance Expense,-90.54,5513769b-9988-4775-afe9-1b9f1e916e3a,2074.58,debit,bank-fee,AU00000,2023-07-01T12:19:18Z
transaction,45398d78-edd8-4abd-a42f-9bfaf3748ec2,posted,Electricity Bill Payment,-2417.44,abec6d09-abf3-4771-baa4-c6605c63f855,-342.86,debit,bank-fee,AU00000,2023-11-27T05:40:53Z
transaction,6f738fbf-db65-4984-9876-7128ca9f1585,posted,Bookstore Purchase,-4399.93,21c92a5b-560d-4464-8799-9eb8c0d8590d,-4742.79,debit,bank-fee,AU00000,2024-02-18T13:15:42Z
transaction,6a3e4306-8dc2-4cea-bcdd-e3a3cafcf1af,posted,AGL RETAIL ENERGY LTD (GAS),-4307.99,c5325cab-a923-456e-a4c3-a534335a076e,-9050.78,debit,payment,AU00000,2023-11-13T21:17:00Z
transaction,c8521791-83cd-4bfb-80a4-a7c3c601dcd8,posted,Coffee Shop Purchase,-1051.58,88ff0315-cd57-40fa-a982-61aaf867b73b,5405.18,debit,payment,AU00000,2024-01-28T18:41:50Z
transaction,6d0512d9-b10d-4dae-b5b9-a996710dbf1f,posted,Amazon Online Shopping,-1139.23,518950f5-a2af-4864-9b8b-a583e40b61f6,4265.95,debit,cash-withdrawal,AU00000,2024-03-17T12:42:52Z
transaction,7a102df1-a6f1-45b5-8cd2-dacc5f0fc82b,posted,Online Gaming Purchase,-1057.08,d8893381-96b4-4f79-9595-44472e50b30a,3208.87,debit,cash-withdrawal,AU00000,2023-06-05T17:48:04Z
transaction,8ed9211d-a6eb-4761-8103-c76c319f726a,posted,Pharmacy Purchase,-3093.51,ca6e2044-e8c5-4f07-8459-6cfc876075bb,115.36,debit,bank-fee,AU00000,2024-03-05T04:04:38Z
transaction,9626e8ee-3673-4b98-bb60-18e1636b9eaf,posted,Online Gaming Purchase,-4997.88,ad3f4711-4735-43c6-94f1-566e9840d0c4,-4882.52,debit,payment,AU00000,2023-07-31T12:40:02Z
transaction,533163f0-ad7c-41e2-872a-c87d93fe5933,posted,Mobile Phone Bill Payment,-2355.59,bba41891-e8d0-4c19-aa39-c6d5b9d2780a,-7238.11,debit,bank-fee,AU00000,2024-04-15T17:06:23Z
transaction,9841db79-7eaa-4e6d-8d9f-9e2ab4549cd3,posted,Pharmacy Purchase,-232.7,da253661-d7a3-44fb-a493-25317176e025,-7470.81,debit,bank-fee,AU00000,2023-07-12T20:36:19Z
transaction,a57cc282-9ad8-4651-8db5-05b49298e166,posted,Online Gaming Purchase,-2571.48,d8229746-eb5b-4312-b407-846f1a577839,-10042.29,debit,payment,AU00000,2023-10-22T14:38:31Z
transaction,8b38fea0-8050-4ea5-966b-d75a570b5470,posted,Pharmacy Purchase,-1954.65,68361600-f0f5-4ea2-97a6-171355e1f410,-11996.94,debit,bank-fee,AU00000,2024-01-09T20:10:18Z
transaction,0055d90d-4d98-4567-9c87-2c31165760a7,posted,Uber Ride,-634.07,cc6ebecd-0525-4569-8bc5-59aaac00dab0,-12631.01,debit,payment,AU00000,2024-01-05T22:53:52Z
transaction,83c96835-82f7-4e03-9a61-530235c1f998,posted,Home Improvement Store Purchase,-611.39,c27297da-9f4e-4050-8b1d-18dd3e01951d,15349.24,debit,bank-fee,AU00000,2023-12-09T16:17:31Z
transaction,977ff338-f0ca-4c18-9386-08c3feec4f83,posted,Online Gaming Purchase,-3727.81,bf9e1ce7-ae38-4fe1-80bb-548795010bdd,11621.43,debit,bank-fee,AU00000,2023-09-28T07:31:49Z
transaction,50c0ea06-e965-4ea8-8bc9-3e161c7b1071,posted,Electricity Bill Payment,-3198.66,49356fd6-70a8-4eca-b7c1-54428eb4e424,8422.77,debit,payment,AU00000,2023-10-18T03:03:51Z
transaction,e1f8ad0e-058c-49f7-b717-88d664cd07d6,posted,Movie Ticket Purchase,-1234.54,0531290a-1ab7-42be-b75a-e48f8810449a,7188.23,debit,payment,AU00000,2024-04-13T06:50:56Z
transaction,96ecc7e3-d326-451f-9cad-423dc24fbac3,posted,Pharmacy Purchase,-3890.53,171170c1-8bab-4f27-8173-f17afa1a4415,3297.7,debit,bank-fee,AU00000,2023-05-20T04:49:59Z
transaction,304389ed-f05f-403c-a63d-d5b8965937bd,posted,Non Hooli ATM Withdrawal Fee,-1984.8,d8ee1a8e-923c-4bda-896c-4f8b136ddc66,1312.9,debit,cash-withdrawal,AU00000,2023-10-16T11:26:03Z
transaction,fcdc092e-02de-48ca-9bab-0dde8abbb26d,posted,Wdl ATM WESTPAC IGA BALGOWLAH BALGOWL AU,-3889.48,b511f891-df17-4b12-aa8c-9197cc694119,-2576.58,debit,payment,AU00000,2024-02-25T10:29:34Z
transaction,0e0b957b-6220-4273-8ded-91180a6ea717,posted,Coffee Shop Purchase,-1484.54,c84e03a4-3d99-4e8a-bdf1-5e4fc0fd0184,-4061.12,debit,bank-fee,AU00000,2023-08-26T05:19:03Z
transaction,064f0929-669b-4397-b390-b70cf9d93af6,posted,Travel Agency Booking,-4464.41,b5a64305-1a4a-4e30-91af-df757a556908,-8525.53,debit,bank-fee,AU00000,2024-01-27T13:18:47Z
transaction,b42d6f67-6583-4e6d-943c-492799012e25,posted,Restaurant Dinner,-2304.65,f36c53f1-c067-499a-a94f-bc8a61690e08,-10830.18,debit,cash-withdrawal,AU00000,2023-05-27T02:30:19Z
transaction,048279dd-e3bc-4189-9dd4-cf6ce2f2f348,posted,Clothing Store Purchase,-401.14,53cf7e92-5383-4ef8-8f1e-34c03650585f,5866.79,debit,payment,AU00000,2024-03-22T00:32:47Z
transaction,1972bea9-2471-4d57-b14a-1bc38105121d,posted,Travel Agency Booking,-745.28,81ed206b-b92e-49d3-8422-89fac83afcc3,5121.51,debit,bank-fee,AU00000,2023-06-19T11:03:30Z
transaction,89b95841-cc54-407f-9a90-76e77b3ba7e1,posted,Gym Membership Fee,-3676.7,c1cf6795-699d-484a-8401-3589a94ecc7e,1444.81,debit,bank-fee,AU00000,2024-04-13T09:33:02Z
transaction,9bbd47c4-f982-4512-a20c-58f4cc1c66ad,posted,Hair Salon Appointment,-2567.56,36aa4a9b-63f1-417b-952f-b373925187f0,-1122.75,debit,bank-fee,AU00000,2024-02-16T15:28:30Z
transaction,d988f0cf-aa0a-4bf0-ab7d-439b0f2ef7f4,posted,Public Transport Fare,-2604.93,56f1f5d2-9cb7-409d-9099-b22340aceb39,-3727.68,debit,bank-fee,AU00000,2024-04-06T23:02:32Z
transaction,4c2231f3-76f9-4bf4-8fd3-311b717ec152,posted,Amazon Online Shopping,-4320.63,5f3c2dd3-cc88-4371-af65-f1811d9ef2b1,-8048.31,debit,payment,AU00000,2023-07-16T22:19:00Z
transaction,8ad23a08-aea1-4fd4-af22-2eae0ec5424c,posted,Transfer Platnm Homeloan 346454,-752.26,32ccb79b-78b2-4551-851e-ee61dad1f81b,-8800.57,debit,cash-withdrawal,AU00000,2023-07-30T08:57:09Z
transaction,7314fbfa-22a5-48ff-9508-5db8ecfc2866,posted,Public Transport Fare,-3877.67,fd1c1e7f-ce78-470f-b776-1263e61dd3a1,-12678.24,debit,cash-withdrawal,AU00000,2023-09-03T22:53:05Z
transaction,ea20d8f0-07a8-4bbc-bd5a-9b399e94ab15,posted,Uber Ride,-1870.92,919c7e51-10b0-4425-b7b3-03a4a3343127,-14549.16,debit,cash-withdrawal,AU00000,2024-03-23T17:37:22Z
transaction,7ae3dd7e-10e4-4e86-bb44-1aa8eae49c60,posted,Uber Ride,-4865.41,d052e013-acd8-4b9c-b222-5c3ec49020a4,-19414.57,debit,payment,AU00000,2024-03-31T20:22:12Z
transaction,c239a59b-7127-42f3-85ee-2fe3c39292ed,posted,Non Hooli ATM Withdrawal Fee,-2217.25,1f54f012-5d82-4fed-9b58-204d8389c3d7,17245.46,debit,cash-withdrawal,AU00000,2023-08-13T05:31:02Z
transaction,7024179c-7b87-4e32-87b6-226d402580ea,posted,Online Gaming Purchase,-1577.41,ec3ec917-83c8-40b3-9ec9-9c88a984eef9,15668.05,debit,cash-withdrawal,AU00000,2023-07-06T10:10:43Z
transaction,a8f9de18-1c47-4186-84e8-bed62f1e7e8a,posted,Wdl ATM WESTPAC IGA BALGOWLAH BALGOWL AU,-1690.49,c9c5cd83-2f6a-436a-a5c2-988b1a79a6e8,13977.56,debit,cash-withdrawal,AU00000,2023-07-26T02:37:00Z
transaction,96ab122d-7ed3-4e59-9d98-c68b776df7b1,posted,Online Gaming Purchase,-3166.0,09dda550-1ca4-4011-9380-251a7c4a6255,10811.56,debit,cash-withdrawal,AU00000,2024-05-09T17:07:52Z
transaction,ddec444c-ca43-4b4c-b278-786a3c3e0c88,posted,Music Streaming Subscription,-1507.53,a50094c5-d2b9-4fb0-ab6e-b85e81d9f770,9304.03,debit,bank-fee,AU00000,2023-12-26T18:37:45Z
transaction,0d31639b-13d8-4224-b294-117ffbb5e6b2,posted,Gym Membership Fee,-2066.84,bfdac9a3-a296-4736-a993-008df63a91f3,7237.19,debit,payment,AU00000,2023-06-25T03:14:49Z
transaction,81c7216b-cb78-47ee-ba38-076610bf5363,posted,Amazon Online Shopping,-4582.53,6f6c347a-fac0-4e62-93cd-1ab92c05795c,2654.66,debit,payment,AU00000,2023-07-24T14:56:42Z
transaction,4fb22e97-8b34-4f79-ae30-79ba968fd931,posted,AGL RETAIL ENERGY LTD (GAS),-1828.11,23c0154f-f560-4630-ab31-61fb6e50a6bb,826.55,debit,cash-withdrawal,AU00000,2024-02-13T20:58:38Z
transaction,9c17f216-f983-4020-b932-db56ee7c9f92,posted,Clothing Store Purchase,-3527.48,0dae9bfd-3f56-4459-a509-a78d3418e11b,-2700.93,debit,cash-withdrawal,AU00000,2024-05-07T17:38:14Z
transaction,e0abe0cf-aab0-49e3-8565-2d48da1dfb09,posted,Bookstore Purchase,-3859.01,f60be9d7-2e2f-4e60-9b1e-72197af4fa59,-6559.94,debit,payment,AU00000,2023-08-04T07:03:19Z
transaction,8e135d23-3ae5-45be-bcd4-cb75d48175ba,posted,TRANSFER TO JOANNA SMITH CAMPING,-3289.0,23b4c148-3152-430b-8c49-b7dc0429a336,11755.74,debit,payment,AU00000,2023-10-01T07:01:02Z
transaction,39eb6a3d-6a3f-43ca-837d-20b5a9a2f530,posted,AGL RETAIL ENERGY LTD (GAS),-4482.9,29fa507a-e269-4d00-acfb-9dc51742a8d6,7272.84,debit,bank-fee,AU00000,2023-06-26T03:23:50Z
transaction,ee957dc4-d0b1-417a-906c-cc16f6ea3874,posted,Manly Maths Tutor Wages,-2889.41,820ff16c-8d64-4347-9517-69fd7f10a553,4383.43,debit,payment,AU00000,2024-04-09T06:25:52Z
transaction,c4c9a9e5-8e3f-446f-aa88-4ca594f7e7a8,posted,Electricity Bill Payment,-687.69,30a37e42-7f5b-4ce8-8ccd-ca96d6455574,3695.74,debit,payment,AU00000,2023-06-18T14:59:17Z
transaction,5005eb0b-3f6d-4bbf-8a76-3f85fd7d6c74,posted,Travel Agency Booking,-4120.61,18e419f4-38f1-4a00-a3a7-a736c68925db,-424.87,debit,payment,AU00000,2024-05-02T06:05:16Z
transaction,9dba0e5e-df4c-4fa4-9ba5-ba59a3bafb3f,posted,Hair Salon Appointment,-2480.31,5318a28a-b759-4a30-841a-fd6080ba5818,-2905.18,debit,bank-fee,AU00000,2024-02-23T06:14:33Z
transaction,5c736366-69c4-450f-b146-6271a7846520,posted,TFR Acc14000 TO 12389,-4543.81,bc689974-3cdf-415e-a592-27cbdaee23b7,-7448.99,debit,payment,AU00000,2023-11-25T17:36:01Z
transaction,39ba885b-e2dc-49a9-b283-258287151f09,posted,Public Transport Fare,-4545.0,a3c3b6ae-5f1c-4fb3-ac42-9e2e07c2fe7a,-11993.99,debit,payment,AU00000,2023-10-18T05:44:33Z
transaction,771f49ad-6290-41fc-80ee-ed2a40a443e3,posted,Music Streaming Subscription,-1798.19,51a3f737-ff82-4ddc-86cb-0870ee850c7f,-13792.18,debit,payment,AU00000,2023-08-23T03:07:12Z
transaction,2c140bcd-0332-4433-b3d6-ab6c5d6b6235,posted,TRANSFER TO JOANNA SMITH CAMPING,-3251.02,f0ea1b6c-4928-494b-a4e0-1d49ab37a8f9,-17043.2,debit,bank-fee,AU00000,2023-06-12T16:53:11Z
transaction,aa9b8569-1599-4982-b753-c79b49a11f74,posted,Bookstore Purchase,-3722.51,6eafc043-4922-4f34-840d-eee2497a1a5a,14481.96,debit,bank-fee,AU00000,2024-03-11T09:52:17Z
transaction,4d7af13b-a84a-48f8-887f-faad97007010,posted,Gym Membership Fee,-4694.28,51ce04bd-9224-4fc5-8f10-6be91cbd28df,9787.68,debit,payment,AU00000,2023-07-21T12:18:19Z
transaction,adf0cd99-9f7e-45ba-83b4-1efbaa8960b9,posted,Bookstore Purchase,-2022.87,e6223f03-c5de-4d04-9987-1fb36b0c80d0,7764.81,debit,bank-fee,AU00000,2024-04-13T11:56:12Z
transaction,59ea3b92-908c-4a96-9565-f4cd76a7cae6,posted,Payroll WFRMS 15439393,10035.38,6ec800e5-a95b-4795-8aac-6c253c56f7b6,17800.19,credit,transfer,AU00000,2023-05-18T08:52:00Z
transaction,66ac1728-4688-4aa9-8bd7-af2e78dfabd5,posted,Mobile Phone Bill Payment,-4825.32,44ee8f6e-b8ca-457a-9e14-567fce4b8140,12974.87,debit,cash-withdrawal,AU00000,2024-01-23T14:54:51Z
transaction,849d9953-9b26-4fb6-a796-e9d868f5a8d0,posted,Gasoline Purchase,-590.59,71d61549-97de-4d88-8336-65c2b9ca3e5e,12384.28,debit,payment,AU00000,2023-09-29T05:13:40Z
transaction,8acf20ff-a9e8-467b-aaba-f40663739a2c,posted,Car Maintenance Expense,-3767.44,065b197a-412b-427b-9c20-77d0371d3040,8616.84,debit,cash-withdrawal,AU00000,2023-07-11T19:08:50Z
transaction,9f3c736e-a9ff-44cc-9bea-6428e819312f,posted,Restaurant Dinner,-4716.39,80ced764-2d7f-44b9-94bb-1ed826c2e745,3900.45,debit,cash-withdrawal,AU00000,2023-12-28T13:57:03Z
transaction,d420818e-fba9-438a-9ca2-3996a25e577d,posted,AGL RETAIL ENERGY LTD (GAS),-1726.5,c9454254-3569-4db7-b58d-d76f826e045a,2173.95,debit,bank-fee,AU00000,2024-04-21T11:42:56Z
transaction,815e2c79-c132-414f-87c3-7d86dd58db85,posted,CTRLINK CARERS Ref: 998R6789201610974V,-1980.51,2900e670-8ade-4a8e-a88c-4408bd9fdab2,193.44,debit,cash-withdrawal,AU00000,2024-01-12T04:16:04Z
transaction,f5b6643a-81ce-4246-be4d-d1af13433ffd,posted,Netflix Subscription,-2346.81,25b6c626-ab3a-4d57-879c-8484fbc6b345,10648.99,debit,bank-fee,AU00000,2023-11-06T02:14:06Z
transaction,868731b1-3348-4b61-915f-5d57176f39f6,posted,Clothing Store Purchase,-498.17,14bd86bf-ea92-4725-a731-4d1df67d89ad,10150.82,debit,payment,AU00000,2023-12-30T15:10:07Z
transaction,ad99dad5-1b4a-449a-87bc-46653e323c28,posted,CTRLINK CARERS Ref: 998R6789201610974V,-3156.65,c39df356-ed80-4de7-8ffe-af161d7258ce,6994.17,debit,cash-withdrawal,AU00000,2023-09-08T20:34:54Z
transaction,ef261cf6-e35e-4705-b81c-dc5fec5ffdd6,posted,TFR Acc14000 TO 12389,-1326.87,b0719b60-aa92-4796-9e6b-938745baa424,5667.3,debit,cash-withdrawal,AU00000,2024-01-30T20:58:49Z
transaction,424c1493-ad0f-464d-bf84-e4be8dff4aef,posted,Mobile Phone Bill Payment,-1704.01,930dc349-7ce0-4d51-9b2d-f6effba3f4aa,3963.29,debit,cash-withdrawal,AU00000,2023-10-31T22:41:37Z
transaction,7484545e-7ad9-42c3-bc83-cd22d1586826,posted,Home Improvement Store Purchase,-466.33,4a726409-7d04-429b-876b-b731c7e4f53e,3496.96,debit,cash-withdrawal,AU00000,2023-12-09T11:27:51Z
transaction,730eec84-8be0-471e-ad57-6cbfe1007198,posted,Transfer Platnm Homeloan 346454,-1313.76,06fef1d2-0e0b-49cd-bf6b-91fd147f9872,2183.2,debit,payment,AU00000,2024-01-01T08:03:28Z
transaction,86f3e165-fdb6-40c3-8585-07e37014714e,posted,CTRLINK CARERS Ref: 998R6789201610974V,-595.6,ee140575-8405-4a05-8736-9985d025e3ea,1587.6,debit,cash-withdrawal,AU00000,2023-09-11T17:19:52Z
transaction,82c7aaaa-62d5-4803-b9c9-8a70b73ae9ba,posted,Amazon Online Shopping,-241.11,7f5f3a13-1ce8-4ec1-9df0-4fb61e8d3908,1346.49,debit,bank-fee,AU00000,2023-12-15T10:02:57Z
transaction,2b462cfa-151a-45a8-adbf-f78326bbeedc,posted,Netflix Subscription,-3905.69,e04cb25e-625e-401f-8c9f-a323968bff71,-2559.2,debit,bank-fee,AU00000,2024-02-10T11:01:57Z
transaction,d64d1860-c874-4257-978e-0249c766b7a9,posted,Amazon Online Shopping,-1193.88,70db43f5-ddf7-4e67-80eb-bfc1f628890a,6669.75,debit,bank-fee,AU00000,2023-11-07T22:20:31Z
transaction,1fa93876-8492-481c-86ad-e49a477e9335,posted,Online Gaming Purchase,-1458.85,a865576f-e1c0-40bd-9cdb-e0ab61f8dd31,5210.9,debit,cash-withdrawal,AU00000,2024-05-07T17:14:41Z
transaction,4d86f4e3-85c3-477b-a759-5f080abf1f89,posted,AGL RETAIL ENERGY LTD (GAS),-1467.47,feebc8fd-1a6a-43bb-886e-f368cfec691d,3743.43,debit,cash-withdrawal,AU00000,2023-07-16T15:01:08Z
transaction,8a1f43d7-9a45-4984-a696-274e16b0376f,posted,Amazon Online Shopping,-2592.2,49719147-1ec9-47e0-a1ed-649aaf840885,1151.23,debit,bank-fee,AU00000,2024-02-21T17:45:07Z
transaction,af25d20f-d48c-4cff-af2f-a98a5b0b26b6,posted,Restaurant Dinner,-3926.38,b25e0fe2-c46a-47b9-a9f9-374b0f60f957,-2775.15,debit,bank-fee,AU00000,2023-07-25T08:50:20Z
transaction,2099be6c-9ca4-47b9-be95-2dce382c64ab,posted,TFR Acc14000 TO 12389,-4969.14,b6c0b663-5229-444e-b7a6-b80164a4c42e,-7744.29,debit,payment,AU00000,2024-01-05T21:52:39Z
transaction,8c62bfbc-63f3-4112-925e-c090e33a584d,posted,Restaurant Dinner,-4113.38,1deb4a9b-1915-4435-a6ac-1a56d0367ca8,-11857.67,debit,cash-withdrawal,AU00000,2024-02-20T13:53:49Z
transaction,2d996d03-3511-46e1-9694-eac45651d427,posted,TRANSFER TO JOANNA SMITH CAMPING,-854.07,1764cf38-1a96-4b1d-a67a-b10394775ec5,-12711.74,debit,bank-fee,AU00000,2024-02-02T11:21:17Z
transaction,cea8fea1-d15d-41b0-9e75-ab25001796f3,posted,Movie Ticket Purchase,-2947.25,c67585e1-270e-45c7-a9bd-01b19df3747a,-15658.99,debit,bank-fee,AU00000,2023-12-02T08:48:48Z
transaction,1a855030-eea0-4025-8323-df830f7aeb56,posted,Home Improvement Store Purchase,-3063.1,0ec5c99a-a5e4-4d0b-94c3-d4dd7bbf02cd,-18722.09,debit,bank-fee,AU00000,2023-09-14T18:06:11Z
transaction,3f4dc825-7fab-4d31-b908-abf9ba5bdc01,posted,Uber Ride,-1398.43,2c5d74f9-820d-4c1a-b743-ed71c5749fdb,8044.88,debit,payment,AU00000,2023-11-21T07:19:59Z
transaction,f94e0617-9573-4833-9137-f7abcc176b54,posted,Transfer Platnm Homeloan 346454,-1342.18,e309bfd5-0195-437d-bfef-782063a1976b,6702.7,debit,payment,AU00000,2024-04-20T20:25:38Z
transaction,824143f0-82d6-4f95-9925-3165f2bd8e57,posted,Movie Ticket Purchase,-3166.95,d21ca3b2-b384-4588-8573-189831dcb852,3535.75,debit,cash-withdrawal,AU00000,2024-01-28T01:51:14Z
transaction,2fd2230f-99af-48ed-89c6-a1656318219d,posted,Movie Ticket Purchase,-2019.26,434009ed-2c41-4483-86aa-3cd4b2e51546,1516.49,debit,cash-withdrawal,AU00000,2023-07-19T03:12:58Z
transaction,09bd462d-e1bb-4b37-85df-73206e577d1e,posted,Clothing Store Purchase,-1356.47,f3da5c11-d46a-4fa0-b4f0-f1592f5e73b6,160.02,debit,bank-fee,AU00000,2023-12-31T21:09:05Z
transaction,69e990e4-d821-4609-98fc-5adbae8a0fea,posted,Restaurant Dinner,-300.74,afc7c968-9ffb-463c-a28d-ac7d7a1d76c5,-140.72,debit,bank-fee,AU00000,2023-08-17T22:13:12Z
transaction,a339da65-3143-47ca-9b4b-e48674fc40d0,posted,Pharmacy Purchase,-2365.23,fe44b0d9-5405-42d0-b81a-4ca55876acbc,-2505.95,debit,bank-fee,AU00000,2023-08-25T00:47:20Z
transaction,d7d4be16-05d5-4567-a07c-a498e1ea3e71,posted,Netflix Subscription,-1554.04,b6b3bee8-20c0-4dc3-93aa-8cfdb5eda264,-4059.99,debit,bank-fee,AU00000,2024-01-26T00:47:18Z
transaction,44226156-e060-4ea9-a07e-63afc2014a7a,posted,Online Gaming Purchase,-4329.7,c8fc232d-ad57-48b2-abec-4048fc1432f2,-8389.69,debit,bank-fee,AU00000,2023-09-15T13:10:11Z
transaction,433be302-78d7-4014-b9c3-8497261e9b73,posted,Transfer Platnm Homeloan 346454,-2637.25,b994a164-9277-4c05-8728-d5ad606cdc23,-11026.94,debit,cash-withdrawal,AU00000,2023-12-26T08:14:32Z
transaction,aec4ec75-1699-4b7a-8145-02346249455c,posted,Movie Ticket Purchase,-2575.44,5b137590-6d68-4977-82e0-661f8ede59b2,16442.91,debit,payment,AU00000,2023-06-03T03:09:28Z
transaction,075a243a-45bd-428d-93c1-d9179d39b5c7,posted,Transfer Platnm Homeloan 346454,-4700.42,d4385183-9660-4fd5-a8d5-798fc88f5e02,11742.49,debit,payment,AU00000,2023-08-27T15:58:46Z
transaction,3b7eaa73-25b8-4eb9-a82f-61ee2a0fd017,posted,Restaurant Dinner,-2340.41,783c5126-40b6-474e-8b3c-c983ee729536,9402.08,debit,bank-fee,AU00000,2024-03-28T23:42:57Z
transaction,6dc1a1d7-739e-4f42-b6ad-cdd9d193d12d,posted,Movie Ticket Purchase,-2488.53,215062e9-6358-4600-aaf8-4c1d933bd2be,6913.55,debit,payment,AU00000,2024-03-20T01:03:11Z
transaction,a0e2f40e-52be-4695-bee7-c9d49d8a6a49,posted,Coffee Shop Purchase,-3503.06,01d706de-b898-4398-9680-86f6d093f442,3410.49,debit,cash-withdrawal,AU00000,2024-04-24T20:53:55Z
transaction,d10d191a-8efe-412f-8b61-7b607fa3fef8,posted,Mobile Phone Bill Payment,-4167.66,dbe0d5ea-c6ed-40a0-8c95-d9f02c827cf1,-757.17,debit,payment,AU00000,2024-03-13T20:50:28Z
transaction,593692e2-af37-4445-bb24-48098cb251c5,posted,Online Gaming Purchase,-566.63,ac32ae33-73cc-4c27-bbc6-cb3b6fcea92e,-1323.8,debit,cash-withdrawal,AU00000,2024-03-07T10:15:28Z
transaction,1d2c59b4-f70e-4591-b089-09661a8bbc0c,posted,Uber Ride,-2526.71,d8149e5e-ee2e-447f-916e-c7db7452661d,-3850.51,debit,cash-withdrawal,AU00000,2023-12-08T11:08:51Z
transaction,53029d4c-669c-4fb0-9e61-ff6d5eb37c6a,posted,Hair Salon Appointment,-4695.42,5aad5c1b-06a0-493d-99e7-9c82ecbf6d77,-8545.93,debit,payment,AU00000,2023-05-15T14:56:41Z
transaction,c939dbe0-134c-4584-af1c-53a57e8d7e7d,posted,Payroll WFRMS 15439393,10977.03,f59effce-c659-4237-bb3a-86724ae436bf,2431.1,credit,transfer,AU00000,2024-03-11T03:48:26Z
transaction,e09332dc-d632-4028-b177-9471c1ae1445,posted,Music Streaming Subscription,-3459.37,fe0800db-2eb9-4804-b6cc-f01b860eb14c,9136.84,debit,cash-withdrawal,AU00000,2023-08-04T17:20:51Z
transaction,877a7b9a-c41d-4117-83ef-892b2e22ea39,posted,Non Hooli ATM Withdrawal Fee,-975.75,571aa83c-df6d-410f-806b-2010d9a00ca0,8161.09,debit,cash-withdrawal,AU00000,2023-08-17T16:32:04Z
transaction,878ef327-c73a-4671-aea1-c92f1c204b55,posted,Payroll WFRMS 15439393,10252.5,84fac23c-c577-436f-9063-687f594d5880,18413.59,credit,transfer,AU00000,2023-05-20T06:42:34Z
transaction,e234604f-7402-4691-9f70-1c7f86ffff30,posted,AGL RETAIL ENERGY LTD (GAS),-1752.27,5c916a80-226a-4e14-b6fa-fe757883046a,16661.32,debit,cash-withdrawal,AU00000,2024-01-09T22:45:33Z
transaction,7ba218b2-5854-4075-a8e2-8e037f62d8c2,posted,Music Streaming Subscription,-2531.99,b8267094-2041-4e57-a24b-02c552d621d9,14129.33,debit,bank-fee,AU00000,2024-01-30T11:12:48Z
transaction,3b607a71-9ccd-42d1-87fa-e3c00c4e342b,posted,Hair Salon Appointment,-339.61,7c1e521f-9842-4302-94f6-6f8b0d5809be,13789.72,debit,bank-fee,AU00000,2023-05-17T20:01:40Z
transaction,fa61542e-e9c0-4076-a911-76b63e4cd5f1,posted,AGL RETAIL ENERGY LTD (GAS),-3851.1,703fbae1-03e3-49c9-ab76-883f9c2747ca,9938.62,debit,bank-fee,AU00000,2023-08-25T06:51:42Z
transaction,fd5d2abb-a887-42b8-a7c7-382b4a987dcd,posted,Online Gaming Purchase,-4523.83,968d2468-fe95-418d-a3a5-bc843e555203,5414.79,debit,cash-withdrawal,AU00000,2024-04-18T01:15:33Z
transaction,11eb1233-bd29-4929-a0ad-df1204035f01,posted,Netflix Subscription,-4531.41,8bc8cd1a-8884-4cc0-a530-5421959ee09a,883.38,debit,cash-withdrawal,AU00000,2023-06-18T22:11:22Z
transaction,4f5d3591-9a77-4758-9468-2b027b641592,posted,Clothing Store Purchase,-3651.66,a2b7c1ed-ff91-4b16-b1bc-1da57d4c4fca,-2768.28,debit,cash-withdrawal,AU00000,2023-08-30T00:51:32Z
transaction,095947be-0344-4b9d-a1c1-846b11b197bb,posted,TFR Acc14000 TO 12389,-466.59,70996f7d-5e2d-4486-9c45-7225471dc377,7503.19,debit,payment,AU00000,2023-10-06T08:55:52Z
transaction,6faabe3c-2e50-41fe-8137-b9511ee7219c,posted,Music Streaming Subscription,-311.95,c9b816a6-7492-4410-9f32-2cb5bc0a3a36,7191.24,debit,bank-fee,AU00000,2023-07-02T01:05:07Z
transaction,ee89519a-6dfc-44dc-83fd-db7501b79a93,posted,Public Transport Fare,-4753.19,2d4a5938-04c6-4499-8a37-821f0d4ab3c7,2438.05,debit,bank-fee,AU00000,2023-06-21T17:57:21Z
transaction,d7a38364-7714-4802-849a-6bc4fc627e8e,posted,Transfer Platnm Homeloan 346454,-886.67,9b5ab553-6112-45ff-8139-13bf67e5ec42,1551.38,debit,cash-withdrawal,AU00000,2024-03-19T22:38:53Z
transaction,4e7a0aa1-ef0f-48ed-86a4-759d2b47d792,posted,Payroll WFRMS 15439393,10977.85,0fa45ec3-1f26-437f-9f21-f9e48369cbdd,12529.23,credit,transfer,AU00000,2024-03-01T17:43:42Z
transaction,026508bb-790b-49d6-bc3c-61a069c5dc36,posted,Music Streaming Subscription,-1206.09,bb8b4c86-0dcf-4568-9736-050c016511a9,11323.14,debit,payment,AU00000,2024-04-17T21:18:33Z
transaction,5355d6f2-d013-47f3-ad8e-48d36db33a96,posted,Uber Ride,-2646.8,8f246464-cb98-48f6-9746-af2f171bcc1a,8676.34,debit,cash-withdrawal,AU00000,2023-11-16T09:01:58Z
transaction,e6349ac5-474b-4772-97d2-a513e8fffc1e,posted,Uber Ride,-3793.56,670051ac-4424-4ef6-b72d-9236b5cf4559,4882.78,debit,bank-fee,AU00000,2023-05-23T08:23:25Z
transaction,0528ac2c-0d86-4b57-b268-424c2457dba6,posted,Transfer Platnm Homeloan 346454,-3560.71,a30af022-5b71-4e36-ab21-2e5ad75d03bc,1322.07,debit,cash-withdrawal,AU00000,2023-09-02T23:29:29Z
transaction,0546dee5-c215-4143-9ade-671f84ee3d56,posted,Uber Ride,-4520.11,ff927473-8ee4-4401-b7a9-6d6d03684d9c,-3198.04,debit,cash-withdrawal,AU00000,2024-05-08T06:40:41Z
transaction,988c2899-4e4b-4125-825a-39580ff49572,posted,Gym Membership Fee,-163.5,f8cbad21-1f65-407d-836e-e98b9baa1acd,6466.81,debit,cash-withdrawal,AU00000,2023-10-26T02:59:12Z
transaction,565a5a45-d7fc-4246-af89-c0e5cb1b4dab,posted,Public Transport Fare,-4885.97,d7a10295-275d-4895-b5d4-a42d5c8f9825,1580.84,debit,bank-fee,AU00000,2024-03-03T20:53:02Z
transaction,b6300b5b-ea70-43ab-a41c-aa326df97fb1,posted,Non Hooli ATM Withdrawal Fee,-2997.04,cdc468b2-57db-4ff5-9048-a92192a29723,-1416.2,debit,payment,AU00000,2024-04-14T17:18:05Z
transaction,7164582e-a774-42d8-89af-f5f8adcad4a9,posted,Gym Membership Fee,-3467.46,abc2c3d0-89d0-4706-8ddb-eeed745bb3d3,-4883.66,debit,payment,AU00000,2023-12-08T20:32:04Z
transaction,b2da4b5e-dd03-4dfa-9d56-15015cdc6b11,posted,Home Improvement Store Purchase,-1146.1,e195fa82-3943-4708-94f7-08b6af4d9f13,-6029.76,debit,cash-withdrawal,AU00000,2023-09-19T16:45:00Z
transaction,e00621c2-949e-4a57-a1b3-30a909cc0302,posted,CTRLINK CARERS Ref: 998R6789201610974V,-698.41,6c99a4f8-db51-48f8-945e-7077ea33a750,-6728.17,debit,cash-withdrawal,AU00000,2023-06-07T16:02:06Z
transaction,019c1aee-b19b-4e76-a0f6-a38f5f809a4f,posted,Mobile Phone Bill Payment,-3257.53,89d4938e-fc34-4823-93e7-0ae657eb0005,-9985.7,debit,payment,AU00000,2023-10-13T04:37:25Z
transaction,dd0932a8-fe74-477c-950b-175c9c830d50,posted,Uber Ride,-1899.7,f90f443f-e4a7-4818-adf7-e1c2aa5681e4,-11885.4,debit,cash-withdrawal,AU00000,2023-11-09T02:33:09Z
transaction,5406c48f-9a28-47b8-af7c-70ff9e5f8a16,posted,Electricity Bill Payment,-3380.46,3f0ad639-36e8-4b4a-9e7a-6ff0d559dd9a,-15265.86,debit,bank-fee,AU00000,2023-07-05T17:17:39Z
transaction,531a0a64-b694-494f-a84e-bd514f0eaf93,posted,Hair Salon Appointment,-2773.95,6b7acd96-1fa5-48f5-b1ec-4c60109152d5,-18039.81,debit,payment,AU00000,2023-11-28T14:46:44Z
transaction,8b5a328a-122c-400e-a45c-73a449c8210e,posted,Wdl ATM WESTPAC IGA BALGOWLAH BALGOWL AU,-1634.74,78080e08-c0ec-4af7-ba06-68a4008cfe98,5792.15,debit,cash-withdrawal,AU00000,2023-08-30T07:35:16Z
transaction,b5f4d8e8-16f2-4b1c-8624-86cc8591f5dd,posted,Gasoline Purchase,-2389.36,786796b8-3ffa-4f8e-8501-28bd07eff598,3402.79,debit,payment,AU00000,2024-03-24T20:18:21Z
transaction,cddf3a24-c71a-45b7-b5b5-d6012e0d83b1,posted,Coffee Shop Purchase,-783.31,edc2f8f8-8b20-44e9-9924-39192f3ea393,2619.48,debit,bank-fee,AU00000,2024-03-21T15:52:34Z
transaction,b6cb40a4-47be-4648-aef2-8bb95a8e0fad,posted,Manly Maths Tutor Wages,-2326.55,49b03b5a-f83b-4201-a683-0a094ab0b693,292.93,debit,payment,AU00000,2023-09-02T15:42:59Z
transaction,0c39c39f-6042-4d57-9a1c-7c8314471ae7,posted,Non Hooli ATM Withdrawal Fee,-1280.62,f21b0e18-ec13-4277-a73a-0a1e75747af4,-987.69,debit,cash-withdrawal,AU00000,2024-02-25T08:40:22Z
transaction,6e577f0b-4674-4c21-aa8d-c6ba1f7ae688,posted,Travel Agency Booking,-265.18,e746449c-8b84-40d7-b13a-a9a75b53f777,-1252.87,debit,payment,AU00000,2023-12-23T20:26:11Z
transaction,b23e3dc1-92fc-4c54-998c-5dc38dd753a1,posted,Online Gaming Purchase,-2979.48,30b9c899-78b1-4e4c-aaa2-f2a3a4d81348,-4232.35,debit,payment,AU00000,2023-06-16T10:10:18Z
transaction,075bdd04-276e-4aa8-b449-20ee732020ab,posted,Transfer Platnm Homeloan 346454,-235.65,a1f3d76e-41d6-4dfd-9eba-41ab3055f56f,-4468.0,debit,cash-withdrawal,AU00000,2024-02-05T09:34:48Z
transaction,1a514005-8338-4c21-8166-f47b02a58025,posted,Amazon Online Shopping,-2420.52,c2643d02-91e4-4fa6-b87e-27c458bf9a66,-6888.52,debit,cash-withdrawal,AU00000,2023-11-14T17:59:50Z
transaction,a9820773-4b0d-41c4-8345-5bd5defb0e63,posted,Amazon Online Shopping,-32.09,f59c4dca-6cb8-4ae1-940f-bff42691b1f8,-6920.61,debit,cash-withdrawal,AU00000,2024-03-30T03:15:09Z
transaction,ca3c91c7-325c-48ca-96af-fd6aea5c8d7d,posted,Public Transport Fare,-531.91,555a3971-fca0-42fc-bcf8-789561a14b10,17080.42,debit,cash-withdrawal,AU00000,2023-09-01T14:50:09Z
transaction,6ceb70f5-879c-495d-81c5-7332bc0a3462,posted,Coffee Shop Purchase,-785.45,1da8c51f-8fff-433f-af11-af44dd05b957,16294.97,debit,cash-withdrawal,AU00000,2024-04-03T16:06:43Z
transaction,ed4ddf39-2732-434b-8a7c-9fe5f1414695,posted,TRANSFER TO JOANNA SMITH CAMPING,-406.73,34989f1f-a035-41f5-8ed0-f18f6d767b28,15888.24,debit,cash-withdrawal,AU00000,2024-02-22T06:53:19Z
transaction,1d9ff9c2-99ce-4b9f-8331-0287735447d2,posted,Travel Agency Booking,-3275.27,eef17024-19c7-4fe7-b1b8-1dcb0532142c,12612.97,debit,payment,AU00000,2023-11-29T15:15:45Z
transaction,de3ac2f2-4c05-4c8c-81bd-1daf8ead5051,posted,Hair Salon Appointment,-543.59,a44b43b8-f3a6-4012-afe6-012fd2772110,12069.38,debit,payment,AU00000,2024-03-07T14:55:57Z
transaction,b408735b-3e15-46de-a85e-5296bc40db58,posted,Manly Maths Tutor Wages,-1171.18,f7ed4c00-c034-42bf-ad58-3ae75981120d,10898.2,debit,payment,AU00000,2023-09-25T23:13:43Z
transaction,5f04f7cf-283d-4336-a4ce-6735912c26ea,posted,Amazon Online Shopping,-3632.13,4b5d1fb7-efb3-4235-aa2c-ad0de653e6d3,7266.07,debit,payment,AU00000,2023-09-25T05:10:48Z
transaction,2969055a-47a6-4247-b746-83abbe5754d7,posted,Pharmacy Purchase,-438.22,14a2d16f-df0b-4aca-822d-4b32664b0e7f,6827.85,debit,cash-withdrawal,AU00000,2023-06-22T17:55:42Z
transaction,a8232d2a-f3e8-416c-938f-642461ce3fa6,posted,Amazon Online Shopping,-580.69,9ba73373-020b-4bfe-8187-9c9745a063a6,6247.16,debit,payment,AU00000,2024-02-23T19:20:28Z
transaction,5d0cf223-15ef-448f-b166-bed8fab1b171,posted,Movie Ticket Purchase,-1408.08,4df4b6f5-7563-44d0-bd54-e68f8cdfc4d9,4839.08,debit,payment,AU00000,2024-03-29T11:54:29Z
transaction,b5d7f3ff-0802-47b5-af4d-74db4aec1566,posted,Amazon Online Shopping,-3307.16,d3062baf-dc42-4c13-ba05-eb10ba7e0e4a,12360.86,debit,payment,AU00000,2024-03-29T16:11:04Z
transaction,54463116-a152-42be-a286-c7e06ca89315,posted,Uber Ride,-1292.11,64aa265b-e51f-4020-93fb-50919ae650b1,11068.75,debit,bank-fee,AU00000,2023-12-12T18:51:32Z
transaction,d1a3fa66-82ac-4504-9fe2-6ea06e096c9f,posted,Car Maintenance Expense,-1622.88,bd6b72b9-330d-41c2-b6c5-f8b75a9ab742,9445.87,debit,bank-fee,AU00000,2024-03-05T11:50:45Z
transaction,19f2800a-65b5-4a85-9404-b90755e4bb1c,posted,Wdl ATM WESTPAC IGA BALGOWLAH BALGOWL AU,-2414.33,42daf984-f905-4989-8f08-f208e6bcbbf7,7031.54,debit,payment,AU00000,2023-10-20T16:51:08Z
transaction,9dd2ed62-a36e-4cea-85e7-15a451cd911a,posted,Gasoline Purchase,-4550.03,4cce428d-3f23-4a77-a7c1-9796f595cf98,2481.51,debit,cash-withdrawal,AU00000,2023-07-05T03:54:38Z
transaction,3d791c11-a54e-44db-abd7-16cb97fd45ee,posted,Wdl ATM WESTPAC IGA BALGOWLAH BALGOWL AU,-3331.5,db4938a7-4d32-40cb-89db-ee8b52ee916d,-849.99,debit,bank-fee,AU00000,2023-06-09T03:21:11Z
transaction,4b5112f7-2234-469a-b887-694b9c519b88,posted,TFR Acc14000 TO 12389,-3415.62,874aff0b-143d-4f8b-9e7e-a43858069088,-4265.61,debit,bank-fee,AU00000,2023-06-07T17:31:52Z
transaction,a21e68c3-103a-487b-9892-ad32e6fbf60f,posted,CTRLINK CARERS Ref: 998R6789201610974V,-1488.96,79b6d6a4-acff-4b56-80d9-ef9014deafa3,-5754.57,debit,payment,AU00000,2023-06-25T05:22:23Z
transaction,fee80104-7a48-4c1b-b759-b6296561a232,posted,Wdl ATM WESTPAC IGA BALGOWLAH BALGOWL AU,-4241.63,53c111f1-ad38-4815-b428-4ac8167ddf1d,-9996.2,debit,bank-fee,AU00000,2023-05-13T00:23:28Z
transaction,f16adb50-3f0a-4d76-87a5-5d5df9d73688,posted,Car Maintenance Expense,-1092.14,71d02702-8a10-4602-83bc-ad5e88fd8d0a,-11088.34,debit,cash-withdrawal,AU00000,2024-01-07T02:14:08Z
transaction,dbbc76ff-081f-4295-b177-dd36a471fd15,posted,Clothing Store Purchase,-1535.18,838aa9ae-a281-4a74-95b5-b9729b3ca859,17436.54,debit,cash-withdrawal,AU00000,2023-10-08T22:09:07Z
transaction,29548bad-d283-4b3a-a800-9e4824793bed,posted,Movie Ticket Purchase,-3658.54,9f49b938-065a-424b-8735-871fea2a19f5,13778.0,debit,payment,AU00000,2023-08-19T05:20:03Z
transaction,ebb93962-f36a-480c-a86f-8d9cb24a03dc,posted,Hair Salon Appointment,-3645.84,3294ad05-2f53-4eaa-b5b3-5ad289ad1826,10132.16,debit,payment,AU00000,2023-10-04T07:43:47Z
transaction,7dc1c82f-cce9-4221-95d5-059a71ae75a4,posted,Wdl ATM WESTPAC IGA BALGOWLAH BALGOWL AU,-2050.64,cf113344-24bb-4d9e-8332-d97f9c7114c0,8081.52,debit,cash-withdrawal,AU00000,2023-11-18T16:12:32Z
transaction,cb6922d4-06ab-4b06-9f5b-71f84b517019,posted,Coffee Shop Purchase,-855.91,4954c491-19db-4d68-b270-3adcdc09aa5d,7225.61,debit,payment,AU00000,2024-03-07T05:36:32Z
transaction,2d99f7eb-1829-413b-9441-fbfa0ad47b86,posted,Manly Maths Tutor Wages,-1165.34,a34f0119-2aac-44b6-8e4b-4041f6ee707b,6060.27,debit,bank-fee,AU00000,2024-04-17T05:03:43Z
transaction,19ccb7db-24f3-4b20-ab66-701d43ed2e1a,posted,Travel Agency Booking,-3024.34,bc811a5c-49c5-4873-9ced-bf1a2f3448b7,3035.93,debit,payment,AU00000,2023-05-26T17:36:39Z
transaction,05a453cf-ffff-40be-837e-adbd4fb6d2af,posted,Home Improvement Store Purchase,-2456.49,dcfb9f1f-80eb-4aed-aa11-b87975daf397,579.44,debit,bank-fee,AU00000,2023-12-02T17:44:08Z
transaction,48ee9530-ecea-40f6-9a05-d824f07f62d2,posted,Clothing Store Purchase,-578.88,f0e8b4d5-e313-4377-b1a8-013d722eaae2,0.56,debit,payment,AU00000,2023-11-11T16:19:55Z
transaction,4bb525b7-185d-4cee-aef6-762847b755ff,posted,CTRLINK CARERS Ref: 998R6789201610974V,-4933.64,78c3bd64-e734-4594-85e7-5b9abdcb2a22,-4933.08,debit,bank-fee,AU00000,2023-10-10T18:38:37Z
transaction,ed107397-1193-4aa5-9c12-2a4ff5872abc,posted,TRANSFER TO JOANNA SMITH CAMPING,-3702.75,928e89a7-3ccf-45fe-9518-0ff96939ae7a,13065.56,debit,payment,AU00000,2023-09-09T13:10:43Z
transaction,9708fb07-aea7-4012-a3ac-635576dab2da,posted,Amazon Online Shopping,-1395.07,b8bda199-bc6d-4a24-84ab-1e46ae8dfd1a,11670.49,debit,bank-fee,AU00000,2023-12-22T17:09:52Z
transaction,8e5d4430-6268-4bbd-817e-f5817a2d15ad,posted,Pharmacy Purchase,-4910.71,a2683a94-b2fd-4972-9ec2-fb8a119d5ef7,6759.78,debit,payment,AU00000,2024-04-04T19:04:19Z
transaction,42c3f2c0-3440-43cb-a7a3-a9f5b5c37644,posted,Restaurant Dinner,-4673.9,f35ef7af-cf81-4866-95ab-cce8edf6ca19,2085.88,debit,bank-fee,AU00000,2023-10-17T14:25:43Z
transaction,788c9bb6-bb65-4153-a0fc-2cc12ea8e0d1,posted,Car Maintenance Expense,-2443.82,7cd56cdc-45f8-438d-9a3c-b7e34569c492,-357.94,debit,bank-fee,AU00000,2024-04-13T00:22:02Z
transaction,db027920-1dfe-44a5-a44c-f589b84421e9,posted,Amazon Online Shopping,-3833.25,88c65856-7b44-4eeb-bbbc-ebd8c9ee0cce,-4191.19,debit,cash-withdrawal,AU00000,2023-11-16T19:44:24Z
transaction,63008c7f-76ef-47ed-a608-4f05b12c6c41,posted,Manly Maths Tutor Wages,-3780.36,6530d1b3-fe11-45b5-a4ce-467278e715e3,-7971.55,debit,bank-fee,AU00000,2023-12-10T21:47:30Z
transaction,a3f484c1-bd8e-422c-bfb5-6dbc6275df94,posted,TRANSFER TO JOANNA SMITH CAMPING,-3316.98,9ac2902d-51b8-45da-8a1b-c1ee2fff1a50,-11288.53,debit,cash-withdrawal,AU00000,2024-02-13T19:03:01Z
transaction,f24bda67-c70b-4339-a97e-fa4a30f9ca4f,posted,Music Streaming Subscription,-546.63,f0a18d8e-d89b-41f2-aa59-921e3c1e63b5,-11835.16,debit,bank-fee,AU00000,2023-08-14T09:58:38Z
transaction,64d86b45-c2c7-4700-a202-f45c6aaf9a69,posted,Car Maintenance Expense,-4249.69,d0da6663-f793-4445-8c2d-43df3975eb69,-16084.85,debit,cash-withdrawal,AU00000,2023-12-15T22:49:43Z
transaction,0dc98b04-0b6f-4a29-aeaf-98de5354a016,posted,Bookstore Purchase,-4657.41,db211b77-ad01-466a-947b-87142efb1620,2651.17,debit,payment,AU00000,2023-09-13T05:26:00Z
transaction,a639e5ea-61f3-4284-aeb0-afba7d4c12fe,posted,Bookstore Purchase,-1325.38,514e02d3-aafb-405f-838b-cb005e4ded2b,1325.79,debit,cash-withdrawal,AU00000,2023-12-14T08:04:44Z
transaction,222f6fe7-97fa-4b28-b8e2-32bfa2cb913e,posted,Hair Salon Appointment,-295.39,7a8eec33-2b59-47a5-a3f4-dbd48240ccb3,1030.4,debit,cash-withdrawal,AU00000,2023-05-31T16:22:55Z
transaction,868c1736-eb40-41e9-b4da-6d0a01c9aad5,posted,Travel Agency Booking,-1443.8,d9599eb4-5471-4c51-a50f-b21be6f32b26,-413.4,debit,payment,AU00000,2024-02-10T22:46:18Z
transaction,83bd2730-6374-4f2d-be88-dbdb25da7f3d,posted,Gasoline Purchase,-3435.68,fd2cfe6d-001d-44a2-8819-a5ebc8a47dab,-3849.08,debit,cash-withdrawal,AU00000,2024-01-08T13:20:54Z
transaction,86fe7553-cb07-410c-ac2a-9a446692824d,posted,Public Transport Fare,-2377.62,14a04785-37e3-4b93-bd5f-f7f72ef413e9,-6226.7,debit,cash-withdrawal,AU00000,2024-03-20T07:36:22Z
transaction,5e0c3edb-3767-490c-bd74-06d8ffd6d465,posted,Amazon Online Shopping,-2281.6,7d2adccd-c850-4347-a471-4cd44fafb711,-8508.3,debit,bank-fee,AU00000,2023-11-11T16:52:52Z
transaction,2093cb56-814f-4e9a-a795-612277aa9c8d,posted,Transfer Platnm Homeloan 346454,-3863.61,06f8004c-1df8-4d5a-90bc-87c5d79aecee,-12371.91,debit,payment,AU00000,2024-04-15T01:16:50Z
transaction,ffa45046-4cd9-46d7-bc9c-5d31fd6031e2,posted,Online Gaming Purchase,-3110.37,843eeb83-e35d-45d2-bd9e-6132cbb269fb,-15482.28,debit,cash-withdrawal,AU00000,2024-02-21T18:46:10Z
transaction,1d22d0d2-c817-4fac-917f-7e70035b2416,posted,Hair Salon Appointment,-295.25,aeffdd7a-a70d-4502-bb8e-28f00189c66a,-15777.53,debit,payment,AU00000,2024-02-12T19:37:58Z
transaction,2e70eb75-e60e-4a6a-9ed2-6078ba46ce66,posted,TRANSFER TO JOANNA SMITH CAMPING,-4032.33,4be8c3c0-551f-4d62-a15c-5115fd319b7b,13107.95,debit,payment,AU00000,2023-10-31T22:17:45Z
transaction,86a65828-39ac-4780-aa6f-18c6bfb8f91c,posted,Amazon Online Shopping,-4236.15,7f2453c7-98a5-457d-86e6-2c7c8276da38,8871.8,debit,payment,AU00000,2023-12-27T02:48:51Z
transaction,cbde6fcb-6b53-45c1-94e3-52e129ec9471,posted,Manly Maths Tutor Wages,-4376.99,f4c7a7da-e5c4-4430-9213-cecea92e5751,4494.81,debit,cash-withdrawal,AU00000,2023-09-20T01:31:16Z
transaction,d8fe17d2-81c8-4291-8368-03c9d9949cc0,posted,Payroll WFRMS 15439393,10187.07,e354b32d-352f-4d6f-ab53-4e5c94a02b5c,14681.88,credit,transfer,AU00000,2023-08-22T23:07:36Z
transaction,be2987c8-2bb0-4996-a2d2-3a927bd2d16b,posted,Pharmacy Purchase,-3647.79,51b72a16-3833-4408-9e55-c25a7209ce74,11034.09,debit,cash-withdrawal,AU00000,2023-11-23T14:20:35Z
transaction,78ad7462-58b8-40eb-90dd-8b43fa3c4e87,posted,Wdl ATM WESTPAC IGA BALGOWLAH BALGOWL AU,-805.74,460cb00b-15d7-4b16-b8ec-bb5e6aa88aa1,10228.35,debit,cash-withdrawal,AU00000,2024-04-18T01:32:27Z
transaction,5742cccb-702a-498b-8efe-0d5f62b980c5,posted,CTRLINK CARERS Ref: 998R6789201610974V,-2926.0,923c341d-2183-4717-b552-9cbc830d2ac2,7302.35,debit,payment,AU00000,2023-10-07T00:24:23Z
transaction,7551c474-b49d-47dc-8a84-59493789f248,posted,Home Improvement Store Purchase,-902.81,7aaa2242-a9c6-4fb1-9056-72e2836f1b68,6399.54,debit,cash-withdrawal,AU00000,2023-09-27T20:46:33Z
transaction,b5a0a818-22f9-43c3-8bab-aef8a4ca793e,posted,Payroll WFRMS 15439393,11939.8,5b5b45df-7009-428b-b0e1-432086358304,18339.34,credit,transfer,AU00000,2023-12-02T07:32:45Z
transaction,98931cf4-0eb6-45af-bb85-f11216637884,posted,CTRLINK CARERS Ref: 998R6789201610974V,-2760.88,12f06f79-bb65-449d-8425-44fe47fca810,15578.46,debit,payment,AU00000,2023-07-28T17:47:33Z
transaction,fcb8267d-9c4c-4409-a2f1-fe442a4020fd,posted,Non Hooli ATM Withdrawal Fee,-84.37,e3118000-cb9d-40e3-a34c-0a96bdfc657f,13648.58,debit,cash-withdrawal,AU00000,2024-02-12T21:09:28Z
transaction,d8448e1a-729a-44b8-988d-6a65b04d1b51,posted,Gasoline Purchase,-3541.54,540693b9-82cf-4351-85da-2b46a84fabb1,10107.04,debit,payment,AU00000,2024-02-20T07:00:06Z
transaction,19fe1beb-ee7f-4f31-be29-189aebe07b3a,posted,Wdl ATM WESTPAC IGA BALGOWLAH BALGOWL AU,-3187.13,7773df50-fd1b-4da7-82d6-715eec98fd3e,6919.91,debit,payment,AU00000,2024-01-04T23:06:11Z
transaction,1d389d19-1e71-4871-a0ed-6f3e69777c7f,posted,Amazon Online Shopping,-3688.73,a63ffc78-c781-40c2-9221-a743ca05c33d,3231.18,debit,bank-fee,AU00000,2023-05-17T12:31:33Z
transaction,4b3bc775-4189-493e-b568-929e7498dd23,posted,Public Transport Fare,-56.54,efabb11b-1f9d-4b12-a376-a0c53bb8ac8f,3174.64,debit,cash-withdrawal,AU00000,2023-08-29T09:26:30Z
transaction,2db39fda-74ec-4e91-858d-ea993f82dbbf,posted,Car Maintenance Expense,-1064.34,b6e02e02-fa7b-4f66-a481-1a999c2d6cd6,2110.3,debit,bank-fee,AU00000,2023-05-22T21:47:22Z
transaction,de80ac93-4b78-4316-836d-58de9ec1c55c,posted,Public Transport Fare,-275.07,1c4ff956-1d60-4cdb-be23-39a082b50969,1835.23,debit,bank-fee,AU00000,2023-10-02T12:39:30Z
transaction,da894d12-c75c-4d0e-8b1a-793d4c48d93f,posted,Home Improvement Store Purchase,-1211.45,73257235-5dfe-42d6-ab80-7f9a7c1cc51a,623.78,debit,cash-withdrawal,AU00000,2023-08-18T14:54:13Z
transaction,abb5526e-3d04-46ed-88d0-6c2f0c3b3024,posted,Hair Salon Appointment,-4843.98,db1a337c-3a66-4d48-9134-7fe7da537459,-4220.2,debit,cash-withdrawal,AU00000,2023-07-02T14:08:27Z
transaction,f6329325-f25a-4789-8a66-841647fda35e,posted,TFR Acc14000 TO 12389,-1726.79,e0b7cd90-83ef-4223-add0-c4c1d1c45790,-5946.99,debit,cash-withdrawal,AU00000,2023-11-17T15:16:23Z
transaction,61b4a489-7303-4235-9601-d7e129a1be5a,posted,Car Maintenance Expense,-1325.7,e5608339-6e86-4aa1-871f-2af95d6446ad,16584.6,debit,bank-fee,AU00000,2023-08-10T12:43:50Z
transaction,cc2805a2-d33b-4cbb-845f-a413e500b6a0,posted,Mobile Phone Bill Payment,-4337.64,aa0e3b97-487a-4d31-b44f-7898bfe75390,12246.96,debit,payment,AU00000,2024-01-10T00:12:49Z
transaction,0eb994ba-a057-4f82-9eaa-05f40d160657,posted,Coffee Shop Purchase,-1203.41,11443b12-191b-4fad-b147-7ab3332f6169,11043.55,debit,bank-fee,AU00000,2023-06-16T13:01:28Z
transaction,d07fd22d-0ced-4304-99af-89bad08f2846,posted,TRANSFER TO JOANNA SMITH CAMPING,-3152.11,efaf9a2f-4757-401d-859e-13bdd18a60fc,7891.44,debit,bank-fee,AU00000,2023-07-08T18:02:36Z
transaction,a35a8b55-1718-4413-975b-554fff948e5a,posted,Coffee Shop Purchase,-4857.98,30d0a730-c268-48a5-8c02-2ff445b88ed1,3033.46,debit,payment,AU00000,2023-12-26T19:37:39Z
transaction,29b8451d-fac2-4304-82d1-678f233a4855,posted,Mobile Phone Bill Payment,-270.4,59509c67-d02c-4a71-97c0-5de90c710776,2763.06,debit,cash-withdrawal,AU00000,2023-11-18T06:20:29Z
transaction,48b1e80e-297f-4b1a-98f6-c9fa66590019,posted,TRANSFER TO JOANNA SMITH CAMPING,-1679.96,994631d0-bf55-43f6-882b-b1174747796e,1083.1,debit,cash-withdrawal,AU00000,2023-08-28T17:25:00Z
transaction,b36a6dd7-0c3f-4b50-ac7d-0007562bf9c6,posted,Non Hooli ATM Withdrawal Fee,-3881.37,14da2432-4100-4863-855f-52fbb41920dc,-2798.27,debit,cash-withdrawal,AU00000,2024-05-10T13:02:27Z
transaction,0777d76c-1bf8-4f97-808d-6c691aadf10e,posted,Netflix Subscription,-337.45,867da875-1a1c-4c71-b6c9-cb70f487fc1b,-3135.72,debit,bank-fee,AU00000,2023-07-28T19:58:01Z
transaction,fe03db4f-a3c0-4dcc-a1be-46845b012810,posted,CTRLINK CARERS Ref: 998R6789201610974V,-811.71,bcd65504-bf97-487b-bd69-f356661a6e90,-3947.43,debit,bank-fee,AU00000,2023-07-25T21:46:21Z
transaction,750ad4e7-ac68-45d7-85ce-308d8f795cfb,posted,Mobile Phone Bill Payment,-828.4,40a836b5-0a1c-41d6-be3e-afbb41f19f25,14146.98,debit,bank-fee,AU00000,2023-06-19T09:51:39Z
transaction,5b72347d-a92f-44a7-955c-0c1cededb659,posted,CTRLINK CARERS Ref: 998R6789201610974V,-4708.49,48b9a61b-de24-418d-9aaa-4b422858ebaf,9438.49,debit,cash-withdrawal,AU00000,2024-04-17T10:53:07Z
transaction,cc12c07a-56be-4e38-9072-50062185d5ed,posted,Uber Ride,-141.43,28e9238a-726e-4c9a-b21d-cc84725cb2f6,9297.06,debit,payment,AU00000,2024-01-20T00:30:52Z
transaction,f08f3b88-3a21-4ffb-bc6d-37419394ab04,posted,Home Improvement Store Purchase,-1363.42,0bdfec13-3fa8-4932-a52c-8cd6cdef7111,7933.64,debit,cash-withdrawal,AU00000,2024-01-15T06:13:08Z
transaction,339dbbc9-6f39-430e-a0f1-9840c1ff5f8d,posted,Public Transport Fare,-4595.71,290080d7-e6c1-4047-80cd-84f122ce8891,3337.93,debit,cash-withdrawal,AU00000,2023-08-10T22:32:42Z
transaction,565316db-a711-4979-95b7-d4067bc9593b,posted,AGL RETAIL ENERGY LTD (GAS),-2371.02,74a278fb-bf0b-4078-8703-4247b76396cc,966.91,debit,cash-withdrawal,AU00000,2023-09-04T10:02:30Z
transaction,41db7bd5-aae8-47c4-88d2-7cd25993ba7a,posted,Music Streaming Subscription,-4094.2,7ced79b8-62f4-429c-aeb2-aeb9f6ece499,-3127.29,debit,cash-withdrawal,AU00000,2023-06-01T13:04:34Z
transaction,d9cd9f21-11cd-4b7a-bd6a-e3dbb3cccfdb,posted,Gym Membership Fee,-3347.05,4f4c7f17-469f-4b1b-b38c-79dacc574962,-6474.34,debit,payment,AU00000,2024-04-02T07:26:33Z
transaction,6f8a8e07-4902-4576-ac61-12f870390789,posted,AGL RETAIL ENERGY LTD (GAS),-3032.24,c77fd3d6-b4b3-4577-80e8-ddb976991b6a,-9506.58,debit,payment,AU00000,2023-05-26T23:49:01Z
transaction,dbf51711-68ee-461a-9911-7292af62b3e9,posted,Clothing Store Purchase,-3698.49,60c355b4-2507-4c1f-82ba-d840bffce6ea,-13205.07,debit,cash-withdrawal,AU00000,2024-05-10T17:50:59Z
transaction,7026efd8-67b7-45f6-b2b4-ed1ef770a82c,posted,Bookstore Purchase,-4485.29,0cc57142-ea40-469a-b89c-ba7e72f46aa5,7215.31,debit,bank-fee,AU00000,2023-07-21T21:48:28Z
transaction,0bb033ba-a2e3-44c7-b1f4-f984157c925d,posted,Restaurant Dinner,-271.19,34e25e10-772b-4cda-a561-ae815df4da48,6944.12,debit,bank-fee,AU00000,2023-07-15T20:56:08Z
transaction,e436da70-f5ae-4ed7-b0d7-29bd3fcde91d,posted,Wdl ATM WESTPAC IGA BALGOWLAH BALGOWL AU,-2631.03,03316c37-f6ac-4b4c-8452-47c20fcd4610,4313.09,debit,cash-withdrawal,AU00000,2023-06-19T21:30:59Z
transaction,ef681188-d5c5-4d78-bb45-8097c9fe9ad7,posted,Wdl ATM WESTPAC IGA BALGOWLAH BALGOWL AU,-4516.13,205fcead-5062-481c-a9ae-c2ae7fd10ccc,-203.04,debit,bank-fee,AU00000,2023-06-27T11:54:26Z
transaction,31dbd6f3-44d6-4531-9c8b-de44571184f7,posted,Clothing Store Purchase,-2055.58,b8ab7f70-1715-480a-9773-9e130cba48b0,-2258.62,debit,cash-withdrawal,AU00000,2024-03-29T11:14:56Z
transaction,4fc327e2-73b5-4976-a42a-fcbec42646ea,posted,Wdl ATM WESTPAC IGA BALGOWLAH BALGOWL AU,-495.38,0c33cd44-11a0-4567-88a9-c81e093c5df8,-2754.0,debit,payment,AU00000,2024-04-22T13:02:02Z
transaction,0c8e162d-1d6c-4823-891c-86bf19b8e61a,posted,Netflix Subscription,-129.05,f34ac791-86f3-450b-b523-f5aa42da1f99,-2883.05,debit,bank-fee,AU00000,2023-05-28T19:40:09Z
transaction,8d8a8f53-71bf-4f5a-bf73-45e8d53c3643,posted,Uber Ride,-2702.64,3d8c3a84-f4cb-4ca4-ae77-dfca02555231,-5585.69,debit,cash-withdrawal,AU00000,2023-05-18T12:09:36Z
transaction,660e951c-fd08-4c0c-ac5b-321d6dfcdd7f,posted,Travel Agency Booking,-3341.03,4c7bfe43-8204-45c6-86d7-4a76986aa461,-8926.72,debit,payment,AU00000,2023-06-07T09:20:45Z
transaction,1750e297-c938-4f86-8c6f-4022677d87a1,posted,Gym Membership Fee,-796.69,163bbf70-bf6c-4390-9b6e-8d5fe0ea72c0,-9723.41,debit,bank-fee,AU00000,2023-10-25T06:12:04Z
transaction,06357185-5c4f-463e-b01c-efadfe8b1514,posted,AGL RETAIL ENERGY LTD (GAS),-1825.38,a00be0ff-9d89-4e45-940d-bad75134f16a,6902.64,debit,bank-fee,AU00000,2024-04-08T17:20:25Z
transaction,b19e22d5-a6ec-4b1b-83d6-867e85d5f14e,posted,Public Transport Fare,-3025.57,b064634b-effb-4ea6-a3dc-45e733ce3047,3877.07,debit,payment,AU00000,2024-01-10T17:49:52Z
transaction,0c46e13e-6d9f-476f-bb43-1b7c4365edf0,posted,Transfer Platnm Homeloan 346454,-3037.7,72a02d54-14f1-435f-9b6e-4baf58722299,839.37,debit,bank-fee,AU00000,2023-07-02T08:24:32Z
transaction,c56c5556-24e9-49e1-9064-412f6e4b1014,posted,Pharmacy Purchase,-3561.09,674b9e67-9782-441f-bdfa-a061338a76d1,-2721.72,debit,cash-withdrawal,AU00000,2024-03-25T18:52:38Z
transaction,a1e9f23f-688f-4978-aefe-72415f7af460,posted,Restaurant Dinner,-2142.12,006ee22e-add8-46ec-8aa2-eb99dc95a902,-4863.84,debit,bank-fee,AU00000,2023-09-28T10:17:23Z
transaction,15d7b5a4-3793-482b-857d-67bbfc016fb8,posted,Manly Maths Tutor Wages,-1730.0,d6654db9-f09e-4b27-90dd-fe1af7a67874,-6593.84,debit,cash-withdrawal,AU00000,2023-05-31T22:03:03Z
transaction,edd0cb25-d4f2-43b2-bfa7-d10331ac9287,posted,Travel Agency Booking,-4535.35,79556821-8bd3-40c2-8a55-026edbeef85f,-11129.19,debit,bank-fee,AU00000,2023-11-29T13:16:39Z
transaction,6def28ea-e04c-4ba5-8228-c71e725061a5,posted,Netflix Subscription,-755.43,7f46e60c-7d71-4082-941f-ca8a7186870f,-11884.62,debit,payment,AU00000,2023-10-20T18:21:50Z
transaction,7ff8454e-cb91-49df-9817-68f5d46ed386,posted,Uber Ride,-196.53,58bbbea9-1222-42d4-8ea1-1ae005a1a581,-12081.15,debit,bank-fee,AU00000,2024-04-23T09:08:07Z
transaction,95343a40-b459-47ae-b041-45a303a24a9a,posted,Amazon Online Shopping,-3402.02,db0b9d3d-6da5-4adb-b6ca-79e714f8ab1f,-15483.17,debit,bank-fee,AU00000,2023-10-14T22:49:11Z
transaction,90ccc12d-da69-4da2-aa54-34cc91b34a3c,posted,Payroll WFRMS 15439393,10505.97,6f001224-54fd-43ae-ad01-79cd86530c91,27687.29,credit,transfer,AU00000,2023-06-22T12:16:31Z
transaction,cbef6c05-8344-43e6-aea8-670175fd4b3a,posted,Mobile Phone Bill Payment,-3850.43,a8b31d87-ff64-4450-a191-b05359cd8bea,23836.86,debit,bank-fee,AU00000,2023-06-18T17:35:22Z
transaction,44bd6281-8a4f-433d-95e1-202b3f653c66,posted,AGL RETAIL ENERGY LTD (GAS),-4584.43,4c453210-6da9-4df2-9cac-8344cc04ab36,19252.43,debit,payment,AU00000,2023-07-02T22:31:11Z
transaction,2743728a-8e1e-407e-879a-6fe59f813d8e,posted,TFR Acc14000 TO 12389,-816.94,19511ecc-7907-4d6e-b5f9-85c52b45a5c3,18435.49,debit,cash-withdrawal,AU00000,2024-02-16T13:04:36Z
transaction,dfab9433-2013-4fe4-a14a-f66e41a7231e,posted,Non Hooli ATM Withdrawal Fee,-2505.91,95b88ccd-f53c-4687-b96c-3e79b266ce81,15929.58,debit,cash-withdrawal,AU00000,2023-09-30T22:49:33Z
transaction,0b97da6a-3831-4070-9701-340f9f614759,posted,Payroll WFRMS 15439393,11909.68,43de1622-cfd5-4a3a-8d27-4586fab3a2ab,27839.26,credit,transfer,AU00000,2023-10-29T14:13:40Z
transaction,0d6032d6-2059-44b8-aded-a0db104530e3,posted,Public Transport Fare,-464.92,9f7f0908-1eb4-4db0-9bf9-fff801043af4,27374.34,debit,payment,AU00000,2023-05-21T13:40:41Z
transaction,3aeea9c9-408f-48f1-a423-a6aa26f44c5b,posted,Uber Ride,-1550.94,fec359f9-f8fb-44c6-a29e-9acb80717d10,25823.4,debit,payment,AU00000,2023-06-23T21:24:35Z
transaction,fa3b96e1-770d-4c3b-86d8-754cd463d2bc,posted,Coffee Shop Purchase,-279.03,502b711f-7379-40b6-882b-406c3d446618,25544.37,debit,cash-withdrawal,AU00000,2023-05-28T06:37:00Z
transaction,489f4582-127e-4469-aa51-934dc371b0f6,posted,Uber Ride,-818.63,3a2f0856-8de3-454f-a128-d7d0f892dc0a,24725.74,debit,cash-withdrawal,AU00000,2023-06-20T18:09:15Z
transaction,f465a2b7-4f7f-482e-888c-a92503ec8096,posted,Online Gaming Purchase,-3501.72,a8fd1921-1e3a-44e1-a9ee-588b1b083ab8,15446.41,debit,bank-fee,AU00000,2024-01-21T06:25:41Z
transaction,193af675-0384-48e4-a427-c73e9609800c,posted,Restaurant Dinner,-3714.01,09780833-1565-4e2d-a374-3f97874dc44f,11732.4,debit,cash-withdrawal,AU00000,2023-08-08T10:01:36Z
transaction,b9a6519e-8746-46d9-9501-bdcd57963b77,posted,Hair Salon Appointment,-749.43,e99ab129-a91b-47a3-9194-8a92748080fa,10982.97,debit,cash-withdrawal,AU00000,2024-05-04T00:59:14Z
transaction,0b1be2a5-7693-4725-8fea-c752974c256d,posted,Travel Agency Booking,-165.6,5a0ac36a-2859-4934-9bb2-ffcb8d4b98c7,10817.37,debit,bank-fee,AU00000,2024-04-10T17:43:53Z
transaction,511b14ad-65a1-4e18-bc6c-f502801570ad,posted,TFR Acc14000 TO 12389,-1198.59,47090029-027f-4172-8729-91aeec333794,9618.78,debit,payment,AU00000,2023-07-28T06:04:54Z
transaction,518478f6-a0e7-434a-9492-6115ab56c555,posted,Online Gaming Purchase,-1994.38,eb843f1d-66d2-4f37-8124-217afda7457d,7624.4,debit,cash-withdrawal,AU00000,2023-06-09T16:25:15Z
transaction,2e5b0f8a-2c38-473d-9c15-10d8ed33041c,posted,Hair Salon Appointment,-353.94,ed7915fd-4d90-46e9-9e41-4958f51cd950,7270.46,debit,payment,AU00000,2023-12-28T09:51:02Z
transaction,168c9520-a9ab-47e2-91f4-1e41c0c3b0a8,posted,Wdl ATM WESTPAC IGA BALGOWLAH BALGOWL AU,-1274.27,a0d95516-ae18-4fa3-8ded-4ec70168b828,5996.19,debit,cash-withdrawal,AU00000,2023-10-05T16:10:14Z
transaction,82f5556c-fe54-4c88-a330-b45bd31d451e,posted,Hair Salon Appointment,-4235.15,6dad14ea-ffd5-49fd-8601-3cc390970da5,1761.04,debit,bank-fee,AU00000,2024-04-10T23:27:38Z
transaction,33b749c3-7acd-4883-9f64-d6967ba91726,posted,Music Streaming Subscription,-2961.14,93cf93f3-7f0e-4d12-a1d6-02a0efed64af,-1200.1,debit,bank-fee,AU00000,2024-05-05T13:10:16Z
transaction,d9d09a68-7d95-49a3-8f19-5314157d2783,posted,Clothing Store Purchase,-1403.16,8642e944-527f-44bb-85e3-eecf951e5680,5496.74,debit,payment,AU00000,2024-03-05T12:13:49Z
transaction,cefe0310-59d4-4862-96b3-6d9889ca9d4b,posted,Manly Maths Tutor Wages,-1832.11,c16dbed9-fbff-4491-9ad7-162b8b2bc846,3664.63,debit,cash-withdrawal,AU00000,2023-09-24T04:54:35Z
transaction,37cd7d68-9ba0-4a78-8511-5872941e6809,posted,Transfer Platnm Homeloan 346454,-4877.23,405640e7-b14c-4ce3-a44b-e33c4b24b72c,-1212.6,debit,payment,AU00000,2024-01-01T13:38:43Z
transaction,36419165-52df-43c4-9eb7-806b1bf04a28,posted,TRANSFER TO JOANNA SMITH CAMPING,-143.61,dc13324c-1fb2-4c57-9b41-e1d569e18cfb,-1356.21,debit,cash-withdrawal,AU00000,2023-10-16T11:10:05Z
transaction,eedd2d9c-431c-4e25-b90d-728c504c1b4d,posted,Uber Ride,-2247.65,4f694fde-f65e-4616-beac-87e230147229,-3603.86,debit,bank-fee,AU00000,2023-11-16T01:50:48Z
transaction,0328976c-eb35-4b98-a961-d1fb798a3bb8,posted,Home Improvement Store Purchase,-3286.81,5a41de96-8431-4cc2-8cbf-3d4c7fd9ebc3,-6890.67,debit,bank-fee,AU00000,2024-01-30T02:22:38Z
transaction,8be13705-755b-4679-b43b-c2d2923a815b,posted,Gasoline Purchase,-900.39,f982407d-b820-4ab4-801c-ca863d2f9fe7,-7791.06,debit,payment,AU00000,2023-10-12T19:11:38Z
transaction,afb20ed3-2e8c-49f0-a137-ecf6b8f19ded,posted,Gym Membership Fee,-3452.35,2f1aa5e7-4015-4e31-aba5-7a9000febe42,-11243.41,debit,bank-fee,AU00000,2024-02-28T06:55:00Z
transaction,595c8831-99c3-4d9a-9d56-57e26e4c62f2,posted,Public Transport Fare,-4107.55,6f1eb5e2-a792-46fe-afa8-bda080e69d0b,-15350.96,debit,cash-withdrawal,AU00000,2024-01-06T04:19:23Z
transaction,b581ddf4-cca7-4794-bbd1-05e71292ceff,posted,Hair Salon Appointment,-532.18,e7d539a6-26f2-47fe-8f27-fedfba33e558,-15883.14,debit,bank-fee,AU00000,2023-09-25T04:54:33Z
transaction,27b1718f-f855-4f23-b864-8a1625754173,posted,Non Hooli ATM Withdrawal Fee,-1722.6,b6dbe82a-687b-4cdf-a4f8-430f6a330814,11327.58,debit,bank-fee,AU00000,2023-11-13T13:58:47Z
transaction,236e4d8d-e4f7-4120-819e-57ae04ebe3f9,posted,Gym Membership Fee,-1899.41,854c35b1-50b5-4f7d-b4ae-4702a38fd102,9428.17,debit,cash-withdrawal,AU00000,2023-06-10T00:38:29Z
transaction,cbecd142-80c6-487b-93f1-e42dca5996a3,posted,Bookstore Purchase,-2767.51,b7493590-6410-42b1-9054-b199ffbb9658,6660.66,debit,cash-withdrawal,AU00000,2024-03-25T02:37:32Z
transaction,33f21657-9d31-4c81-bfe2-f398cdeb59c8,posted,Public Transport Fare,-3999.28,efabb21a-d87d-41c3-8c05-4de6e7323bd0,2661.38,debit,cash-withdrawal,AU00000,2023-10-09T22:23:56Z
transaction,c3a99240-0a88-4a46-a81e-d9e100c4252f,posted,Electricity Bill Payment,-1472.3,117c1804-42ee-4b61-87b2-688324137de1,1189.08,debit,bank-fee,AU00000,2023-09-04T10:36:46Z
transaction,a5afa55c-bf6e-475b-b266-74eb0d0f22ed,posted,Car Maintenance Expense,-99.22,3490d58b-6cdc-4912-8fdc-dbdc6ab5e048,1089.86,debit,payment,AU00000,2024-03-23T05:21:11Z
transaction,09bd1f22-0ab2-4cc8-bae5-7017cbf45b74,posted,Gym Membership Fee,-3714.07,edf09568-be56-41de-ad36-075c652793de,-2624.21,debit,cash-withdrawal,AU00000,2023-05-13T15:11:58Z
transaction,5792e4b3-697f-4471-9221-e220eccc19c6,posted,Travel Agency Booking,-1743.94,bf2dba19-0d9f-4085-9abf-495384b5e06b,-4368.15,debit,cash-withdrawal,AU00000,2024-03-13T02:52:50Z
transaction,1e05e2fa-5518-4aa8-9a42-4b92267bca28,posted,Home Improvement Store Purchase,-3142.18,530a532d-ac15-4459-a821-a28e7c48b81a,-7510.33,debit,bank-fee,AU00000,2023-06-06T07:41:36Z
transaction,1774eb10-f673-4698-b6fc-130b409cebef,posted,Coffee Shop Purchase,-2526.21,d5b07e12-74d1-481c-b1f1-401d65cfdaa5,-10036.54,debit,cash-withdrawal,AU00000,2024-03-17T20:04:57Z
transaction,1b07ce70-f222-4a61-b004-16dbb51128b5,posted,AGL RETAIL ENERGY LTD (GAS),-2059.92,99c411a0-c3f7-4290-ad11-06eb21fea365,9309.19,debit,bank-fee,AU00000,2024-04-30T10:20:49Z
transaction,9a800eaf-90df-4972-a267-bfcc7b668bb9,posted,Mobile Phone Bill Payment,-2519.17,46e1075d-849d-455d-862a-513b2f85de90,6790.02,debit,cash-withdrawal,AU00000,2023-07-18T20:40:09Z
transaction,d5f75d65-b0e8-4f86-adc9-da21ccda4011,posted,Online Gaming Purchase,-4183.91,80ff7d7a-fe0c-4cf9-af38-7888860d31f6,2606.11,debit,bank-fee,AU00000,2023-07-23T08:50:23Z
transaction,4fd1b7af-a639-49c8-9dfc-a62e7bcad7a5,posted,Movie Ticket Purchase,-4113.07,2712c053-cdf1-4792-b15f-fa0fcf4bcddb,-1506.96,debit,cash-withdrawal,AU00000,2023-05-17T21:51:19Z
transaction,6baff8df-6940-49a1-848e-e10192271c8c,posted,Payroll WFRMS 15439393,10306.74,d1a09bb6-5307-4f14-a617-ae66cb384bc4,8799.78,credit,transfer,AU00000,2024-05-04T06:54:11Z
transaction,ba61f812-d354-4dd6-ae39-e4c113709aed,posted,Manly Maths Tutor Wages,-204.34,b2c6c289-ca64-445b-8fe3-b6477287eaf5,8595.44,debit,payment,AU00000,2023-05-18T23:16:25Z
transaction,95654ef8-bd3b-4cf0-a741-ad26e7d59410,posted,Clothing Store Purchase,-4766.36,c0c3cd8b-1dba-4650-9ad4-e85f732749ef,3829.08,debit,payment,AU00000,2023-12-31T13:09:17Z
transaction,ce5eb5b8-0768-4751-bca5-03fb3049b579,posted,Amazon Online Shopping,-3613.59,4a373f2c-81eb-46b2-ae19-3b8375c159d5,215.49,debit,bank-fee,AU00000,2023-08-07T15:12:35Z
transaction,0d96ec50-3be0-462d-ab4e-bd7d975aa95c,posted,Wdl ATM WESTPAC IGA BALGOWLAH BALGOWL AU,-4674.38,e8c0eaa4-5c2b-45d5-8ac2-e857a1f230b3,-4458.89,debit,bank-fee,AU00000,2024-01-08T22:28:08Z
transaction,81c89e32-8018-45c4-8c73-ffdc8ebd6e7f,posted,Car Maintenance Expense,-2098.26,7c18d6fb-adb6-4411-95e6-982294661d38,-6557.15,debit,cash-withdrawal,AU00000,2024-04-18T08:18:43Z
transaction,441f2863-cee4-4f8e-a70b-2d121c18c723,posted,CTRLINK CARERS Ref: 998R6789201610974V,-3489.09,ca924ae3-c719-4ec7-a657-cf2fa4126275,6114.47,debit,bank-fee,AU00000,2023-05-24T15:41:09Z
transaction,10fbb17a-9403-4e8b-8c26-d9da275cb6ba,posted,Manly Maths Tutor Wages,-4707.99,adb9f481-dc4d-4021-837c-009eb1780f27,1406.48,debit,bank-fee,AU00000,2024-04-04T23:19:58Z
transaction,c239d9fa-a3e1-4e42-ad33-eca17ec31acc,posted,Transfer Platnm Homeloan 346454,-4748.47,cd789f6a-5af3-4c2a-b8cb-b5aa19edf483,-3341.99,debit,cash-withdrawal,AU00000,2023-06-08T06:53:38Z
transaction,1950922f-889c-4848-8d78-d707a6a1f77a,posted,Uber Ride,-1052.74,78df31b8-5c93-4da8-8c6c-4ec570e5955f,-4394.73,debit,bank-fee,AU00000,2024-04-16T05:41:50Z
transaction,69b5cb87-0b7f-4406-8a58-cfc1095fb95e,posted,Electricity Bill Payment,-4101.67,47de5824-c42c-4eaa-87d7-d8049368e68e,-8496.4,debit,bank-fee,AU00000,2023-12-04T10:13:33Z
transaction,07e46e3c-f60f-418f-be02-6141113e816c,posted,TFR Acc14000 TO 12389,-881.71,22fc3121-c620-46f0-ab54-d150f36dcdda,-9378.11,debit,payment,AU00000,2023-10-06T12:07:32Z
transaction,b716ad2a-48c8-444a-ae23-22cb50089529,posted,Uber Ride,-1547.18,fc56e312-ea94-460a-b2e8-c216d79aaa5b,-10925.29,debit,bank-fee,AU00000,2023-06-03T10:41:15Z
transaction,56766462-6b4f-4ec7-b0a2-c6ce1f7371b9,posted,Electricity Bill Payment,-3873.58,48a8a23f-ab82-4db1-94e8-fe47738b2ac1,-14798.87,debit,bank-fee,AU00000,2024-03-13T16:37:25Z
transaction,6f200169-2baf-44fc-b6da-16953fb0c19b,posted,Electricity Bill Payment,-922.86,b424aa85-81e3-42b0-9421-13bf71c6fa75,-15721.73,debit,cash-withdrawal,AU00000,2024-04-27T06:46:54Z
transaction,91549540-ed82-4d01-bb6f-06a2bbf1844d,posted,Movie Ticket Purchase,-2260.0,61d53eb7-eb93-4d1c-85b2-fc788a69bcaa,-17981.73,debit,cash-withdrawal,AU00000,2024-03-22T16:46:55Z
transaction,2c81b06c-107b-4ac3-b9ca-59d3f1534e15,posted,Car Maintenance Expense,-443.1,da718906-07f5-41bf-a40d-edf202de7168,5603.16,debit,bank-fee,AU00000,2024-04-25T13:19:04Z
transaction,a32c5d81-dc9c-481a-ab24-db0eb7ba024d,posted,Electricity Bill Payment,-3954.65,236428d0-4727-4ed2-b25f-836a44735c0d,1648.51,debit,payment,AU00000,2023-07-06T16:32:28Z
transaction,f6ce1d98-9b9d-4d59-ae0a-b91e83129f41,posted,TRANSFER TO JOANNA SMITH CAMPING,-4199.04,bcc82fc8-bb15-4372-9d81-f9aeef69f5d5,-2550.53,debit,bank-fee,AU00000,2023-07-13T21:42:17Z
transaction,e88deb94-20e3-4dc0-bc06-ad6af56a2af4,posted,TRANSFER TO JOANNA SMITH CAMPING,-271.18,72402cd5-fa77-4384-b028-63717cc4de84,-2821.71,debit,cash-withdrawal,AU00000,2023-08-31T07:27:58Z
transaction,da23bc44-39c0-45b4-9825-aea8bceb6fe1,posted,Transfer Platnm Homeloan 346454,-4822.03,520c0663-7c31-460f-95f2-e9c921397ffd,-7643.74,debit,bank-fee,AU00000,2023-11-23T14:18:38Z
transaction,796a81f5-ab3b-4de6-87b2-9d1aad19b1dc,posted,Pharmacy Purchase,-4773.69,e8c6af85-2903-4abe-9717-803707d64471,-12417.43,debit,cash-withdrawal,AU00000,2023-08-25T20:08:28Z
transaction,8f824654-8f60-4464-9fb9-a4850ecfb078,posted,Movie Ticket Purchase,-1435.77,0b7101c9-8770-4119-aa8d-089a6f34bf17,-13853.2,debit,bank-fee,AU00000,2024-04-08T07:17:06Z
transaction,f80a8ebc-3264-42cb-8ca7-84034a91ce8d,posted,Coffee Shop Purchase,-1760.98,baf26cb3-8d86-4ecc-b11d-0ffa215d11ff,-15614.18,debit,cash-withdrawal,AU00000,2023-10-14T06:06:06Z
transaction,a8f1b7e4-0281-4448-bbbb-ea6791ec5738,posted,Gym Membership Fee,-1909.96,10911e08-0a7c-4afc-bba6-430c24039913,-17524.14,debit,cash-withdrawal,AU00000,2023-08-18T03:48:20Z
transaction,ec0f6dd5-3d72-45e2-a989-0c9726707650,posted,Hair Salon Appointment,-880.44,bfb7d0d2-e823-4a85-9d48-cedb935e632f,-18404.58,debit,cash-withdrawal,AU00000,2023-06-22T22:47:01Z
transaction,adca7f6c-b469-479c-9dd6-98c5c96143e6,posted,Uber Ride,-4870.02,12f36ec4-5b04-4d6d-abd0-41ffb5336348,5010.27,debit,payment,AU00000,2023-09-03T04:54:19Z
transaction,e092e37e-7e14-448c-b8cf-cfd82024404d,posted,TFR Acc14000 TO 12389,-1129.88,70e614c9-c0db-425b-9cf8-a3832ef0d0a3,3880.39,debit,cash-withdrawal,AU00000,2023-10-06T04:42:45Z
transaction,861f1259-25ca-4e7e-8b09-5a99c40d0754,posted,Mobile Phone Bill Payment,-4932.51,db993ca2-8785-4d90-9c32-bbb5250e8479,-1052.12,debit,cash-withdrawal,AU00000,2024-03-22T05:30:56Z
transaction,a15133aa-6256-4037-a4b3-fcc8c04be3b1,posted,Music Streaming Subscription,-1081.27,a956871e-bead-4440-926c-9a1f433ef055,-2133.39,debit,cash-withdrawal,AU00000,2024-02-25T21:00:22Z
transaction,086fb193-3d07-41db-ad55-af77925d4dc1,posted,Payroll WFRMS 15439393,10057.18,660d9f3b-76d4-416a-9353-6a654f1c31a9,7923.79,credit,transfer,AU00000,2023-07-16T20:27:18Z
transaction,02f00a03-2512-4d85-baeb-04f698bcc50c,posted,TRANSFER TO JOANNA SMITH CAMPING,-250.41,59926983-0dd4-4476-b1fd-5e676a6554d2,7673.38,debit,bank-fee,AU00000,2024-03-15T18:09:58Z
transaction,fbb3b65d-d0d5-4065-997f-e9f5e5497b86,posted,Gasoline Purchase,-1395.53,e83bb24b-6cb1-4630-bce9-1595c013fcbd,6277.85,debit,payment,AU00000,2023-05-31T03:11:28Z
transaction,a38c92f8-0da0-4459-be1e-ff1f673bc192,posted,Clothing Store Purchase,-293.39,0030f1ba-2130-4605-834a-2cfd039e9b9d,5984.46,debit,cash-withdrawal,AU00000,2024-01-04T20:55:08Z
transaction,98c294c1-6709-4133-9e3b-57a0a82f766d,posted,Coffee Shop Purchase,-1675.16,4b3cc418-61fd-4dbf-96a8-e33044038d68,4309.3,debit,cash-withdrawal,AU00000,2024-04-11T21:30:40Z
transaction,bcdb32e1-19e1-40ca-9ffd-f0ac81261d5a,posted,Wdl ATM WESTPAC IGA BALGOWLAH BALGOWL AU,-1783.77,279a7f54-ce0f-4237-af03-cc247c4c8628,2525.53,debit,cash-withdrawal,AU00000,2024-04-20T07:03:23Z
transaction,00d7bd9f-781e-4173-af4b-8b64f956433d,posted,Netflix Subscription,-3168.68,486ef6b0-75e4-404d-a635-efdca76cb4ad,11741.51,debit,cash-withdrawal,AU00000,2024-03-22T14:43:31Z
transaction,51cefe44-d3e6-4772-b108-436cdf9c6ee3,posted,Restaurant Dinner,-249.34,af020f18-2075-4076-ac79-28643b6e8a95,11492.17,debit,bank-fee,AU00000,2023-07-05T05:05:49Z
transaction,7bd2e091-9d38-429a-8cb3-b52db490822e,posted,Hair Salon Appointment,-1331.62,4c46473b-34a1-44e9-a2ba-b04737b5969e,10160.55,debit,cash-withdrawal,AU00000,2024-04-06T11:58:23Z
transaction,d89bd046-5ff9-4ec9-ac36-f7524543efa3,posted,Payroll WFRMS 15439393,11911.43,f6e4ade6-e1b7-4fd2-8c36-5bfc26ffff33,22071.98,credit,transfer,AU00000,2024-03-18T21:01:30Z
transaction,6a3df13c-c325-4e93-a58a-e032feaadb62,posted,Home Improvement Store Purchase,-3129.95,c26d9bb6-3d71-460f-906e-fb6f8bb26090,18942.03,debit,payment,AU00000,2023-08-25T18:47:11Z
transaction,2554e84b-3ae6-4d30-a7ae-b8d3dc0e8888,posted,Transfer Platnm Homeloan 346454,-1739.55,11b3825f-f528-4b83-b459-83d1f8efeae7,17202.48,debit,bank-fee,AU00000,2023-09-30T23:10:54Z
transaction,867499d0-7ee4-4433-979a-bb14c650b71f,posted,Mobile Phone Bill Payment,-3864.74,a00d2c7c-93f3-46be-9e2a-7d387145d0ad,13337.74,debit,payment,AU00000,2023-09-21T11:47:29Z
transaction,5427e8b5-ad9f-45aa-b034-63e74e257e92,posted,Gym Membership Fee,-1488.83,33edad04-8394-4faf-84e6-e3bbde968329,11848.91,debit,cash-withdrawal,AU00000,2023-08-26T22:10:00Z
transaction,3afd316d-a17e-4f7f-b928-eb6f54778722,posted,Non Hooli ATM Withdrawal Fee,-58.84,5c2a3b76-57fc-49da-89fa-24f92953d6d5,11790.07,debit,bank-fee,AU00000,2024-01-07T20:56:57Z
transaction,71cd37b8-f3b0-40b9-8d46-883b8d96d2ee,posted,Non Hooli ATM Withdrawal Fee,-635.18,6797a9e7-f03f-46e3-ab48-7e6575f2a233,11154.89,debit,cash-withdrawal,AU00000,2023-10-06T13:32:55Z
transaction,8f7a7337-cfc9-4d94-8669-3f051ddbdc31,posted,Music Streaming Subscription,-2184.77,729757fc-70d2-4d29-a676-fc1bdaf5de77,6291.28,debit,payment,AU00000,2023-05-23T02:36:39Z
transaction,58222ba5-e840-47a9-b72e-40455c94227c,posted,TRANSFER TO JOANNA SMITH CAMPING,-634.65,3ffe641e-18c0-48f4-afc0-a0f584f5f6d7,5656.63,debit,cash-withdrawal,AU00000,2023-08-05T05:14:48Z
transaction,01859322-4886-425a-8353-ffebb26f2c7d,posted,Travel Agency Booking,-3158.59,9c3dde17-fc53-46e7-ae44-d7dedf6e7f5c,2498.04,debit,payment,AU00000,2023-09-18T12:06:45Z
transaction,8a2eede1-511f-48fb-bd5e-91ec425a43a3,posted,Public Transport Fare,-3991.4,08350a63-bc9e-483a-8e6b-dfd9023ba18c,-1493.36,debit,payment,AU00000,2023-08-27T15:46:25Z
transaction,620305e1-821b-4405-ac0b-95542aeb2c0b,posted,Pharmacy Purchase,-895.88,90804078-c776-4e29-acdb-4f5ec54ab015,-2389.24,debit,bank-fee,AU00000,2023-07-31T10:55:24Z
transaction,b9984523-6c78-43f4-84de-fb2db09db91a,posted,Pharmacy Purchase,-2579.51,1630eb7a-9950-44ad-baa3-8d568ba2b2d3,-4968.75,debit,payment,AU00000,2023-06-04T18:30:40Z
transaction,71a695de-8b0b-413d-bc6c-9066019e1e81,posted,Hair Salon Appointment,-3770.29,0059ef08-5dda-45da-8b5b-13b1910ebabc,-8739.04,debit,cash-withdrawal,AU00000,2024-03-21T20:44:25Z
transaction,3fb5e821-970e-4cbc-9c13-b904f604f423,posted,Hair Salon Appointment,-4866.2,37d3fffe-d4f9-4ae1-884d-f39ba870e8f4,-13605.24,debit,cash-withdrawal,AU00000,2023-07-08T08:21:39Z
transaction,c06e1a91-015a-46e8-be57-a0d093a969bc,posted,Transfer Platnm Homeloan 346454,-3085.13,eacdcd7a-8d51-4168-ab5f-c1935b316dfa,-16690.37,debit,payment,AU00000,2023-06-26T08:16:41Z
transaction,75a14abd-93d7-4e25-b126-ff5cccf9b09c,posted,TRANSFER TO JOANNA SMITH CAMPING,-2797.82,1d54f481-29b1-4f03-b499-2cfe3e6ccdfd,-19488.19,debit,bank-fee,AU00000,2023-10-17T23:19:27Z
transaction,12729466-63d0-4ae3-8e50-2551c88aee65,posted,Restaurant Dinner,-164.24,79c34253-f89c-4c77-801d-bac34b8cb8b0,14184.74,debit,bank-fee,AU00000,2023-09-11T08:19:42Z
transaction,fdb10777-1a21-4e10-ae03-11a8e45f6f7e,posted,Netflix Subscription,-3856.15,5cbf2d5b-bf62-4ae5-996d-f68a1429343c,10328.59,debit,bank-fee,AU00000,2023-06-11T13:08:32Z
transaction,7e95ba79-0681-4558-bf12-f7e62ad0671f,posted,Netflix Subscription,-665.06,cdc67ba8-78d4-48f5-90b6-606cf6c90859,9663.53,debit,payment,AU00000,2023-05-29T19:05:57Z
transaction,1f7fa071-35dd-4596-a357-9e2f49895d0d,posted,Pharmacy Purchase,-1653.04,54c5e499-7061-467c-957d-53fa967264b5,8010.49,debit,cash-withdrawal,AU00000,2023-10-10T19:03:12Z
transaction,da5537d0-88c6-47a9-be4d-0b56701713c6,posted,Restaurant Dinner,-4093.78,8e90771c-7261-4585-a1ef-e72549553c06,3916.71,debit,bank-fee,AU00000,2023-10-21T22:47:50Z
transaction,a99250e3-29d0-4951-807c-dec2c570a947,posted,Payroll WFRMS 15439393,11111.93,0658f082-0a3f-4260-adc8-f68eb61b8847,15028.64,credit,transfer,AU00000,2023-10-09T01:56:31Z
transaction,dcac7d1c-91a6-40f4-baf8-2c731888cea5,posted,Uber Ride,-2921.44,3bfc5414-9abc-4499-89be-f43a2fe2e113,12107.2,debit,cash-withdrawal,AU00000,2024-05-05T01:31:20Z
transaction,2a335e14-1521-4ca2-936a-642ae945d56c,posted,Coffee Shop Purchase,-178.69,2a99bf55-f98d-47ff-a609-f5d91f0ce31f,11928.51,debit,payment,AU00000,2024-03-16T14:55:38Z
transaction,32bd00ef-d806-4b37-88e8-0492794bd791,posted,Travel Agency Booking,-1157.91,197aec05-2799-44a9-b4d9-da9ba8f7eb05,10770.6,debit,cash-withdrawal,AU00000,2023-08-26T03:23:19Z
transaction,4874e9b8-3a11-4f65-b98e-8abb3f15ca50,posted,Clothing Store Purchase,-2129.91,3db2f3cc-2756-473b-b1f4-55d2c76f5915,8640.69,debit,cash-withdrawal,AU00000,2024-01-16T04:17:07Z
transaction,a2baa316-a611-4062-a311-42523c1f59b3,posted,Bookstore Purchase,-1164.72,b5b7d7d6-7c42-47ce-988e-1e84a1c438ab,16915.9,debit,cash-withdrawal,AU00000,2024-05-10T22:43:19Z
transaction,cd6271f5-efe1-4f76-963e-2146f9f9a5a9,posted,Pharmacy Purchase,-4770.64,c1b3a444-41cf-4c9b-8c8e-d7c0bbf1a69d,12145.26,debit,bank-fee,AU00000,2024-04-22T19:03:43Z
transaction,70371112-9ce3-48e1-9211-f7c24d4d85cd,posted,AGL RETAIL ENERGY LTD (GAS),-757.63,7ab3605e-f1d1-47e8-b945-c17aa2344c72,11387.63,debit,bank-fee,AU00000,2023-09-13T16:39:51Z
transaction,a5f8cabe-0692-4702-9761-3b896aae89ec,posted,Pharmacy Purchase,-835.79,3fc24cae-cb13-42ab-99f8-10758aa30e18,10551.84,debit,payment,AU00000,2023-12-17T08:18:10Z
transaction,ddb632be-946f-4d96-ae83-01d567d4b376,posted,Movie Ticket Purchase,-2420.2,45ed6311-d116-4a4d-b257-1333eb629bcf,8131.64,debit,cash-withdrawal,AU00000,2024-01-31T19:21:14Z
transaction,d624070a-c4de-47c1-893e-b3450689336d,posted,TRANSFER TO JOANNA SMITH CAMPING,-3690.63,de3b20e2-fc19-48eb-8795-d339b0bdb090,4441.01,debit,bank-fee,AU00000,2023-12-13T10:06:07Z
transaction,c649a712-3af9-4a93-ad81-aa91b7913703,posted,Transfer Platnm Homeloan 346454,-2277.99,7e2e71aa-2ef6-4cd5-8fb0-7a99e6b26431,2163.02,debit,bank-fee,AU00000,2024-01-13T18:35:13Z
transaction,9ec9105b-093e-4c34-8ad9-5999d7c70084,posted,Electricity Bill Payment,-1540.42,47af0062-3774-42a5-aa19-f25acc405170,622.6,debit,payment,AU00000,2023-09-05T06:37:18Z
transaction,0eda6005-d355-4984-afb9-b28f81e9a6c3,posted,Car Maintenance Expense,-1365.24,a2f802a1-adbf-48c9-a911-0a58aceea112,-742.64,debit,bank-fee,AU00000,2024-02-15T04:25:04Z
transaction,135fd128-66d8-44a2-b95d-85c127108b81,posted,Movie Ticket Purchase,-2756.48,688c3ef5-b1b1-420e-a1f9-e560e3522da7,-3499.12,debit,bank-fee,AU00000,2023-08-16T14:34:58Z
transaction,737cd216-d4a0-46ed-b545-43be1d5ea07d,posted,CTRLINK CARERS Ref: 998R6789201610974V,-488.71,24f4d9fe-ed89-434b-8892-4823111c17b2,11530.34,debit,payment,AU00000,2023-12-11T20:03:58Z
transaction,275f7fc5-218a-44e5-b97d-72dbafb2fced,posted,Bookstore Purchase,-2697.74,97c0bfb3-e077-4ed3-8f71-68e431ab5d66,8832.6,debit,cash-withdrawal,AU00000,2024-01-08T13:38:24Z
transaction,833c5fdf-37ce-420a-b2d8-5a20db4ce2fe,posted,Gasoline Purchase,-1699.49,98399022-7c92-4048-ba18-693e63d2c402,7133.11,debit,bank-fee,AU00000,2023-12-27T20:49:10Z
transaction,e63433b5-8702-4aa2-9a0e-d3289226f2f2,posted,Uber Ride,-3991.19,38d9762d-2ccc-433d-baa6-721c5e8a4210,3141.92,debit,payment,AU00000,2023-12-07T23:02:03Z
transaction,309d6bb9-ead2-424c-a4ca-6d40ff51c113,posted,Manly Maths Tutor Wages,-2667.57,49035a75-8c3b-49f8-8d5c-98967d633c80,474.35,debit,payment,AU00000,2024-03-13T17:23:47Z
transaction,4327ae8a-7516-4d14-a721-74e9f3246473,posted,CTRLINK CARERS Ref: 998R6789201610974V,-3768.75,2f0c25df-761e-4e4c-a314-e3c91e9f91a9,-3294.4,debit,cash-withdrawal,AU00000,2024-02-22T14:35:51Z
transaction,d7f44813-03eb-44aa-a8f9-e188af0409b3,posted,Mobile Phone Bill Payment,-467.65,2b7494ba-8de7-4307-936c-abc5ed757046,-3762.05,debit,bank-fee,AU00000,2023-11-30T12:34:24Z
transaction,397dd1d1-2bea-442d-88bf-f2cf7a4fe6ab,posted,Pharmacy Purchase,-4669.65,b8286692-fce7-4b6d-9350-61099a4c9fe6,-8431.7,debit,payment,AU00000,2023-10-17T12:58:00Z
transaction,8d5ea8ce-90d3-400e-8181-46465b39cef0,posted,Music Streaming Subscription,-2748.72,f878c1a4-c920-4e42-a89e-775d4d55ef00,-11180.42,debit,bank-fee,AU00000,2023-12-09T01:09:51Z
transaction,f739b753-cf27-4904-8bbe-081f986ed048,posted,CTRLINK CARERS Ref: 998R6789201610974V,-1784.65,4ce6d107-8dd0-4dde-8c79-5a298e3b7310,-12965.07,debit,cash-withdrawal,AU00000,2024-01-02T10:46:25Z
transaction,1dee3255-1b8d-4bcd-8a48-28d2d1415d90,posted,Clothing Store Purchase,-655.7,08176b7d-1fc3-4b2b-9121-aba074eb7361,16688.2,debit,payment,AU00000,2023-12-31T19:08:14Z
transaction,cc2869eb-b8b6-4c20-bf86-8fbd135bb3d8,posted,Manly Maths Tutor Wages,-3579.58,03c117df-1654-4a04-927b-54db9d40e45f,13108.62,debit,bank-fee,AU00000,2023-11-15T04:14:26Z
transaction,6e54d88c-d242-48e4-a85a-2db98c7bda4d,posted,Manly Maths Tutor Wages,-2230.64,d071bbdf-e2d0-4c51-8bac-570a657fff82,10877.98,debit,payment,AU00000,2023-06-06T06:57:43Z
transaction,756151b6-53fa-4b7c-a82b-0131c267caf0,posted,Coffee Shop Purchase,-298.89,3316113f-e053-4a5e-bfc1-81468d25b685,10579.09,debit,cash-withdrawal,AU00000,2023-07-16T04:13:06Z
transaction,83a806e5-c323-48aa-844f-ac79e702c6c0,posted,Payroll WFRMS 15439393,10467.75,bbbbde76-2273-4afa-8cb0-d20c3c806984,21046.84,credit,transfer,AU00000,2023-11-02T16:05:53Z
transaction,a7ec9ad4-8466-4e30-a6c7-9b64b4c3420a,posted,Travel Agency Booking,-851.38,b611b50e-110a-4655-b031-1295027efb8b,20195.46,debit,bank-fee,AU00000,2024-02-05T06:01:12Z
transaction,19351d1b-b097-48d5-bb2a-39192fbf289a,posted,Gasoline Purchase,-256.68,047069e6-4f49-4e59-8742-7515bda20ce1,19938.78,debit,cash-withdrawal,AU00000,2023-11-09T14:05:51Z
transaction,d19e6140-ef49-4a8c-acf9-b2b42c912798,posted,Electricity Bill Payment,-837.1,051daef9-c17f-4204-8e4e-47d7790ac48b,19101.68,debit,bank-fee,AU00000,2023-10-07T11:54:50Z
transaction,eb3a6887-5d43-43d6-879a-3b5a164fafe8,posted,Gym Membership Fee,-1837.33,7d554595-a4cb-40ae-b33b-c9c9a92ac22e,17264.35,debit,cash-withdrawal,AU00000,2024-02-25T07:29:44Z
transaction,c9f7049b-7b88-471f-bd23-db10514a74cd,posted,Electricity Bill Payment,-4178.88,69c834e4-9483-45f4-b36a-023a73994614,13085.47,debit,payment,AU00000,2024-03-14T05:41:46Z
transaction,52fb0578-1cd9-4b40-b109-8a27c3f7057b,posted,Mobile Phone Bill Payment,-3704.79,20fa563a-0d36-4902-afa3-e413e1e66ea9,2151.05,debit,cash-withdrawal,AU00000,2024-01-15T01:09:26Z
transaction,827222ad-53f3-49b0-bdd5-2202b7806bf3,posted,Hair Salon Appointment,-2377.8,2ae5e205-c10d-4566-9285-b93a275624af,-226.75,debit,payment,AU00000,2024-03-07T16:51:20Z
transaction,6cabec84-b45a-4382-85d8-48ff4b8980fa,posted,Online Gaming Purchase,-1306.49,34b05d76-fdbb-4778-880b-ebdead5ada34,-1533.24,debit,cash-withdrawal,AU00000,2024-04-04T08:16:21Z
transaction,74585bea-b942-47bf-972a-9e1ab5844a6a,posted,Music Streaming Subscription,-3462.52,bed45099-6571-4528-a88c-d40f62679ba2,-4995.76,debit,bank-fee,AU00000,2023-05-31T11:18:56Z
transaction,4d64c04a-92f2-4783-a5be-8d0e2c9bd6e1,posted,CTRLINK CARERS Ref: 998R6789201610974V,-3049.68,50d594e8-1be8-487b-bff0-b7db2103f414,-8045.44,debit,payment,AU00000,2023-11-05T23:32:11Z
transaction,e8d2b008-400f-4762-a60f-ae0cd54d8b74,posted,Netflix Subscription,-3573.57,9a50e7a0-2c9f-4ef3-8d5e-eecb5bd4cb2d,-11619.01,debit,cash-withdrawal,AU00000,2023-10-17T22:48:04Z
transaction,50535d5e-8f96-4920-abe6-9f21c2056e13,posted,Public Transport Fare,-375.11,6ab0eda2-fe4f-444f-8810-d4aa5c6d6e4a,-11994.12,debit,bank-fee,AU00000,2023-06-02T21:42:42Z
transaction,32cdc204-0e46-4f79-84e8-e7e4bf1cae89,posted,Travel Agency Booking,-2618.91,10f33013-5e35-4b6e-aea9-094b5901be8b,-14613.03,debit,payment,AU00000,2024-04-23T05:05:46Z
transaction,e7d8f0c7-019b-439d-83e6-618b88723bad,posted,Car Maintenance Expense,-3819.72,f27800ec-7293-4688-8286-3be40a670266,-18432.75,debit,payment,AU00000,2023-11-30T04:21:08Z
transaction,e972ce19-e3b2-44f8-9c8f-af2d594fcae7,posted,Electricity Bill Payment,-4905.03,23e3dc5e-96b5-4128-ac77-d7af733ac237,-23337.78,debit,payment,AU00000,2024-05-06T13:12:58Z
transaction,33f954d2-8f4d-4894-a654-b6940c3529b0,posted,Bookstore Purchase,-3926.4,4727b1fc-9461-4b03-a4a1-87b71debda7c,13724.46,debit,payment,AU00000,2023-08-09T13:29:25Z
transaction,148a0f82-ae4f-4182-8abf-245c6099a837,posted,Clothing Store Purchase,-3770.41,51993a92-b065-474f-a6b3-97820c3db408,9954.05,debit,payment,AU00000,2024-03-20T21:52:32Z
transaction,9baa303e-dfa3-4260-8f1c-c7233321adf7,posted,Transfer Platnm Homeloan 346454,-2138.51,590eda37-b757-4632-96bc-fd6a0c86bfa9,7815.54,debit,cash-withdrawal,AU00000,2023-07-27T12:08:22Z
transaction,8859f6a4-98a7-420b-b62d-802863acc35f,posted,Restaurant Dinner,-4317.45,0d2f3dc1-5815-4049-bbb8-4fb2dc39f1ed,3498.09,debit,payment,AU00000,2024-03-21T08:26:30Z
transaction,60c85d59-2267-4829-8ca7-409f432bc8ab,posted,Clothing Store Purchase,-2384.16,2ce79429-f40a-49cb-9d83-a22e903ea86f,1113.93,debit,payment,AU00000,2023-07-23T03:52:43Z
transaction,c240a398-5906-461e-8d03-c0df1576f270,posted,Restaurant Dinner,-1080.39,c464b150-f393-4860-92c6-6ccf2be13b88,33.54,debit,bank-fee,AU00000,2023-08-10T08:32:20Z
transaction,6a1a3326-2b29-4d2f-ac37-e34d2f184eac,posted,Gasoline Purchase,-405.62,54613062-56b0-4d50-9234-5b274ec388d1,-372.08,debit,cash-withdrawal,AU00000,2023-06-05T23:39:34Z
transaction,e25fb9ae-792a-4ef8-8411-fe829a5bedcd,posted,Home Improvement Store Purchase,-1124.89,c9d13933-cb2e-4d65-a456-d1b37533f04d,-1496.97,debit,cash-withdrawal,AU00000,2023-10-03T21:52:19Z
transaction,2feb1838-1793-4635-9be7-296f15c8be8c,posted,Gym Membership Fee,-3624.79,12b3f505-c801-4f0c-805b-479d79ad5191,-5121.76,debit,bank-fee,AU00000,2023-06-07T20:54:43Z
transaction,a6923dc1-7cc4-412d-b44d-f32fd4603b3a,posted,Pharmacy Purchase,-1509.24,04d920d6-4333-4482-a7b7-1b9e5c4d7a4c,-6631.0,debit,cash-withdrawal,AU00000,2024-04-07T07:36:39Z
transaction,3068f71b-16e6-4373-8f45-a222d0e2362e,posted,CTRLINK CARERS Ref: 998R6789201610974V,-4921.93,2c319d71-292b-4480-82ae-1c77a551db07,10486.59,debit,bank-fee,AU00000,2023-12-13T23:35:31Z
transaction,e38f5006-566e-4522-a247-f35e7462aa42,posted,Non Hooli ATM Withdrawal Fee,-500.19,d6a87824-9220-4e0a-9d03-b25d4c0437bd,9986.4,debit,bank-fee,AU00000,2023-12-11T12:48:18Z
transaction,ed3ece65-030f-4f28-9855-acb2e7b6aa41,posted,Electricity Bill Payment,-1501.97,2987ec1c-8598-4d41-9480-c44c7b1a25d9,8484.43,debit,cash-withdrawal,AU00000,2024-01-11T16:56:36Z
transaction,f62238e2-d135-4e43-8f6d-f414caa5ca62,posted,Bookstore Purchase,-3195.43,7478b57f-09ed-4a6d-ba51-ebf24353e920,5289.0,debit,bank-fee,AU00000,2024-04-26T22:58:50Z
transaction,d930a796-2e45-4dc6-882c-9bafe9eea99b,posted,Public Transport Fare,-4233.67,3f5cfb4e-06e3-4b38-8fc5-8c48d4d401b9,1055.33,debit,payment,AU00000,2024-03-08T19:25:45Z
transaction,bd378198-3e49-4e33-bd7f-04cf2d6a354d,posted,Wdl ATM WESTPAC IGA BALGOWLAH BALGOWL AU,-305.88,ad468083-3ab2-4285-abcc-d1630e88d509,749.45,debit,cash-withdrawal,AU00000,2023-10-04T02:50:32Z
transaction,5821f398-d3c4-4f6d-8dbb-bfde43699594,posted,Coffee Shop Purchase,-4809.02,da5cb634-d0d2-4d39-afb1-8c17301ec51e,-4059.57,debit,bank-fee,AU00000,2023-10-15T09:17:22Z
transaction,3b69898b-6fc5-4bf0-8565-d0495b20bd73,posted,Movie Ticket Purchase,-1630.55,961bce39-7467-407c-abe5-c91106e9a256,-5690.12,debit,bank-fee,AU00000,2023-12-16T12:26:09Z
transaction,5b3ad2de-4f43-4520-8a95-3f766a1b8a36,posted,Home Improvement Store Purchase,-2082.15,0f298771-361b-42bb-8cde-3e89d1cdceab,-7772.27,debit,cash-withdrawal,AU00000,2023-09-04T05:44:19Z
transaction,773ea70f-91cc-4857-8aca-9ef7b73efed8,posted,Pharmacy Purchase,-1111.01,cc3982fe-e422-4062-bfdb-0ba510212057,-8883.28,debit,payment,AU00000,2023-07-07T19:55:51Z
transaction,014be05f-a23f-4b4e-b717-f002245a5ec3,posted,Non Hooli ATM Withdrawal Fee,-594.01,492e486e-3095-4159-9420-b1f55c036caa,7559.87,debit,payment,AU00000,2024-02-06T15:55:37Z
transaction,7a19a7ca-5293-4bda-98f1-6ded149ef6c7,posted,Mobile Phone Bill Payment,-1216.7,e29771eb-4087-4bf9-85c0-d23b8c4aa3d0,6343.17,debit,cash-withdrawal,AU00000,2024-03-08T19:23:00Z
transaction,59f8d6e2-ef22-407c-8ae0-3c8e0ac657b3,posted,Transfer Platnm Homeloan 346454,-2032.6,93979bd3-f189-42b3-9ee9-8b7ca54c7719,4310.57,debit,bank-fee,AU00000,2023-08-29T02:18:30Z
transaction,38eede9b-8dc2-4061-8478-2b35e4885b55,posted,Bookstore Purchase,-124.56,e19d34d4-4fa4-4850-8305-b785fae7f56c,4186.01,debit,bank-fee,AU00000,2023-12-16T16:37:30Z
transaction,0af44ad0-0853-48a0-a898-509820b8d88f,posted,Payroll WFRMS 15439393,11896.7,3e6dff47-1dd4-485d-8810-170c76f9df43,16082.71,credit,transfer,AU00000,2023-06-13T15:15:47Z
transaction,7d41e343-2d9d-4d02-bd44-9a82589ff34e,posted,Car Maintenance Expense,-468.1,32319392-3b52-4de8-944d-f1319657df5e,15614.61,debit,cash-withdrawal,AU00000,2023-12-10T03:00:59Z
transaction,8abc19ca-236f-4302-a31d-a84ebe8b722b,posted,Netflix Subscription,-3050.76,0d6b4535-51f4-4d56-88d2-302fd8baa2e2,12563.85,debit,payment,AU00000,2023-08-28T17:06:27Z
transaction,1ab25cc9-5175-4dc0-8ed1-2475871a3d5e,posted,AGL RETAIL ENERGY LTD (GAS),-4308.64,dcf47c04-f34e-4d7e-b889-9766673ac2c9,8255.21,debit,payment,AU00000,2023-08-16T18:44:16Z
transaction,bdc17524-a1cf-4106-af01-1664485b2bd0,posted,Movie Ticket Purchase,-3913.49,472b15bc-f9c2-4538-bf37-73493def88ec,4341.72,debit,payment,AU00000,2023-06-12T03:58:29Z
transaction,e7110d78-081a-4af6-a416-59f4caf7b0ac,posted,CTRLINK CARERS Ref: 998R6789201610974V,-3007.81,e75d5ef1-6780-4cf0-9b21-1d6a6593a204,1333.91,debit,bank-fee,AU00000,2024-01-16T07:56:53Z
transaction,9c441fb6-df5d-44b8-9d24-9cb9ee80134b,posted,Mobile Phone Bill Payment,-1169.92,24f608f9-e763-4c14-a3cd-95804fca5d22,11065.32,debit,cash-withdrawal,AU00000,2023-10-05T10:32:10Z
transaction,46c28706-6c7a-4c6a-b138-eb7ae49587e1,posted,Gasoline Purchase,-1380.8,a452e419-1369-498a-a4c4-9738253dcca3,9684.52,debit,cash-withdrawal,AU00000,2023-06-09T00:07:36Z
transaction,8859b95e-a111-4808-bbd6-5311707d0893,posted,Public Transport Fare,-4655.61,b7ad883c-45a0-4acd-a99d-4096da132225,5028.91,debit,payment,AU00000,2023-06-17T09:57:07Z
transaction,6d11b582-89df-4b85-bc2b-aa2069d7130f,posted,Manly Maths Tutor Wages,-2993.82,62fd84ef-28c2-4d7c-a29c-1df4a42efafb,2035.09,debit,cash-withdrawal,AU00000,2023-11-15T13:22:28Z
transaction,118be64f-8db6-4a56-8460-63e3157ab4bf,posted,Online Gaming Purchase,-4984.58,dc55e451-6601-43a3-bc05-00f28f292195,-2949.49,debit,bank-fee,AU00000,2023-09-05T05:56:59Z
transaction,701fa985-76fe-45d6-bfe6-5cc4a5f24ed9,posted,Transfer Platnm Homeloan 346454,-3715.37,b8d016c7-26a7-4f36-ac2e-639fc4f225dc,-6664.86,debit,cash-withdrawal,AU00000,2023-07-03T03:21:31Z
transaction,30a0128f-8a8f-4082-a310-ea418bad5dcd,posted,Transfer Platnm Homeloan 346454,-4247.91,0582dee0-d633-4962-9b6a-6e45e0dbe125,-10912.77,debit,payment,AU00000,2023-10-30T08:40:09Z
transaction,2eaa6907-6a3d-4d09-8317-d1c94378e34a,posted,Uber Ride,-4082.5,1bac6199-e77d-4bd4-b2c9-161877b98e5e,-14995.27,debit,bank-fee,AU00000,2023-07-16T06:24:33Z
transaction,72442356-e1b0-4c51-99de-8d80c870e405,posted,Online Gaming Purchase,-982.99,ea73b6ac-facb-4a86-81fc-fae2faa7369a,-15978.26,debit,payment,AU00000,2023-11-28T14:05:40Z
transaction,e433ed05-3a19-4d48-bf74-cc36f0029505,posted,Gym Membership Fee,-2681.64,f95a30a9-350d-4679-bac5-ebb9e32f1908,-18659.9,debit,payment,AU00000,2024-01-22T08:03:17Z
transaction,74ea8b35-3cc4-4835-9f6d-6aff06f4d655,posted,Mobile Phone Bill Payment,-1269.33,a8e66c86-1459-4736-9d33-a59fb2ff7335,12244.18,debit,cash-withdrawal,AU00000,2024-03-17T21:34:34Z
transaction,03613bc2-5178-40ca-9dee-8fbb2b80ab58,posted,TRANSFER TO JOANNA SMITH CAMPING,-3691.98,95afc314-95ca-45e3-9dae-c0117d46231c,8552.2,debit,bank-fee,AU00000,2024-01-09T15:29:15Z
transaction,9653f541-78b3-4c0f-9f1e-922c2b3b8a2a,posted,Hair Salon Appointment,-3623.44,06e8cd29-a5d7-4467-8645-9a7eda6539df,4928.76,debit,payment,AU00000,2023-06-05T06:28:04Z
transaction,1b5557f8-601c-4fb9-92a5-a4bc25582045,posted,Uber Ride,-2750.49,810dc904-203e-4a2e-95df-6e37d8de68a9,2178.27,debit,bank-fee,AU00000,2024-02-26T08:53:37Z
transaction,99189b50-74e6-4a46-96b7-18dd108ca1d5,posted,Manly Maths Tutor Wages,-1070.88,9b69d8df-2a92-4dd2-b795-49cff6e66093,1107.39,debit,payment,AU00000,2024-02-22T04:03:58Z
transaction,dc31e7e8-16b3-4c6e-82ea-74325872e32b,posted,Hair Salon Appointment,-2840.11,fbf961b3-5b60-4790-abe9-ebb6a9194945,-1732.72,debit,bank-fee,AU00000,2024-04-24T22:41:11Z
transaction,04ed655e-1493-47e1-b03c-77183a1a9aa0,posted,Wdl ATM WESTPAC IGA BALGOWLAH BALGOWL AU,-4146.64,184b630e-6bc8-4c2c-ac3a-38b705220f94,-5879.36,debit,cash-withdrawal,AU00000,2024-01-22T13:40:39Z
transaction,7ed09511-8052-4066-bca7-8cd8427b0d90,posted,Hair Salon Appointment,-2199.14,9e60c20b-c21b-412b-96c5-9f40a3c6ccfb,-8078.5,debit,bank-fee,AU00000,2023-11-07T13:05:18Z
transaction,edf1951c-2615-4f21-8238-95d2f52a43a0,posted,Mobile Phone Bill Payment,-1697.34,fc4cae99-0847-4bef-89d9-46410658e5d7,-9775.84,debit,bank-fee,AU00000,2023-08-28T19:03:58Z
transaction,995e4092-4a25-461a-8a03-cb77a4416722,posted,Home Improvement Store Purchase,-3777.58,11db031f-681b-43c8-8239-8e856080c80c,-13553.42,debit,bank-fee,AU00000,2023-06-01T16:50:16Z
transaction,1bf1600a-ed10-40f3-b0c2-38564ffe5816,posted,TFR Acc14000 TO 12389,-1535.04,0b12171f-676d-4262-90e1-47d1e64a8a21,12599.66,debit,payment,AU00000,2024-04-20T14:01:51Z
transaction,de95238d-929a-4bab-8551-3bf6971ce373,posted,Transfer Platnm Homeloan 346454,-4346.66,a784e000-d5ec-4c06-8f61-6974854736fa,8253.0,debit,cash-withdrawal,AU00000,2023-08-16T08:07:12Z
transaction,5eefbb43-5d08-4d10-82d6-6f754d9b92ab,posted,CTRLINK CARERS Ref: 998R6789201610974V,-4823.1,211adea7-ea71-4d48-b249-342763b34c10,3429.9,debit,cash-withdrawal,AU00000,2024-03-17T02:57:26Z
transaction,f959de7b-8082-4fee-a516-b3d4c1a68617,posted,Public Transport Fare,-2496.19,2345eb0d-bed0-4450-b19b-f85b38947e0c,933.71,debit,cash-withdrawal,AU00000,2024-04-10T19:03:01Z
transaction,76a8b193-2ecc-42a1-93b7-f6e3e1be51a6,posted,Transfer Platnm Homeloan 346454,-3785.46,11be6b26-c452-4047-b8a3-924fc9b40982,-2851.75,debit,payment,AU00000,2023-07-06T01:02:08Z
transaction,8f1ef9b1-61c3-41bf-a488-9dfbca48e07d,posted,Coffee Shop Purchase,-2284.47,1f3500f3-ab17-4a16-b4e3-b84cb7b4d5d2,-5136.22,debit,cash-withdrawal,AU00000,2024-04-15T09:00:44Z
transaction,6fa89786-8f22-4eb7-b4ee-210baf5aa2e8,posted,Movie Ticket Purchase,-2822.41,1711a3ef-1144-4797-a639-b196bde6eb76,-7958.63,debit,bank-fee,AU00000,2024-04-21T03:10:17Z
transaction,2009659c-d499-4c6f-b700-433840d3922b,posted,CTRLINK CARERS Ref: 998R6789201610974V,-1833.65,c1420b20-f826-4745-800d-266a7bd8b9ae,-9792.28,debit,payment,AU00000,2023-09-24T16:59:16Z
transaction,f6ba8179-b4cb-48c1-a13e-959507bbe69c,posted,Gasoline Purchase,-3155.83,651c5fee-ad7d-40d1-be05-af2c1443cde3,-12948.11,debit,payment,AU00000,2023-09-12T21:47:20Z
transaction,63fbc51a-9f18-4dd9-bdb9-3af9da26e11d,posted,Movie Ticket Purchase,-2093.18,2412f19f-9ed7-43f1-b55b-2c62b82a36a3,-15041.29,debit,bank-fee,AU00000,2023-05-26T21:01:23Z
transaction,1a29d2a5-8c1d-458c-96c9-083deced9eaa,posted,Mobile Phone Bill Payment,-1524.58,774b59f4-bbca-4f0b-8e0c-64c1b866ea02,16147.69,debit,bank-fee,AU00000,2023-10-21T17:18:46Z
transaction,f2547e07-df45-46ee-9854-1e902419825c,posted,Restaurant Dinner,-2193.06,2bf586ef-6215-434c-9fbc-1e361df3b849,13954.63,debit,payment,AU00000,2024-02-28T21:54:51Z
transaction,c1260ee7-6c98-4196-af50-64e93bffd793,posted,Netflix Subscription,-68.42,e778912d-dba3-46d8-8ebb-35ef8c94818f,13886.21,debit,bank-fee,AU00000,2023-09-05T02:13:45Z
transaction,69fe1238-0f4d-4ac7-b330-5653d7d42b87,posted,Uber Ride,-296.23,2ff2f0a5-815e-4fc5-8a6f-be75bda96f1c,13589.98,debit,payment,AU00000,2023-08-08T12:22:44Z
transaction,24c81f2c-6cab-450f-8540-87ff6ec37184,posted,Pharmacy Purchase,-3571.85,0e74c2f0-36f5-4bfb-a8c6-6721cb7224f2,10018.13,debit,cash-withdrawal,AU00000,2023-05-22T18:27:57Z
transaction,1e6b8cea-a58b-47af-bab0-c7d9fd4bf87b,posted,Uber Ride,-580.67,0500771d-330e-4ee3-a5d0-fca752f8d74e,9437.46,debit,bank-fee,AU00000,2024-03-05T20:03:03Z
transaction,df2592b3-c840-4cca-b069-bd207c9d3b23,posted,Coffee Shop Purchase,-4797.0,c9596817-fca9-4248-9668-ea21e74c1dd9,4640.46,debit,bank-fee,AU00000,2024-01-24T06:58:21Z
transaction,aa224626-54c8-402a-bed9-72266d950adb,posted,Coffee Shop Purchase,-3328.38,1c4dd8ca-09af-40df-ba0c-894823a5eb90,1312.08,debit,payment,AU00000,2024-02-15T07:54:13Z
transaction,31f9efdd-02c7-4897-af60-6d924f488e21,posted,Gasoline Purchase,-2078.37,3f9587a4-f569-434a-a03f-97cec4059e9d,-766.29,debit,payment,AU00000,2024-03-07T12:27:22Z
transaction,a7a3c8a7-9666-4543-9606-9fadb645efb7,posted,Travel Agency Booking,-1228.1,22517f3a-4a90-4ad3-ad87-79791a614a29,-1994.39,debit,cash-withdrawal,AU00000,2023-12-12T17:36:44Z
transaction,b0091c17-0bf3-4ef8-a0d6-b94ce459c00c,posted,Gasoline Purchase,-2427.37,61a49ff6-c95a-4e54-b23e-85b56f5d2faa,9011.69,debit,payment,AU00000,2023-10-26T19:50:44Z
transaction,6592ac21-cfb6-4f91-9d75-b7f30ddc3a2f,posted,AGL RETAIL ENERGY LTD (GAS),-1561.54,2541f18d-7b72-42ac-bf9a-258b7695dd68,7450.15,debit,cash-withdrawal,AU00000,2023-11-28T09:48:02Z
transaction,269a4894-b75c-454f-84b7-c5a20f707abc,posted,Movie Ticket Purchase,-3458.13,fd5d492a-a094-432d-9dd0-2b340f0427ff,3992.02,debit,payment,AU00000,2023-09-08T07:15:59Z
transaction,484f3829-5c6f-4704-9e4d-ae18079632e8,posted,Music Streaming Subscription,-586.47,3925a036-a17b-43ed-a4fb-6d4fb457da00,3405.55,debit,payment,AU00000,2024-05-04T11:44:27Z
transaction,b302a90b-36ce-4dd2-91d0-8308c50d53f2,posted,Bookstore Purchase,-250.36,90447d5d-aa58-4509-9ed5-7de02d5b2361,3155.19,debit,bank-fee,AU00000,2023-11-25T04:40:50Z
transaction,5e1876a7-630c-42f1-b310-8001f158dc56,posted,Clothing Store Purchase,-2777.29,ecaa2e41-bfc9-41ef-bca1-8ef387a4c1fa,377.9,debit,cash-withdrawal,AU00000,2024-04-23T06:11:57Z
transaction,eb5bfba1-6fe4-4758-bc95-d8f5d81e94a3,posted,Gasoline Purchase,-3712.3,24f72d45-b586-483c-bf6e-3b17c443cdb9,-3334.4,debit,payment,AU00000,2023-05-19T19:07:39Z
transaction,c7e0c10c-9a21-47e2-b2eb-6a8e8a144b1b,posted,Wdl ATM WESTPAC IGA BALGOWLAH BALGOWL AU,-3153.14,885097b9-8f5b-474b-a99e-eb65018d8c9d,-6487.54,debit,cash-withdrawal,AU00000,2024-04-19T05:38:25Z
transaction,4e2aacbc-b7c1-4d2a-927f-f286f8a78a6f,posted,Bookstore Purchase,-1774.82,129d19be-33e9-41ef-b743-6a0c8261deb1,-8262.36,debit,bank-fee,AU00000,2023-05-12T06:08:05Z
transaction,3ee16b1b-1690-41f3-b49b-8f9129ff871a,posted,Public Transport Fare,-2982.49,6140da0e-ed00-4948-9a19-3729b5a01818,-11244.85,debit,bank-fee,AU00000,2023-12-08T12:02:06Z
transaction,ec42f9e0-39db-4fcc-8d9c-3c5a318a3687,posted,Public Transport Fare,-2760.72,89efc61f-8a72-4d6c-ad32-9eff6070d2b1,3472.39,debit,cash-withdrawal,AU00000,2023-10-08T14:03:07Z
transaction,7d4acaae-10b2-444a-9634-d34be911f78e,posted,Clothing Store Purchase,-3408.55,b758c2e1-614f-4a61-91fd-dc30768b9d49,63.84,debit,cash-withdrawal,AU00000,2023-07-12T22:22:08Z
transaction,d250dd98-8ce2-4cfd-b735-f475f331f1d0,posted,Electricity Bill Payment,-286.79,34cae76a-a9cc-46e9-b3f1-40aeb1943ea7,-222.95,debit,cash-withdrawal,AU00000,2023-11-02T10:46:03Z
transaction,81ede589-d38e-4576-bb35-e81016b428e8,posted,Gasoline Purchase,-2908.4,a04be087-a50a-47d3-9dd4-d9d5e0122599,-3131.35,debit,bank-fee,AU00000,2024-05-04T06:10:33Z
transaction,832a2eb3-809d-46f1-ad3b-707fe1dad58d,posted,Online Gaming Purchase,-1786.32,f78bd9c9-93e2-4ce4-a8f4-cae85db3891e,-4917.67,debit,cash-withdrawal,AU00000,2023-11-12T02:39:10Z
transaction,c93d441d-a4ac-431c-a583-231f76787cdb,posted,Car Maintenance Expense,-3815.72,804e49a2-f552-4941-abdd-1c1ca7928524,-8733.39,debit,payment,AU00000,2023-08-14T17:38:54Z
transaction,4d21b488-8d1b-4939-b5cf-ff1bbf945c39,posted,Music Streaming Subscription,-2565.39,2b18023b-335e-46b5-85b7-59ec043a7464,-11298.78,debit,cash-withdrawal,AU00000,2023-05-15T09:00:43Z
transaction,b94154ab-9829-47d3-afd2-329149c8cba8,posted,Amazon Online Shopping,-972.67,c7c26929-b0d6-4fd2-a581-3b79359cc96e,-12271.45,debit,cash-withdrawal,AU00000,2023-09-13T03:30:57Z
transaction,ac19c489-e55f-4649-a26c-79e0f0418909,posted,Travel Agency Booking,-2834.01,50338b92-6a1a-46dd-84d0-406a6d381e42,-15105.46,debit,payment,AU00000,2024-02-13T09:55:06Z
transaction,b0b09aa2-3e18-4078-b9f4-e1d1160bffca,posted,Uber Ride,-4058.7,bd040ac3-a105-44aa-9f62-76920b5047d8,-19164.16,debit,cash-withdrawal,AU00000,2023-07-28T23:41:16Z
transaction,3a47d7d8-61f6-42b4-8e32-61f4569c0941,posted,CTRLINK CARERS Ref: 998R6789201610974V,-4227.0,542900f9-b2fc-485c-826f-47b45f24f51d,5664.42,debit,cash-withdrawal,AU00000,2024-01-12T07:10:13Z
transaction,8d416e81-9850-4347-b427-4996e8d26713,posted,Coffee Shop Purchase,-2879.1,78b5a28d-276e-4f2e-ab5d-52201ac574e6,2785.32,debit,bank-fee,AU00000,2023-05-31T03:52:33Z
transaction,6f2bcc75-82fa-4ecb-a6db-e740d26e51e4,posted,Amazon Online Shopping,-3096.45,73db6889-30ff-4491-83cc-5298a6abb910,-311.13,debit,payment,AU00000,2023-09-06T09:41:59Z
transaction,ca2c2981-9cf8-4e6d-9b2a-9802a4501b0e,posted,Gym Membership Fee,-662.62,9081f3c5-d9a3-4727-bc27-d88644a7402b,-973.75,debit,cash-withdrawal,AU00000,2023-11-30T23:56:55Z
transaction,b7b5590a-d0c1-427e-9b7e-54d7c7401882,posted,Clothing Store Purchase,-2954.1,088c40dc-5071-454e-93c3-eb921ca40cb1,-3927.85,debit,cash-withdrawal,AU00000,2023-10-18T14:57:18Z
transaction,37911c6c-a042-4a70-a9e4-20dcd6e5566d,posted,Electricity Bill Payment,-1039.1,6e436ecd-7a46-48fa-9f04-ead2eaba0d61,-4966.95,debit,bank-fee,AU00000,2023-11-26T05:19:16Z
transaction,657054e8-a0e1-477a-b80f-f17cde9ee80c,posted,Coffee Shop Purchase,-3687.46,111e4b4f-3c8d-4886-baa6-95c4807716d4,-8654.41,debit,cash-withdrawal,AU00000,2024-03-28T15:09:19Z
transaction,ee612548-0a06-4817-a1aa-79501856e61c,posted,Mobile Phone Bill Payment,-2076.59,45a3cde9-3c1e-4dd2-bb54-51432f5c6d89,-10731.0,debit,payment,AU00000,2023-05-29T22:21:36Z
transaction,9480ce12-dfc0-4e67-8738-542cb3e7c482,posted,Gasoline Purchase,-4893.16,8fcbe41d-1a92-4be5-8c21-7510b09d14eb,-15624.16,debit,payment,AU00000,2024-03-12T19:00:24Z
transaction,9e57cd8d-7ec5-40c5-9f6d-428f13470fe3,posted,CTRLINK CARERS Ref: 998R6789201610974V,-3186.02,dd48336e-320b-4ed7-b278-8abe81aa2a84,-18810.18,debit,payment,AU00000,2023-12-03T07:24:46Z
transaction,609114bb-0feb-4443-a9ba-6a1d5738889a,posted,Public Transport Fare,-3902.18,47d49b29-2640-4da2-84eb-c0261ca9df1b,11805.06,debit,payment,AU00000,2023-10-17T03:16:23Z
transaction,2502d887-dd96-46b5-b8e9-c217632c6ca1,posted,Car Maintenance Expense,-3689.35,9ace58a6-3bf7-437c-9971-2e231d02b846,8115.71,debit,payment,AU00000,2023-05-15T11:57:11Z
transaction,c5e3bbee-ea5d-42e2-850c-d9adc354d425,posted,Car Maintenance Expense,-2863.52,e3d0cb49-5335-43d7-9e61-b6f2a70d791c,5252.19,debit,payment,AU00000,2023-07-25T08:53:03Z
transaction,844f8e8f-e686-48e0-afe7-507cc2e1301d,posted,Gasoline Purchase,-4797.34,16426429-de5e-4bc8-87ce-4283440dc4de,454.85,debit,bank-fee,AU00000,2023-10-20T06:11:21Z
transaction,522a6098-027a-4a10-8041-7888a48b679d,posted,Online Gaming Purchase,-1675.94,bfb2c17d-28a4-4224-81f2-101ea5d2d7f4,-1221.09,debit,payment,AU00000,2024-01-20T10:34:26Z
transaction,9bc63497-2539-4b49-a094-0c0156fa82fa,posted,Online Gaming Purchase,-3491.96,58d21fb8-53e5-4fd7-bed5-44e597b631cc,-4713.05,debit,payment,AU00000,2023-09-29T23:58:50Z
transaction,d563fa69-7021-449e-8cd0-1639b7d8eb43,posted,TFR Acc14000 TO 12389,-3087.85,b585a0aa-0ada-487f-826f-829c20f7066f,-7800.9,debit,bank-fee,AU00000,2024-04-07T14:19:40Z
transaction,a39458e4-f102-47ac-bf41-6da87de44d4c,posted,Gym Membership Fee,-576.7,2a76246d-d755-4781-bfaa-3453141907fd,-8377.6,debit,payment,AU00000,2023-07-02T05:37:41Z
transaction,96b5f6ef-bbcc-4740-b96e-3c23d636cc95,posted,Movie Ticket Purchase,-1785.01,7d517b7b-1f69-49cc-b604-2e8244b11b9e,-10162.61,debit,cash-withdrawal,AU00000,2023-08-17T13:50:50Z
transaction,31e5b9b3-e95e-4bee-b080-6b200f8e58ea,posted,TRANSFER TO JOANNA SMITH CAMPING,-1381.43,5f2e39a8-9c88-4508-b0be-0f4564410a57,-11544.04,debit,bank-fee,AU00000,2024-03-15T10:46:39Z
transaction,232fef38-7fc6-4371-b6c1-779032c1ecd9,posted,Car Maintenance Expense,-2958.64,ff9eae6e-c380-4caa-8c87-fa2940197bfd,15886.27,debit,payment,AU00000,2024-05-08T22:22:21Z
transaction,df734d16-1f91-4c59-852d-fde61c0fb44d,posted,AGL RETAIL ENERGY LTD (GAS),-2160.47,7d0296eb-ee0b-4664-8e05-76f650a13dfd,13725.8,debit,bank-fee,AU00000,2024-04-22T07:14:40Z
transaction,e1ed4408-e733-4fb6-bc43-a09e5297cc93,posted,Mobile Phone Bill Payment,-4711.78,19647ff5-173a-4276-bbc6-d8c6a63f6937,9014.02,debit,payment,AU00000,2024-01-30T02:37:20Z
transaction,97761ee5-c934-4722-aa41-587881707d2a,posted,Travel Agency Booking,-4618.22,b750e3bc-ef28-4093-8e62-c32ac33a64da,4395.8,debit,bank-fee,AU00000,2024-01-18T05:01:50Z
transaction,41776fd1-9ba1-4d0b-8428-539368b43c00,posted,Hair Salon Appointment,-3547.03,071902a7-7f85-42ab-b754-c9ab9d24bef3,848.77,debit,cash-withdrawal,AU00000,2023-09-19T21:02:24Z
transaction,b69862a8-72a1-420a-8089-bf4d216ad1db,posted,Travel Agency Booking,-1009.52,2ad9dedc-5359-4c99-870b-b04096c75895,-160.75,debit,cash-withdrawal,AU00000,2023-06-05T02:59:11Z
transaction,cc0e3afc-e835-48c5-8f88-c7c6b5d7e446,posted,Payroll WFRMS 15439393,11123.56,f73e7ecd-16f4-4be1-8838-705d4fed75d3,10962.81,credit,transfer,AU00000,2024-04-19T00:48:22Z
transaction,5c78350b-d51a-42d9-be0e-0db0a4dd87fb,posted,Manly Maths Tutor Wages,-4756.3,ff6b4940-5373-4b5b-a51f-99469a4e2092,6206.51,debit,cash-withdrawal,AU00000,2023-05-16T23:09:37Z
transaction,479f4451-3f33-4041-af99-16cc23f0455e,posted,TRANSFER TO JOANNA SMITH CAMPING,-1324.81,478d4435-19a1-4a66-8a45-f9e4b407df94,4881.7,debit,cash-withdrawal,AU00000,2023-10-26T23:04:06Z
transaction,bd399d35-ec94-4338-9561-d7f6ed1656c2,posted,TFR Acc14000 TO 12389,-4093.0,25e2fd8d-38b8-4cf9-a85c-472a7a639979,788.7,debit,payment,AU00000,2023-10-27T10:57:01Z
transaction,adf9519c-c8d0-4b94-a2bf-47275024d438,posted,Netflix Subscription,-2853.93,62b27900-3bd4-4888-a18b-71da35d94004,9094.8,debit,bank-fee,AU00000,2023-07-18T21:13:38Z
transaction,fe80d4a1-0ca3-4438-b5f4-12aed6893800,posted,Bookstore Purchase,-1105.92,7e7a0ee0-7323-46a4-ba07-19348ad588a4,7988.88,debit,bank-fee,AU00000,2024-02-24T14:52:21Z
transaction,3049168f-5849-4171-a73c-38be25d299c9,posted,Wdl ATM WESTPAC IGA BALGOWLAH BALGOWL AU,-3362.7,699f914b-2e91-4ccf-be42-8d91579e9715,4626.18,debit,payment,AU00000,2024-03-09T04:27:00Z
transaction,57a0168a-f500-4ba5-aed0-1b403ac5f42a,posted,Bookstore Purchase,-4418.33,04c2ef52-7e88-482e-a607-32d7f3f741b1,207.85,debit,payment,AU00000,2023-10-13T05:39:17Z
transaction,8bb42b40-9795-46ab-b0b0-bc845fa67de9,posted,Non Hooli ATM Withdrawal Fee,-864.28,c7556e0e-a090-46e5-a33a-22a783672c74,-656.43,debit,bank-fee,AU00000,2023-06-01T19:08:49Z
transaction,984ebd53-3eb7-423e-ba7a-ee9298b50c42,posted,Non Hooli ATM Withdrawal Fee,-1590.93,8cbce389-267e-4dd1-b8e7-1246889b5efb,-2247.36,debit,payment,AU00000,2023-09-02T07:48:57Z
transaction,8c9b5761-ba0a-4977-ad63-87df22ecd349,posted,Restaurant Dinner,-1650.56,c4fde710-9203-4e7c-81eb-0815546425df,-3897.92,debit,bank-fee,AU00000,2024-04-21T02:54:46Z
transaction,c285c201-b698-4e69-871d-de46bc4f691b,posted,TFR Acc14000 TO 12389,-2645.32,ba00bddc-eb30-4f90-b658-e1649c023e5e,-6543.24,debit,bank-fee,AU00000,2024-03-12T12:46:21Z
transaction,1cf17bae-0e89-4c45-a773-a6e43916dc9f,posted,CTRLINK CARERS Ref: 998R6789201610974V,-4486.22,15916f06-a1e4-45bc-8ead-58980ee12bab,-11029.46,debit,cash-withdrawal,AU00000,2023-07-23T14:15:10Z
transaction,c1591fcd-fbd2-4222-93d0-bb4c3fe326eb,posted,Online Gaming Purchase,-2121.69,3348bc4d-da57-4fe8-89ec-7ce95d24fd46,-13151.15,debit,bank-fee,AU00000,2023-05-26T19:58:42Z
transaction,aefec5cf-6fff-432b-9049-299967e1bf3a,posted,Gasoline Purchase,-3209.06,b41c75fc-550c-48ad-a048-69d02cbd4213,12622.35,debit,bank-fee,AU00000,2023-09-21T14:13:25Z
transaction,983855ff-00cd-4087-bf55-f79a49af291d,posted,Wdl ATM WESTPAC IGA BALGOWLAH BALGOWL AU,-3200.39,ed1bfcd1-dd29-485d-a41d-de5f392c1f33,9421.96,debit,bank-fee,AU00000,2024-03-30T00:16:20Z
transaction,5f2468f1-a4f4-4e27-bce7-596c962065c7,posted,Pharmacy Purchase,-2277.36,7e7851e3-dfec-4171-93b4-288558ea11b8,7144.6,debit,bank-fee,AU00000,2024-03-28T12:17:56Z
transaction,cdfb407e-1fcd-428b-a62f-8ebe7359dce8,posted,Bookstore Purchase,-4499.32,2e2967be-8315-49c6-8732-cd7c8f7c211f,2645.28,debit,cash-withdrawal,AU00000,2023-12-05T13:50:48Z
transaction,3eb7bf1c-7312-4b6f-8dab-a500f3f32e6b,posted,Electricity Bill Payment,-1337.21,94dab10c-8a23-4a76-8df2-808a97cd8ba7,1308.07,debit,bank-fee,AU00000,2023-05-21T14:53:16Z
transaction,ad1819f6-307c-4533-87cc-18fa00f74c15,posted,Hair Salon Appointment,-4214.07,f493eb80-343e-4807-b5ce-a3b8994b1126,-2906.0,debit,bank-fee,AU00000,2024-03-12T13:09:13Z
transaction,e82a3b54-355f-4153-806a-b8002be086f2,posted,Public Transport Fare,-4648.44,1856c470-47e4-433d-9103-03df61a40034,-7554.44,debit,payment,AU00000,2023-09-24T14:19:00Z
transaction,b5f6ac87-17a7-4cf3-b84a-762db3073fa8,posted,Pharmacy Purchase,-1896.97,8dd298d6-dd9f-4aa5-89a6-449b11237f04,-9451.41,debit,cash-withdrawal,AU00000,2023-05-30T09:01:42Z
transaction,d468bfc9-b113-44f2-9697-2dd4e6eb4f17,posted,Online Gaming Purchase,-2912.17,ea069dd8-78be-4803-8106-b007cda70b1b,-12363.58,debit,bank-fee,AU00000,2023-09-23T07:29:57Z
transaction,0d3298b4-fc45-4449-a978-b46fc84c2867,posted,Hair Salon Appointment,-2156.18,d622c36a-760a-4521-bf1c-1c343e8be404,-14519.76,debit,bank-fee,AU00000,2023-05-16T07:36:35Z
transaction,732cccc0-dd5d-4a22-82cb-1e3b9eb64060,posted,Gasoline Purchase,-1582.8,67e14917-f598-4c0a-b2d7-010256677aa4,6861.93,debit,bank-fee,AU00000,2023-07-31T12:52:57Z
transaction,eeedfd9b-5ef0-48eb-8e55-0fa7c340c2e8,posted,Clothing Store Purchase,-142.61,4fd8477a-4b03-41a8-a7a2-7771b2e36666,6719.32,debit,payment,AU00000,2024-01-12T23:57:40Z
transaction,a21910b9-5cc9-4e79-ad16-a8242e7682c9,posted,Uber Ride,-700.18,26f1710a-0dcf-4e36-a7bd-0c4fb790b4f7,6019.14,debit,cash-withdrawal,AU00000,2023-12-23T05:22:44Z
transaction,6a160069-7150-499c-bc48-e40b35461bf3,posted,Payroll WFRMS 15439393,11624.16,487a5495-6391-4fc0-a74f-52e5a592bef4,17643.3,credit,transfer,AU00000,2024-02-11T04:50:01Z
transaction,f6fe50fa-9f0c-4a61-9417-d7aafbfd7155,posted,Netflix Subscription,-2031.59,3749e2e4-e0ec-4f84-8066-7e87e4261fa7,15611.71,debit,bank-fee,AU00000,2023-06-21T06:25:30Z
transaction,2c3483ba-325b-477f-86d1-92dcc5613944,posted,Coffee Shop Purchase,-152.68,45c3e882-d9c4-47ec-8970-cb31546b8d57,15459.03,debit,payment,AU00000,2023-07-25T21:00:18Z
transaction,2467b6da-6ff8-484d-8b14-27a6cc0230a6,posted,Public Transport Fare,-2009.03,a1686f03-146e-4829-bfee-9197ab9b167e,13450.0,debit,bank-fee,AU00000,2023-09-18T20:28:14Z
transaction,8ff2e512-249e-46ca-b09e-affbdf7a27e5,posted,Gym Membership Fee,-570.23,5015f6fe-f0d8-47da-bb79-53ee8a706270,12879.77,debit,bank-fee,AU00000,2023-07-31T00:46:52Z
transaction,7a96ad22-9c4b-4092-966d-0eef7a7f8f24,posted,Home Improvement Store Purchase,-3990.91,52562ce3-2664-4248-953c-4bee2016b23a,8888.86,debit,cash-withdrawal,AU00000,2023-09-06T00:58:11Z
transaction,32bb18af-71fb-4683-a94a-606931716f6f,posted,CTRLINK CARERS Ref: 998R6789201610974V,-4583.84,5eabd991-1806-4560-b278-04d16a1a9a93,4305.02,debit,payment,AU00000,2024-02-02T14:03:55Z
transaction,8fdfa491-f95d-4194-ad09-ae731212f2d5,posted,Payroll WFRMS 15439393,11471.49,9df31d6a-d9eb-4e9c-91a5-38c10538e09f,21949.09,credit,transfer,AU00000,2024-04-06T05:17:02Z
transaction,7ef183e1-704d-4805-8b73-7b61008a8dc4,posted,Non Hooli ATM Withdrawal Fee,-285.15,65d9bb94-5939-4057-a523-3076c8c5a46e,21663.94,debit,cash-withdrawal,AU00000,2023-11-16T18:00:56Z
transaction,423507a6-fae8-49af-ae3c-9dc6df29e30c,posted,Netflix Subscription,-3188.79,2b467e4a-666e-4a47-bbd4-351fc264e5c3,18475.15,debit,bank-fee,AU00000,2024-03-17T17:51:17Z
transaction,d198481d-c737-4f89-a3de-3427a36fd055,posted,Coffee Shop Purchase,-1972.45,8b037603-811c-433d-92c7-6cb046c94320,16502.7,debit,bank-fee,AU00000,2023-11-10T20:58:12Z
transaction,4089d922-d811-4b2d-a48d-658a378213da,posted,Netflix Subscription,-2008.71,75a4a5b1-5c8d-476f-9c66-a96474ca3846,14493.99,debit,payment,AU00000,2024-03-13T01:47:25Z
transaction,4c6c3415-9bca-4c1d-ad3f-2a48fd77c652,posted,CTRLINK CARERS Ref: 998R6789201610974V,-2134.48,d01836b0-c1ee-4267-8906-15c9cf1fcd0a,12359.51,debit,cash-withdrawal,AU00000,2024-04-05T17:17:28Z
transaction,749b91dc-7193-4b48-b152-e7d64402f096,posted,Payroll WFRMS 15439393,10708.56,59f00a67-f7dc-44fc-952d-2fdac67eceaf,23068.07,credit,transfer,AU00000,2023-05-17T21:49:23Z
transaction,19cf6b05-bc8f-4571-8b7e-362ae7d05170,posted,Hair Salon Appointment,-2052.13,ea392640-6182-4599-97eb-6176c2316bce,21015.94,debit,bank-fee,AU00000,2024-04-04T21:27:05Z
transaction,1f21c2e8-c0c6-48c5-a769-67572dac7c9d,posted,Wdl ATM WESTPAC IGA BALGOWLAH BALGOWL AU,-647.45,9656ee2a-1aca-4b79-952a-d4cfd6cd8f64,20368.49,debit,payment,AU00000,2024-01-27T02:59:50Z
transaction,719f09e2-6f7e-402b-9ba1-70e6ec029cac,posted,Wdl ATM WESTPAC IGA BALGOWLAH BALGOWL AU,-3920.69,9cc22579-f726-43a0-8e5d-503b5b83dc60,16447.8,debit,cash-withdrawal,AU00000,2023-09-28T23:13:06Z
transaction,d5262873-537c-4264-a8f0-938f3754a1f7,posted,Manly Maths Tutor Wages,-4434.16,2eefb43b-7132-4114-8fc1-d6dc047eb871,13191.28,debit,cash-withdrawal,AU00000,2023-08-01T16:00:03Z
transaction,be0b4a57-46ea-4ca5-b48b-4766d5bbdc35,posted,TRANSFER TO JOANNA SMITH CAMPING,-126.7,a966737f-e1e2-47b0-8d41-813f13ea570c,13064.58,debit,bank-fee,AU00000,2024-04-19T01:22:37Z
transaction,62f2120c-48ca-47af-8e5b-7f9514d88c77,posted,Restaurant Dinner,-4099.46,0c0726ea-458b-4a93-bd4c-f39c4fc75021,8965.12,debit,payment,AU00000,2023-09-08T09:54:53Z
transaction,95a7dd2c-57e2-4744-aaf7-c28a22012142,posted,Restaurant Dinner,-2573.0,ce63d645-1c6c-4b89-adaf-b6bea5b57a05,6392.12,debit,payment,AU00000,2024-03-23T03:50:56Z
transaction,12ca0c80-bf88-40f4-a234-c665a9481edb,posted,Amazon Online Shopping,-1237.74,6db77823-8778-40fc-881d-3e88ccc75fa6,5154.38,debit,cash-withdrawal,AU00000,2023-12-02T18:13:07Z
transaction,9e97b120-3620-4cb6-9c5c-fc084bab6032,posted,Amazon Online Shopping,-4904.03,010047ad-9ab3-41bc-9b35-606f42c9787a,250.35,debit,cash-withdrawal,AU00000,2024-02-28T04:28:51Z
transaction,8c5955b1-404d-4b74-909d-935c448f8485,posted,Non Hooli ATM Withdrawal Fee,-284.56,518e1996-a3ba-4bd3-905c-57f87a9d949e,-34.21,debit,bank-fee,AU00000,2023-12-27T10:15:53Z
transaction,a16953b3-74c7-4d7c-83a9-8c0cb4678dc0,posted,Bookstore Purchase,-4256.02,6da53734-a3ee-40f6-ad2e-0fa0e87369a8,-4290.23,debit,cash-withdrawal,AU00000,2024-01-17T10:02:09Z
transaction,d7ca8c6e-e959-4df8-8f2a-b4032e586d0e,posted,Car Maintenance Expense,-867.65,3dec0355-ef44-4523-a376-c327495f8f1a,-5157.88,debit,cash-withdrawal,AU00000,2024-02-02T14:52:53Z
transaction,87b78386-f28e-46a9-8e12-164144f998a4,posted,Travel Agency Booking,-951.57,00bfeed9-89ce-4fb2-89f0-04c158e4bd6b,-6109.45,debit,bank-fee,AU00000,2023-10-25T00:06:34Z
transaction,88607cb5-e37f-47d7-ae20-25118b1409ad,posted,Non Hooli ATM Withdrawal Fee,-1657.46,ca316cde-f660-47a0-8bbc-1cae77dfd7fd,11284.8,debit,bank-fee,AU00000,2023-10-15T07:14:47Z
transaction,d5bc0af1-09cb-4d39-9d7e-4f61f08c6a2d,posted,Bookstore Purchase,-2689.03,7c69fd34-f19c-4cf6-bc07-fc1d7aa4b360,8595.77,debit,payment,AU00000,2023-08-07T18:34:14Z
transaction,b4ffca13-a2ec-469d-b11c-79187df6110d,posted,Uber Ride,-3526.47,7ab87ac2-035e-4b72-8dcf-88db5f5dfc25,5069.3,debit,payment,AU00000,2023-06-23T16:32:24Z
transaction,f38d0584-3073-4246-8b4b-5872ccbb19ab,posted,Netflix Subscription,-4908.95,5089f98e-b4ab-4a07-8e8f-2ccc3cdb8f65,160.35,debit,payment,AU00000,2024-01-23T19:08:00Z
transaction,f087c467-cd59-4f00-adf9-117c58164c63,posted,TRANSFER TO JOANNA SMITH CAMPING,-3945.24,b7fd1ecc-7fd2-48d2-9c1c-7d33cf531600,-3784.89,debit,payment,AU00000,2024-03-09T19:04:06Z
transaction,a56de3f2-4c27-440b-a4c6-0ed086e632e4,posted,Hair Salon Appointment,-2328.67,565fe537-751e-4694-8313-ff8efcd8cb3c,-6113.56,debit,bank-fee,AU00000,2023-08-10T11:56:37Z
transaction,9256338c-d4f6-4312-9faf-2ac04ea2ed9b,posted,Non Hooli ATM Withdrawal Fee,-4777.58,dfc4daef-ac8b-4820-8693-2cc2b460ff75,-10891.14,debit,bank-fee,AU00000,2023-08-10T12:57:47Z
transaction,295a413d-c943-4073-9dd8-c69ad28a7d3d,posted,Uber Ride,-1376.59,d0c6ac77-d021-4bee-86e6-8471ef9f9511,-12267.73,debit,payment,AU00000,2024-04-14T22:08:53Z
transaction,7065477c-879a-4feb-9706-1e8097097328,posted,Hair Salon Appointment,-1296.77,d1b4b38b-0a9f-4ade-98c2-18d61491e6f2,-13564.5,debit,payment,AU00000,2024-01-11T20:15:13Z
transaction,43b668be-bcfb-4701-81a2-42ff247cacaf,posted,CTRLINK CARERS Ref: 998R6789201610974V,-1984.26,faaf57ce-303d-4f6a-8c1f-c692c4604c95,-15548.76,debit,bank-fee,AU00000,2023-07-29T16:53:55Z
transaction,917bb505-e491-49d9-8864-5c73edf7b5f7,posted,Transfer Platnm Homeloan 346454,-1562.18,a07da136-3591-4e5c-b8b2-8ad09905dcdb,7112.89,debit,cash-withdrawal,AU00000,2024-01-23T00:23:35Z
transaction,02623d46-4aa2-4f71-8b71-c595d19fe435,posted,AGL RETAIL ENERGY LTD (GAS),-1762.93,159c1e98-660f-44c0-9b0f-0e8cbc352fab,5349.96,debit,bank-fee,AU00000,2023-09-07T11:29:47Z
transaction,46a06b31-ac71-4a06-930f-6a4eb193e3c4,posted,Transfer Platnm Homeloan 346454,-3907.34,a05d72e6-c491-43fb-911e-b707246d9820,1442.62,debit,bank-fee,AU00000,2023-12-21T00:12:16Z
transaction,937cedc2-d460-4edc-8b40-dc3a1e300e19,posted,Non Hooli ATM Withdrawal Fee,-3454.07,393fcb25-c6eb-48b3-82a4-121e22f7e686,-2011.45,debit,payment,AU00000,2024-05-05T16:12:05Z
transaction,e833dc31-1698-40f4-81db-5317358e164e,posted,Restaurant Dinner,-4272.62,e15ac9bc-d15f-4851-be05-c64bc3860966,-6284.07,debit,payment,AU00000,2023-12-20T17:45:34Z
transaction,86196996-7353-45dc-b013-f4e8fb20e87f,posted,Netflix Subscription,-3153.54,4dc1d96c-6abf-483b-b875-f95e8e863f32,-9437.61,debit,payment,AU00000,2023-09-18T19:56:40Z
transaction,4fc327eb-6035-4def-bb54-f48b6d1b1cdd,posted,Bookstore Purchase,-2347.36,19541513-9435-4ae5-916c-f61800b2c55d,-11784.97,debit,payment,AU00000,2023-09-07T22:52:52Z
transaction,4fbbdd97-368f-450b-ae72-e1c992f9c453,posted,Transfer Platnm Homeloan 346454,-335.69,8c38a090-0947-4a0b-b081-20a218d1065a,-12120.66,debit,cash-withdrawal,AU00000,2023-07-04T09:09:03Z
transaction,3008bc38-e599-4606-b5e2-876dcefe13ee,posted,CTRLINK CARERS Ref: 998R6789201610974V,-1279.91,4011aa03-4641-4051-8244-c0f7d407a05b,-13400.57,debit,bank-fee,AU00000,2023-11-29T11:10:20Z
transaction,be06f2b1-16a9-45ed-8114-0003b8ba9af8,posted,AGL RETAIL ENERGY LTD (GAS),-611.52,f7eb2b3e-4ee8-428b-9ab1-e2877365f115,-14012.09,debit,bank-fee,AU00000,2023-12-11T04:19:52Z
transaction,07dd301b-edf5-42e2-abd3-eab7e30f9104,posted,Hair Salon Appointment,-864.87,8172ddad-3795-4dde-809e-7c1d5b74b0d4,18716.17,debit,cash-withdrawal,AU00000,2023-06-15T11:46:28Z
transaction,ea564962-bcd9-4073-8729-b061f971f9ef,posted,AGL RETAIL ENERGY LTD (GAS),-452.43,e883e22f-1799-4218-b034-3b165c261cdf,18263.74,debit,cash-withdrawal,AU00000,2023-05-19T03:32:19Z
transaction,07c488f1-ccfc-4ddc-9235-881623360d80,posted,Gym Membership Fee,-410.07,41213704-5607-4b44-932f-45c7774a9656,17853.67,debit,payment,AU00000,2023-11-19T02:33:12Z
transaction,33b29305-420f-4037-86ba-ec5f14e51fbd,posted,Hair Salon Appointment,-575.45,f04d1e4a-65db-45a8-848c-61a9d7f98983,17278.22,debit,bank-fee,AU00000,2023-05-15T23:06:42Z
transaction,b199b998-037a-498d-99ac-971e6008f9a4,posted,TRANSFER TO JOANNA SMITH CAMPING,-4972.45,69abedbf-38ee-47f8-8859-8059d2fa74d4,12305.77,debit,payment,AU00000,2023-07-07T03:23:04Z
transaction,efd5899f-1216-4103-b27b-7d4417aabdc6,posted,TFR Acc14000 TO 12389,-3383.82,d049a634-79b6-41d9-91fa-6d2d8163b1c7,8921.95,debit,bank-fee,AU00000,2023-07-15T10:01:16Z
transaction,183b024d-d1bc-4369-bd10-6d30ddde9ea9,posted,Bookstore Purchase,-106.95,ab5d8250-c353-4554-8f5c-b0c8cb0bb5cd,8815.0,debit,cash-withdrawal,AU00000,2023-09-06T09:03:59Z
transaction,b5560014-7191-413e-8cbb-af1ad2e7f20e,posted,Bookstore Purchase,-4993.16,caaea6f2-3109-422d-bf8a-decbbee19677,3821.84,debit,cash-withdrawal,AU00000,2023-05-20T06:01:52Z
transaction,bf790861-1502-4ee5-8b2c-f6fcb29bcd44,posted,Bookstore Purchase,-326.44,eae0119c-19c2-4c41-82b0-5ea878c50261,3495.4,debit,cash-withdrawal,AU00000,2023-05-25T08:40:13Z
transaction,c000ae44-14f3-4626-ae3b-fc255602ccf6,posted,Clothing Store Purchase,-2162.5,eccbbd94-0119-4466-84e3-535782e9471b,1332.9,debit,bank-fee,AU00000,2024-04-30T13:38:43Z
transaction,321718b8-6483-48de-8485-90cc5a5492f1,posted,Hair Salon Appointment,-1159.04,87ee6fc3-11e6-42b2-bb62-9754adde25e5,11308.69,debit,cash-withdrawal,AU00000,2023-06-19T21:53:07Z
transaction,283ebfe1-80e1-4a96-a1eb-ee78106e5918,posted,Payroll WFRMS 15439393,10743.02,798f0a1d-1c00-42f3-9b32-631a269d5825,22051.71,credit,transfer,AU00000,2023-10-29T19:03:47Z
transaction,9666b711-b3b8-40b9-a705-926845f78288,posted,TFR Acc14000 TO 12389,-86.48,d8bbb9f5-c640-45c9-b3db-605f89e0e4a6,21965.23,debit,payment,AU00000,2023-05-27T04:11:11Z
transaction,717f55b3-7eeb-4bb1-891f-e66baf3d434a,posted,Pharmacy Purchase,-3569.41,3de2e18a-a615-4329-9db5-07b169453622,18395.82,debit,payment,AU00000,2024-01-31T14:02:40Z
transaction,2f22d008-8922-493f-8506-63dc832bec39,posted,Music Streaming Subscription,-1704.89,54a7a638-3a1e-4640-a0e7-b8e2a0808667,16690.93,debit,payment,AU00000,2024-04-18T05:50:35Z
transaction,61bbeb75-82cb-4ee8-8193-e63227c7a0eb,posted,Coffee Shop Purchase,-1412.26,6e73cdb0-885f-4b3d-a401-160e57e60028,15278.67,debit,cash-withdrawal,AU00000,2023-08-26T14:14:14Z
transaction,92fd538a-bbbc-413e-9e65-4d15308b75f9,posted,Mobile Phone Bill Payment,-3051.84,d290f071-6f9b-494d-bdb6-351eeaa5c86c,12226.83,debit,bank-fee,AU00000,2023-09-09T01:06:37Z
transaction,40637b7f-a770-4f24-a49f-0b91918f2d7a,posted,Manly Maths Tutor Wages,-1711.67,43b61bc6-c399-4fab-8380-14771bb0463c,10515.16,debit,cash-withdrawal,AU00000,2023-12-09T01:59:22Z
transaction,1dd7b341-a209-453a-a638-22fad26f3abd,posted,Restaurant Dinner,-1908.22,fe621431-309c-4253-ac2b-d22f1f81b726,8606.94,debit,bank-fee,AU00000,2024-02-28T19:23:04Z
transaction,66c04070-5d60-4dcd-a6fc-f69077d3fea7,posted,Bookstore Purchase,-2735.06,e55d2073-9275-4ff9-b72f-d5a5b82f856c,5871.88,debit,bank-fee,AU00000,2023-10-20T17:43:24Z
transaction,57d84bdb-9c0c-42c8-981d-11106e5a1943,posted,Movie Ticket Purchase,-3619.43,2c22cf3b-9080-4f7f-ac4b-5d0ef500ba2d,10457.21,debit,bank-fee,AU00000,2024-01-31T19:23:08Z
transaction,f3723936-3394-42c8-967e-f37c475ec26c,posted,Mobile Phone Bill Payment,-4423.05,32278d7a-2c5f-4d31-8f43-170ce6816aa6,6034.16,debit,cash-withdrawal,AU00000,2023-09-17T19:34:54Z
transaction,4c6df90b-4072-44f7-8405-1fbb09451d02,posted,Netflix Subscription,-4113.08,10641c79-fb42-4674-88c4-48c373fa2d5a,1921.08,debit,payment,AU00000,2024-02-04T19:44:26Z
transaction,2627588d-6e9f-4387-b15a-6d5c73b111cf,posted,TRANSFER TO JOANNA SMITH CAMPING,-274.12,ab803dda-7e52-4fda-b9af-da0ff8d16061,1646.96,debit,cash-withdrawal,AU00000,2023-10-04T04:25:54Z
transaction,4293c446-737f-4219-8dd0-c2a254d6fc9a,posted,TRANSFER TO JOANNA SMITH CAMPING,-1725.83,5419ca82-d5ec-4f5a-81d6-0fd71bcbace5,-78.87,debit,cash-withdrawal,AU00000,2024-01-08T08:12:02Z
transaction,0ce56056-65c0-4b01-8d35-cfda40b6f5d0,posted,Restaurant Dinner,-3481.59,eeea2f61-115a-4bea-bc03-7898651bdf50,-3560.46,debit,payment,AU00000,2024-03-05T10:56:01Z
transaction,0cd8c392-53a1-4cd2-a2c8-c729c0ac585e,posted,Clothing Store Purchase,-1864.43,02043d71-97f9-42ef-acc9-95e8b32e5ac8,-5424.89,debit,payment,AU00000,2024-01-07T10:42:47Z
transaction,cb9ea58d-24d2-4f4c-ad24-e6430874b391,posted,AGL RETAIL ENERGY LTD (GAS),-3802.13,0fd920ed-2de6-47f4-ad22-6e5fd7023b3a,-9227.02,debit,payment,AU00000,2024-01-17T17:10:33Z
transaction,936a6d73-890e-4e89-8edb-92c917d9ca0e,posted,TFR Acc14000 TO 12389,-4679.49,bf220bdc-fa45-434f-8ae0-3e126d4ce002,-13906.51,debit,payment,AU00000,2023-12-31T16:25:32Z
transaction,a410532d-ed90-4594-922e-fa3de75100e8,posted,Hair Salon Appointment,-666.19,6c5ce4d6-3961-4bd2-a6d1-cb88c51901a7,-14572.7,debit,payment,AU00000,2023-08-09T10:59:27Z
transaction,bcef10e0-5241-44be-978f-64e6f0ff7ca3,posted,Car Maintenance Expense,-4623.3,c8b47257-45d2-4470-be7a-dd7e51d24969,11212.34,debit,payment,AU00000,2024-04-17T18:51:35Z
transaction,bf20d63b-d4dd-4ff0-9504-00399312900b,posted,Amazon Online Shopping,-2834.31,18bb0980-6c76-4397-bc50-43993cc4658a,8378.03,debit,payment,AU00000,2023-11-06T12:40:40Z
transaction,91ed9cb4-b32f-4c67-a7c4-49a316dc34f0,posted,Manly Maths Tutor Wages,-1696.17,9ddfade9-5614-4e1a-a794-655427df2530,6681.86,debit,cash-withdrawal,AU00000,2023-12-05T05:22:50Z
transaction,d8daa3c1-6009-40b4-9959-58d5a0904b41,posted,Uber Ride,-691.83,094ba21d-b0ed-4558-a720-3078c44d9a0f,5990.03,debit,cash-withdrawal,AU00000,2024-02-14T23:01:33Z
transaction,cb4c913d-8de1-4b9f-85bb-1162bb75e855,posted,TFR Acc14000 TO 12389,-2883.15,19081924-c9fb-40f8-8092-5edb0efed2bb,3106.88,debit,payment,AU00000,2024-03-23T17:31:11Z
transaction,d531a6a7-742b-4100-8cf7-38ab451fac06,posted,Gym Membership Fee,-226.03,ad8c491a-520b-4946-8781-e038336b083d,2880.85,debit,bank-fee,AU00000,2024-03-25T09:16:29Z
transaction,bdf4830b-a389-42f2-8f68-104dcb5322f2,posted,Wdl ATM WESTPAC IGA BALGOWLAH BALGOWL AU,-2452.11,0db01206-74f2-42ae-8162-3311cb254c73,428.74,debit,bank-fee,AU00000,2023-09-14T03:58:01Z
transaction,14ca0b02-0cb6-4862-bda1-e27232adb426,posted,Home Improvement Store Purchase,-2951.56,e8698fda-4b2d-4023-995f-4749a789e73c,-2522.82,debit,payment,AU00000,2024-03-28T09:47:20Z
transaction,f9442510-f1bb-4779-a570-5f46e80e4c64,posted,Electricity Bill Payment,-735.96,fc2a8c38-0075-4339-b13d-fa72a9db58d1,-3258.78,debit,cash-withdrawal,AU00000,2023-08-02T17:22:13Z
transaction,b026f122-f1f5-4a82-8e0c-83657f601a3d,posted,Movie Ticket Purchase,-3958.77,597a7b2d-5d87-4249-819f-bfcd9b56b78c,-7217.55,debit,payment,AU00000,2024-03-28T11:56:16Z
transaction,0bea225d-3b91-43ec-b9c1-c7bb6b8e1a06,posted,CTRLINK CARERS Ref: 998R6789201610974V,-1872.72,03c5d28d-70ac-4b34-8fe0-645a325a4c42,9283.38,debit,payment,AU00000,2023-10-29T06:56:06Z
transaction,f60fda66-5680-4f05-9496-a25703e3fe11,posted,Coffee Shop Purchase,-240.94,1799d6bc-a3b2-427f-96cf-68c252ca89e9,9042.44,debit,payment,AU00000,2023-08-07T01:16:00Z
transaction,340c4a5b-cf3e-4133-abb5-cc9a69ec75a1,posted,Transfer Platnm Homeloan 346454,-1235.04,0a8b02b0-cd9f-47d5-b2b2-b960e56739cf,7807.4,debit,payment,AU00000,2023-07-08T16:17:20Z
transaction,805a4b50-38d2-405d-953c-03079946a8e4,posted,Movie Ticket Purchase,-4441.83,b6e7a21b-250a-4ce8-a8cb-2ae228ec978e,3365.57,debit,bank-fee,AU00000,2023-11-02T12:15:24Z
transaction,34f81d6d-d5a2-4689-8df9-df3505cd7ed5,posted,Wdl ATM WESTPAC IGA BALGOWLAH BALGOWL AU,-2237.08,9c2b86c6-6984-4bc5-b35b-87e2b2496e0a,1128.49,debit,bank-fee,AU00000,2024-05-10T11:41:18Z
transaction,e15fffbb-3a52-4a6a-9493-6b7e404c7386,posted,Hair Salon Appointment,-2390.59,2f5eff2c-eee5-4b52-97f1-cfe8a3b08728,-1262.1,debit,payment,AU00000,2024-05-04T19:23:03Z
transaction,901e620f-0471-41c4-af88-5b5cddc7564f,posted,Online Gaming Purchase,-329.05,ffd4855d-c19b-436e-8382-6dba22946e7e,-1591.15,debit,cash-withdrawal,AU00000,2024-01-03T14:42:49Z
transaction,298d5057-3a82-45e0-b601-41f713479f1d,posted,Gasoline Purchase,-1968.14,f6facc8e-1f71-43a6-a2f7-6001b3b096c3,-3559.29,debit,cash-withdrawal,AU00000,2023-12-26T15:23:58Z
transaction,e777a23b-8274-4551-9cc1-05043f1b459d,posted,Clothing Store Purchase,-3005.18,cf77f7b4-c6f2-4cb1-844c-6e4028cbb3c4,-6564.47,debit,cash-withdrawal,AU00000,2023-08-24T12:33:36Z
transaction,412217af-91d0-4148-bbbd-5ce0a6c197a3,posted,Manly Maths Tutor Wages,-1560.72,4ab5fe67-0bb6-4a7b-aa69-1ce3fa06370d,-8125.19,debit,payment,AU00000,2023-08-31T00:13:25Z
transaction,c94b369f-74b8-42a2-9f34-88c344fe33ac,posted,Public Transport Fare,-2018.3,3fccb15a-12bc-4e2b-ae1b-0df4ef585ec3,16565.15,debit,bank-fee,AU00000,2023-07-09T04:21:07Z
transaction,a9e8f23f-6dc3-42b2-ae0c-a609ff95c717,posted,Uber Ride,-2551.61,249f8d4f-91b8-4b66-92ec-9688771ecc0e,14013.54,debit,payment,AU00000,2024-05-04T19:05:08Z
transaction,dd7d1fbf-dcc0-4b53-80e5-a58a655efb49,posted,Electricity Bill Payment,-2619.72,ea070ff2-6335-4110-90e9-ee90e4a59e2d,11393.82,debit,cash-withdrawal,AU00000,2023-09-24T17:24:41Z
transaction,cc93feed-e6ed-4612-8f6b-2d51fe8c5969,posted,Hair Salon Appointment,-3571.3,299ef158-8f12-4879-918c-b67f7fc61280,7822.52,debit,cash-withdrawal,AU00000,2024-01-30T12:04:48Z
transaction,c3ffcd71-edde-4ed9-a033-9d29f39a314f,posted,Clothing Store Purchase,-819.15,9af40418-9ae7-4833-8ec8-d26309a9eee7,7003.37,debit,bank-fee,AU00000,2023-11-06T06:51:34Z
transaction,e9538f74-e9ed-41aa-92f6-0c92b2d9185b,posted,Pharmacy Purchase,-43.26,f0b757f3-f66b-4bfa-b3cd-f35992c75af4,6960.11,debit,cash-withdrawal,AU00000,2024-04-12T21:22:06Z
transaction,625754d1-0fec-4d42-94ff-4ca5175e6646,posted,Clothing Store Purchase,-1465.89,728a3dfc-4796-4cb0-8b7c-7597fffeff71,5494.22,debit,bank-fee,AU00000,2023-06-25T14:34:15Z
transaction,208a199c-29bf-44a0-a547-2cf1ab6b9684,posted,Gasoline Purchase,-1248.86,7599c5dd-4137-4bbc-94d0-b02719b74c9d,4245.36,debit,cash-withdrawal,AU00000,2023-07-22T03:40:13Z
transaction,0d56c484-481c-43c1-9165-8f176ae62e77,posted,CTRLINK CARERS Ref: 998R6789201610974V,-721.18,ff0b72a8-54fd-4210-b299-ac4538680fc2,3524.18,debit,payment,AU00000,2023-06-14T23:34:51Z
transaction,c01a1cd4-8133-42ae-b256-ed1bdf7e2317,posted,Amazon Online Shopping,-4300.48,b8d959bc-aa15-47bd-a7c9-44b2e9b34e63,-776.3,debit,payment,AU00000,2023-06-22T11:53:43Z
transaction,06523350-53a2-46b6-9a78-a98f1fcfcc54,posted,Amazon Online Shopping,-4840.4,e4321550-ab3c-4b6e-a877-bd0aaa586ffd,5219.46,debit,cash-withdrawal,AU00000,2023-11-18T02:39:41Z
transaction,71624527-df08-45a3-bfcb-0b427c8ec62b,posted,Clothing Store Purchase,-4322.15,618ad024-51c1-4423-95cf-45b9d9f97e9d,897.31,debit,payment,AU00000,2023-10-20T21:11:07Z
transaction,12b75933-f5a4-4e45-9c44-458bff8ea701,posted,Netflix Subscription,-1094.81,466930b3-8a9b-44d2-86fa-da14cc03c295,-197.5,debit,cash-withdrawal,AU00000,2023-12-29T01:29:46Z
transaction,bd84a90f-b122-482f-92b0-41489ab58bb3,posted,Wdl ATM WESTPAC IGA BALGOWLAH BALGOWL AU,-4653.86,e410f4c7-3ffb-4fdb-8d84-f4f6332ce650,-4851.36,debit,bank-fee,AU00000,2024-04-24T20:12:19Z
transaction,6998e3d5-b052-4f67-863f-eca637c40ab9,posted,Car Maintenance Expense,-1233.84,36c91b70-9eb7-4468-9a18-a399b28b38a0,-6085.2,debit,payment,AU00000,2024-04-08T12:35:26Z
transaction,7b79fa1d-cea4-43c9-8e15-749ee0943028,posted,Non Hooli ATM Withdrawal Fee,-3224.7,38d00546-762f-47c4-8a5b-4fc02658cd12,-9309.9,debit,cash-withdrawal,AU00000,2023-08-02T09:50:11Z
transaction,94b6f6ee-c5a5-45dc-b206-ec8a7fa9f8c5,posted,Non Hooli ATM Withdrawal Fee,-1374.57,8cec259a-5bc7-4981-a05b-0768912f58e5,-10684.47,debit,cash-withdrawal,AU00000,2024-04-04T10:45:21Z
transaction,67635d94-19a1-48e8-b406-778c8ed39eed,posted,Wdl ATM WESTPAC IGA BALGOWLAH BALGOWL AU,-1585.93,2e27ff54-cdaf-4239-ac81-55a4f66f9506,-12270.4,debit,payment,AU00000,2023-12-03T04:07:22Z
transaction,f7fa73ac-cb02-4d1c-bea6-1646305f4fe1,posted,AGL RETAIL ENERGY LTD (GAS),-1198.9,cf787088-9b7e-41eb-a1b7-255b37231ead,-13469.3,debit,cash-withdrawal,AU00000,2023-11-09T06:05:16Z
transaction,7b961757-04b4-4156-bf09-87810f7f357a,posted,Restaurant Dinner,-135.6,141676f2-3667-40e3-abd7-db50cfc872f1,-13604.9,debit,payment,AU00000,2023-06-16T11:43:30Z
transaction,35df21d4-bbd6-4773-bdc4-1b79e4ffea6c,posted,Amazon Online Shopping,-3371.5,67662503-0c3e-4a92-b434-42b561e92b99,7861.77,debit,bank-fee,AU00000,2024-03-10T12:41:39Z
transaction,beeafcae-77dc-42c0-9e0c-e363cbd42752,posted,TRANSFER TO JOANNA SMITH CAMPING,-2577.79,93ef8e1b-b249-4635-85d5-ee4379c58f8b,5283.98,debit,bank-fee,AU00000,2023-07-07T14:18:31Z
transaction,0e3509f7-a02d-40d7-bb16-6748c0a6b77a,posted,Online Gaming Purchase,-4646.74,8dbcda0a-7923-4c98-a66c-ae41a6dd438f,637.24,debit,cash-withdrawal,AU00000,2023-06-07T12:22:53Z
transaction,b440e66c-390f-4b9a-bff4-514ead62034e,posted,Home Improvement Store Purchase,-4421.01,67669ea8-1ef5-4f2e-a47c-ce4d667ebf78,-3783.77,debit,bank-fee,AU00000,2023-11-08T02:33:56Z
transaction,5569a130-9b4b-46dd-96c4-ab6f59c4febc,posted,Wdl ATM WESTPAC IGA BALGOWLAH BALGOWL AU,-3866.63,338dd8ad-f068-46d3-99c7-f1564cf66778,-7650.4,debit,payment,AU00000,2023-10-19T12:30:46Z
transaction,7be8fd45-91f5-440d-8dcb-eeeb780cc9d8,posted,Netflix Subscription,-2063.35,49963be1-f02c-493e-b378-8947df63fe11,-9713.75,debit,payment,AU00000,2023-08-23T06:41:16Z
transaction,17468257-6540-4d1a-9a37-d828066b5c06,posted,Non Hooli ATM Withdrawal Fee,-1124.31,aad889f4-6ee2-483c-9ce6-65e3b3db2a5b,-10838.06,debit,payment,AU00000,2023-09-26T18:23:53Z
transaction,98b60a9b-00b0-4596-8495-089a9406a98e,posted,CTRLINK CARERS Ref: 998R6789201610974V,-984.37,bc9f5141-5da9-4dff-b9a4-43d96941a22f,-11822.43,debit,bank-fee,AU00000,2023-11-20T07:16:45Z
transaction,5758aa44-c836-408e-915a-8b50a7356868,posted,Home Improvement Store Purchase,-2816.98,286dd5a0-8f28-4c80-9e7e-6e87f3cc8373,-14639.41,debit,payment,AU00000,2023-11-03T03:40:18Z
transaction,90e5be0e-8f1f-4d5b-9f00-4e48e9ca4a0b,posted,Car Maintenance Expense,-4496.28,0bd25424-3628-4e46-b9a5-fc04edb7bf97,-19135.69,debit,cash-withdrawal,AU00000,2023-07-25T06:49:20Z
transaction,4d9b39ca-ea60-4ac9-90cc-81b9e7e919bc,posted,Restaurant Dinner,-3118.26,79ea34cc-9baf-49ab-9a7e-584631fc3a3d,8773.53,debit,bank-fee,AU00000,2024-02-29T17:29:30Z
transaction,5607b550-e9d9-400a-9405-cb425b872f95,posted,Bookstore Purchase,-58.87,4c3f27f6-5b03-4edb-b457-202486df4622,8714.66,debit,cash-withdrawal,AU00000,2023-08-05T16:30:27Z
transaction,be7b390b-5e99-4840-8eb6-5ccea0b81df2,posted,Bookstore Purchase,-4569.86,5f3d63ac-f2dc-4f77-a6ac-bcd6c56e96b0,4144.8,debit,bank-fee,AU00000,2023-06-11T18:35:22Z
transaction,450d6838-274b-4693-ba71-f90d6676d460,posted,Bookstore Purchase,-1563.81,02322e9d-294e-4118-b188-2c18157c143f,2580.99,debit,bank-fee,AU00000,2024-04-25T07:30:13Z
transaction,ade671a4-9bb6-49cf-9735-400a45a2c07d,posted,Restaurant Dinner,-1454.35,93bc3baa-a4d0-448b-9d7d-1d60211b8457,1126.64,debit,payment,AU00000,2023-06-02T16:31:19Z
transaction,5ea2c0e6-a16a-4c79-84bf-f42bfe483a5a,posted,Uber Ride,-3547.46,2ae855e0-dffd-42c7-9fa4-6ccc9cc872ee,-2420.82,debit,cash-withdrawal,AU00000,2023-08-13T16:04:20Z
transaction,82b8bbbe-81fe-4d27-83bc-7eef7bd2e9e0,posted,Public Transport Fare,-887.99,c318a0cd-20e0-4342-a8fb-932b6bd0308f,-3308.81,debit,bank-fee,AU00000,2023-06-10T01:22:50Z
transaction,74983592-782c-4830-9317-c3eb67a91848,posted,TRANSFER TO JOANNA SMITH CAMPING,-3639.29,3c05d189-c98e-49f6-96d2-7c2496b03591,-6948.1,debit,bank-fee,AU00000,2024-04-18T11:14:04Z
transaction,aa220880-1834-4ebf-a45b-88fed324f260,posted,Online Gaming Purchase,-1728.65,c37b29e1-d55b-4ea7-8966-d0127f970e35,-8676.75,debit,cash-withdrawal,AU00000,2023-07-10T22:03:31Z
transaction,651b2542-72c1-478c-8bf9-3a62fa633c55,posted,CTRLINK CARERS Ref: 998R6789201610974V,-4230.56,ad0a20bc-da5f-400a-ba83-9cb608548989,-12907.31,debit,cash-withdrawal,AU00000,2023-12-04T17:04:14Z
transaction,32d0f365-9a30-424f-bad8-e2611b9c276f,posted,Manly Maths Tutor Wages,-4957.98,567e85ac-5315-405a-91f4-3ea256720f10,10984.2,debit,bank-fee,AU00000,2024-04-24T06:17:11Z
transaction,2d0ac2c3-f840-4933-847d-1d3169f0c3e6,posted,Payroll WFRMS 15439393,10474.61,dbda8627-c612-4d41-a669-145867c2971b,21458.81,credit,transfer,AU00000,2024-05-01T05:43:32Z
transaction,58397037-e82f-401a-b87f-a1b136c3597a,posted,CTRLINK CARERS Ref: 998R6789201610974V,-3079.04,95fc50d6-9c26-451d-be39-3e2882c5cffe,18379.77,debit,cash-withdrawal,AU00000,2023-07-09T22:51:23Z
transaction,febf5c54-ab3a-4b31-a3e7-1f6d088928f1,posted,Netflix Subscription,-3492.45,bdccd1d9-ecd1-48b8-87e1-5c597942d970,14887.32,debit,bank-fee,AU00000,2023-07-03T20:19:22Z
transaction,24c71801-7d2b-4be7-a56a-09a714402187,posted,Non Hooli ATM Withdrawal Fee,-4556.9,90e0e6ae-1b6e-4e2e-b245-df6bb98ee72c,10330.42,debit,payment,AU00000,2023-07-14T11:57:13Z
transaction,409bcd1e-dd67-4e25-a6fe-ce6221a08319,posted,Uber Ride,-4178.73,565f1434-70cb-4446-adf2-fb84dd90e734,6151.69,debit,cash-withdrawal,AU00000,2023-06-11T11:36:23Z
transaction,6c2c2538-ae64-4256-82e7-70c283ddb5c7,posted,Wdl ATM WESTPAC IGA BALGOWLAH BALGOWL AU,-2140.3,1b859a8d-ce22-4dfa-a5bb-6d6cfdf581ee,4011.39,debit,cash-withdrawal,AU00000,2023-07-08T10:02:59Z
transaction,c3c035a0-0c96-4c99-a1e1-01cf4373adc9,posted,Payroll WFRMS 15439393,11834.85,e81cddad-64ab-40b6-8b32-b97492f6d03c,15846.24,credit,transfer,AU00000,2024-05-10T08:11:54Z
transaction,101c7b38-8f1e-4cc8-a94a-58bfb067df34,posted,Clothing Store Purchase,-1909.38,bb0a8ca0-6ccc-4f46-9d15-5c1d44c0ad81,13936.86,debit,cash-withdrawal,AU00000,2024-04-23T18:45:00Z
transaction,b4311a7c-6ce5-42f1-a558-d469d9d571c1,posted,Online Gaming Purchase,-3951.56,f80361bc-e189-490b-8fa6-e0ca58e408bf,9985.3,debit,bank-fee,AU00000,2024-02-06T09:17:02Z
transaction,c12eddbf-eb29-4373-bcbb-fdabbdb4372f,posted,Coffee Shop Purchase,-4665.98,633c817a-ef24-44a6-b27f-a9f6f9ef0803,12854.62,debit,cash-withdrawal,AU00000,2023-08-07T10:36:32Z
transaction,b79a274f-6253-4bcd-ae86-ec7b63670825,posted,TFR Acc14000 TO 12389,-2724.5,2fc3e148-da38-4d47-ac0c-c5836e1de103,10130.12,debit,payment,AU00000,2023-11-20T11:17:39Z
transaction,0f54fd48-baa9-402f-b188-95a5ac56667f,posted,Coffee Shop Purchase,-4506.75,5e8181aa-f5f3-4cda-b3a8-daf256b483d0,5623.37,debit,payment,AU00000,2023-07-18T23:55:51Z
transaction,b5b5fd89-81d5-43d1-b24f-65b70377581c,posted,Pharmacy Purchase,-970.99,95681390-d44d-4e26-99b8-4bc18dded775,4652.38,debit,payment,AU00000,2024-04-21T17:47:31Z
transaction,e037db88-07b0-4027-b1b8-3ff108f11035,posted,Public Transport Fare,-1549.79,2712fa01-010a-4d81-8659-24e32263dd98,3102.59,debit,payment,AU00000,2023-06-12T21:52:28Z
transaction,ce97c978-96c9-4247-b171-42768497d913,posted,Coffee Shop Purchase,-4744.61,e8f105a0-6386-41f1-889c-82b0e82e1dbe,-1642.02,debit,cash-withdrawal,AU00000,2023-05-22T16:07:49Z
transaction,3580b248-970e-478d-88c0-2222f0b9ff88,posted,TRANSFER TO JOANNA SMITH CAMPING,-3781.12,b45d8269-d82f-4450-a241-b7f2361480bf,-5423.14,debit,bank-fee,AU00000,2023-05-22T11:35:57Z
transaction,7dec03a7-cb18-469e-a911-5cec68a9d8a4,posted,Non Hooli ATM Withdrawal Fee,-33.99,2dcbfdc2-98a6-4a0f-8c5a-2da90752e39a,-5457.13,debit,payment,AU00000,2023-06-30T14:34:12Z
transaction,85ebdfb2-7462-45e9-b49c-ce46d0d2f234,posted,Clothing Store Purchase,-1306.29,addfb086-0edc-47c8-8e30-f10a81e43cc7,-6763.42,debit,bank-fee,AU00000,2024-04-10T01:00:02Z
transaction,6cc22e3b-df86-45f7-8b99-aa078a95d0b1,posted,Netflix Subscription,-1388.43,059b80b2-17ba-43d9-87e7-09347efc27ea,-8151.85,debit,payment,AU00000,2024-03-01T07:25:46Z
transaction,4ec99aab-23fa-4dcf-9798-2f564c997bf7,posted,Coffee Shop Purchase,-2827.56,f122ea93-762e-496e-87bd-1fc3ff48085f,5070.91,debit,payment,AU00000,2023-10-02T07:25:39Z
transaction,6196f88f-198b-42eb-951c-dcd99554550c,posted,Coffee Shop Purchase,-3814.87,0d7a2e6a-4c6c-4512-a954-593b75c5fed7,1256.04,debit,bank-fee,AU00000,2024-02-28T13:13:35Z
transaction,fe0bdab0-08a9-40a4-aa00-cd4b263d806c,posted,Music Streaming Subscription,-1661.35,1b70ff09-3fc2-40f8-af1c-28a3f6a8981b,-405.31,debit,cash-withdrawal,AU00000,2023-09-18T03:46:29Z
transaction,6c17ac74-ec90-4b27-8812-1bd450d930af,posted,Wdl ATM WESTPAC IGA BALGOWLAH BALGOWL AU,-145.35,731341f9-30e9-4aee-8755-4d2558f88007,-550.66,debit,cash-withdrawal,AU00000,2023-06-30T06:07:59Z
transaction,f36f8901-76af-4acb-8260-2d693c6e3972,posted,Amazon Online Shopping,-3250.44,1138f8bb-dccd-4566-8cf3-bdab2773fa7b,-3801.1,debit,bank-fee,AU00000,2024-03-25T13:33:45Z
transaction,7a6f70a6-a4e0-4f7c-886a-89b88cd8f164,posted,Car Maintenance Expense,-4797.43,a867e29e-bed3-4e5b-9a9a-a61cc21a7407,-8598.53,debit,payment,AU00000,2024-04-14T04:13:39Z
transaction,c8de20b9-c215-4592-806a-01d6c33812fa,posted,Restaurant Dinner,-579.24,7c0ff192-ac4e-4b7d-852c-e8f62476c4fe,-9177.77,debit,bank-fee,AU00000,2023-12-18T10:17:52Z
transaction,a5682df5-ff04-4ab2-aae6-7dcb2d06a650,posted,Manly Maths Tutor Wages,-90.38,2ee4e94b-8c13-4842-ab57-abb2b5dc4bd4,-9268.15,debit,payment,AU00000,2024-03-06T09:15:57Z
transaction,683def23-b33e-4d98-a274-d79fbebfa5b1,posted,Electricity Bill Payment,-3078.17,006f6f9b-e68c-4b57-b9a3-84959e215ee3,-12346.32,debit,cash-withdrawal,AU00000,2024-01-10T00:33:01Z
transaction,b4f7db06-d6b5-4e9d-9ce3-104d2fc2f9a7,posted,TRANSFER TO JOANNA SMITH CAMPING,-4222.96,2b3947ef-50aa-40b9-b434-64334239508c,-16569.28,debit,payment,AU00000,2023-11-17T06:38:00Z
transaction,996066a2-9fbb-429e-9c4c-fae71d24ef3a,posted,Clothing Store Purchase,-940.01,8e380fe9-d7b1-4ebc-a0d5-c3627efbaeb6,11023.54,debit,cash-withdrawal,AU00000,2024-03-29T16:06:34Z
transaction,7315cacc-d3f2-42e6-9257-b76f7e6c729d,posted,Bookstore Purchase,-3936.89,cad4ba4b-5c59-4b06-8676-36aae735efb7,7086.65,debit,bank-fee,AU00000,2023-05-29T11:45:16Z
transaction,52254f77-6821-474f-a832-86fa2f8d14c7,posted,Movie Ticket Purchase,-1483.96,7bf1ff61-d5c3-4821-891b-4d993806c064,5602.69,debit,bank-fee,AU00000,2023-09-19T04:54:02Z
transaction,741e49da-4944-462a-a58d-7b7b8658585e,posted,Hair Salon Appointment,-2805.55,33b6c449-a837-4bde-9478-13d508d317c5,2797.14,debit,cash-withdrawal,AU00000,2023-11-07T11:11:25Z
transaction,047ac335-ef9f-49cb-99e6-54a194952e1c,posted,TRANSFER TO JOANNA SMITH CAMPING,-2575.26,353bf014-85dd-418a-8933-16cbab7f39f3,221.88,debit,cash-withdrawal,AU00000,2023-09-23T14:12:36Z
transaction,c0a7077e-1f4b-44b8-abf3-6616d37525a9,posted,Online Gaming Purchase,-2678.98,42e7e907-ab7c-4727-9466-24870f5325a7,-2457.1,debit,bank-fee,AU00000,2024-05-10T20:52:38Z
transaction,53f46d80-c45d-4805-8aff-1f9aa5435e0a,posted,Coffee Shop Purchase,-4937.82,b1391885-892c-460f-af54-44091fcee8b6,-7394.92,debit,bank-fee,AU00000,2023-05-13T23:41:55Z
transaction,1de3711a-3ee9-47a7-984e-e58efd4e7da0,posted,Movie Ticket Purchase,-3161.97,87536d56-a71c-46c6-95dd-a928ac77562e,-10556.89,debit,bank-fee,AU00000,2023-11-02T13:45:30Z
transaction,a5c418ef-1c1f-4172-9af4-181e51f2133c,posted,Gym Membership Fee,-3037.29,22a18d04-eb04-4b0a-8a4e-c6a07a433717,-13594.18,debit,bank-fee,AU00000,2024-04-09T02:01:47Z
transaction,bc18e856-a874-4f56-ab0a-5383fbedfcb0,posted,Uber Ride,-3961.67,fc28255f-2934-4fb3-914b-cf5eb3ee8f8f,-17555.85,debit,cash-withdrawal,AU00000,2023-09-30T09:09:30Z
transaction,3742f764-8993-455e-84d5-57c3df2d8aa9,posted,TFR Acc14000 TO 12389,-4890.93,15785c93-4177-4a7f-9523-517832ad00f0,11098.46,debit,cash-withdrawal,AU00000,2023-07-14T05:30:45Z
transaction,db44569b-d3d4-4374-a83f-8d69be4e57ca,posted,Amazon Online Shopping,-2471.81,16051ee4-cc71-4ada-9a7e-eafd02329f6d,8626.65,debit,bank-fee,AU00000,2024-05-08T05:58:30Z
transaction,95da1692-32ca-42fd-86ee-2436d4a92cd7,posted,Movie Ticket Purchase,-507.4,936a0b33-cfe8-46ff-a9d9-b1226532e6cc,8119.25,debit,cash-withdrawal,AU00000,2023-07-06T22:25:52Z
transaction,86f362b8-a16e-4d28-b987-e25e53e93a91,posted,Online Gaming Purchase,-2628.49,86d6ae44-450d-496d-b07c-65ac7947af89,5490.76,debit,bank-fee,AU00000,2023-10-27T18:49:16Z
transaction,475fe53f-0547-4c90-9729-84ead51e14d3,posted,Music Streaming Subscription,-3720.6,ebb3afdd-6ccb-4c52-a8f6-fd1346812583,1770.16,debit,payment,AU00000,2024-04-06T08:37:38Z
transaction,b6783d09-00bf-4b96-9840-58ee9c49eff9,posted,Home Improvement Store Purchase,-4172.45,acd5bdbb-0b1f-40db-8335-b95dc7650c64,-2402.29,debit,bank-fee,AU00000,2024-02-28T01:59:22Z
transaction,b1503015-92da-4962-bad5-c40d8d78f39c,posted,Coffee Shop Purchase,-220.0,12b0b8fe-f518-47a2-b813-4f6bc79a3b1c,-2622.29,debit,cash-withdrawal,AU00000,2023-11-25T09:09:00Z
transaction,c4168ced-b75a-43ec-82d6-b740462287cc,posted,Wdl ATM WESTPAC IGA BALGOWLAH BALGOWL AU,-3322.05,7a4c5e3d-c6e7-441e-bbaf-825f88c5572e,-5944.34,debit,payment,AU00000,2023-07-27T18:39:29Z
transaction,095dbefe-b910-47b9-99c2-8724401dee13,posted,Wdl ATM WESTPAC IGA BALGOWLAH BALGOWL AU,-503.31,c6a02756-2bfd-4155-9e76-b86a10117eef,-6447.65,debit,payment,AU00000,2023-10-26T15:33:30Z
transaction,62089553-bc91-4688-8a7d-391832efd7b7,posted,TFR Acc14000 TO 12389,-4332.12,2102e2ad-611e-43a0-a825-1c5a7e6e1367,-10779.77,debit,cash-withdrawal,AU00000,2023-12-06T17:09:36Z
transaction,da030abc-d1f0-49b2-aea1-421038aa02f8,posted,Bookstore Purchase,-466.9,842b972b-ec49-4440-9ac2-45b9d1bfa692,13353.79,debit,cash-withdrawal,AU00000,2023-11-29T17:54:48Z
transaction,1cc7a15b-1952-488a-8cf5-c9a89a610fc0,posted,Gym Membership Fee,-3845.3,fa826135-8e4f-411c-a0f0-574aa958749e,9508.49,debit,bank-fee,AU00000,2024-01-15T06:22:01Z
transaction,71fad955-2623-4f8f-bea9-09c6a8e4eb53,posted,Non Hooli ATM Withdrawal Fee,-1119.77,13a84306-627c-4529-ae1d-1bf4aca13030,8388.72,debit,bank-fee,AU00000,2023-11-10T14:49:02Z
transaction,a0a79421-a8bc-43cc-8803-49f4a21f4480,posted,Public Transport Fare,-88.86,e55b6f48-d737-4a72-9078-806980ac4518,8299.86,debit,cash-withdrawal,AU00000,2024-04-30T22:37:31Z
transaction,116ef540-69a2-4908-a168-4459a26783d2,posted,Electricity Bill Payment,-2868.23,fe5c6715-1060-4690-b53d-03e038f6a071,5431.63,debit,payment,AU00000,2023-12-02T17:39:27Z
transaction,85f97f47-3f8c-40f3-91f4-4f322cb2fca7,posted,Uber Ride,-992.95,349a68a8-1c6f-4b87-a8fc-3946c38564d2,4438.68,debit,cash-withdrawal,AU00000,2024-01-26T20:46:28Z
transaction,1e41fad8-c166-42fd-9a84-4ee6dd8965e8,posted,Manly Maths Tutor Wages,-2038.33,43b12ff6-78d6-4858-adc4-550a39a1f656,2400.35,debit,bank-fee,AU00000,2024-02-27T10:00:36Z
transaction,2c766ff7-8254-47d9-ace0-84f05fa15696,posted,Travel Agency Booking,-1196.49,2d6ad0b8-e2f5-4c6f-ad6b-a510c2bc24c7,1203.86,debit,payment,AU00000,2023-11-17T00:45:27Z
transaction,be913774-4888-429c-a7e0-e41eed1ba816,posted,Manly Maths Tutor Wages,-4343.72,cf40e670-0f47-4974-9a06-fb87cb3a9a83,-3139.86,debit,payment,AU00000,2024-01-04T19:05:09Z
transaction,fb3248c7-2aab-420a-99eb-13a7a8014309,posted,Manly Maths Tutor Wages,-2311.11,45c16c35-79b2-4bdc-a7ff-10df8be045db,-5450.97,debit,cash-withdrawal,AU00000,2023-07-19T19:13:33Z
transaction,4fe141b4-2378-4d54-aca5-f667efee38a8,posted,Amazon Online Shopping,-1807.34,542b2950-1416-4abc-b254-e6c5d994e809,17472.65,debit,bank-fee,AU00000,2023-09-03T14:41:10Z
transaction,023f6560-ba55-4559-ba29-adb2edad7324,posted,TFR Acc14000 TO 12389,-3563.66,721be848-8c59-4527-a5a7-4fe213f63776,13908.99,debit,payment,AU00000,2024-01-17T20:43:48Z
transaction,5f03e854-e3eb-4142-9f98-ebe9a51a4d30,posted,Non Hooli ATM Withdrawal Fee,-3000.72,ae311520-6ddc-404e-8980-027852560887,10908.27,debit,cash-withdrawal,AU00000,2023-12-25T19:41:04Z
transaction,37acd24b-679a-4d81-8df7-d3d96af34811,posted,Travel Agency Booking,-425.99,c0c0a498-a32c-4451-a239-ab633f0d3364,10482.28,debit,bank-fee,AU00000,2023-06-17T02:19:58Z
transaction,0d6b6412-16ad-4ff0-8024-bbf67fcda25a,posted,Gasoline Purchase,-1205.51,5e7875db-5ce1-4b7f-bbce-a239941ce91f,9276.77,debit,cash-withdrawal,AU00000,2023-07-08T16:22:09Z
transaction,d554b07f-fca2-48e1-8e85-c838d160c270,posted,Movie Ticket Purchase,-4652.29,9a34f9a9-bdae-44cd-ab84-fbd1e71a73dd,4624.48,debit,cash-withdrawal,AU00000,2024-03-28T12:45:55Z
transaction,6aac1ff9-38c2-4eb3-8ffb-f38c61a033b8,posted,Music Streaming Subscription,-3155.75,f107e139-dfa8-4965-bd7b-804bd8e09a76,1468.73,debit,bank-fee,AU00000,2023-11-28T21:28:32Z
transaction,6f360964-fb53-462a-9b0a-af6dfd1d00f9,posted,Gym Membership Fee,-840.39,4027af2d-1685-438c-a213-4c9e7babb768,628.34,debit,payment,AU00000,2024-01-22T21:56:22Z
transaction,7b95b652-0860-4851-8ec5-79eb7f521edc,posted,Hair Salon Appointment,-1130.76,5a24e07f-24a3-4ce8-af4e-58410c10f2e6,-502.42,debit,payment,AU00000,2023-12-20T18:50:32Z
transaction,a7873f1f-8c62-4757-ab21-62b306cf1d66,posted,Payroll WFRMS 15439393,11543.88,d931315c-8a8e-4ed0-9141-1de9aed93532,11041.46,credit,transfer,AU00000,2023-05-19T13:40:42Z
transaction,b5f43773-e533-45fa-b6bf-8f9c6432fc19,posted,AGL RETAIL ENERGY LTD (GAS),-1547.75,3780cbd8-4ace-4f6b-923a-679ba05137ea,5498.9,debit,cash-withdrawal,AU00000,2024-04-06T23:29:42Z
transaction,a284759d-186a-4c87-aadb-6ee9432f4f4a,posted,Gasoline Purchase,-1096.39,ce40e1be-a9f8-43e4-bea4-72093c6e6647,4402.51,debit,payment,AU00000,2024-04-12T21:50:07Z
transaction,47412cd7-e51d-402a-815d-6e98595f83ac,posted,Gym Membership Fee,-320.54,67d1f2e7-cbd5-4631-b98d-7067652075dc,4081.97,debit,payment,AU00000,2024-03-12T02:24:05Z
transaction,d8f123b8-a42d-43e0-9a8d-6ccccc90d5d2,posted,AGL RETAIL ENERGY LTD (GAS),-2499.05,03f94704-31ee-441f-8e18-deabb5001e60,1582.92,debit,bank-fee,AU00000,2023-10-13T12:19:03Z
transaction,a31742e0-8b65-4b73-8f01-ebfec2784459,posted,Electricity Bill Payment,-1133.38,41088163-984d-4b10-a20e-072538f16949,449.54,debit,payment,AU00000,2023-12-02T09:26:49Z
transaction,44572283-d967-4818-a1e6-24987671b81b,posted,Restaurant Dinner,-3452.16,4376ea16-5c5d-4450-87f5-165c4c89c48b,-3002.62,debit,bank-fee,AU00000,2023-06-27T22:11:55Z
transaction,0c4f8265-d4a6-4fad-bc9a-eb692edc7fbe,posted,Bookstore Purchase,-3681.64,1a28ec0f-92cd-43b6-bd47-a01d1818c0e4,-6684.26,debit,cash-withdrawal,AU00000,2023-05-12T10:37:51Z
transaction,63d693a3-72f2-48eb-a6aa-2d4a13776317,posted,TFR Acc14000 TO 12389,-802.87,8683fc9d-d880-41d8-8ff6-a2d63b72c292,-7487.13,debit,bank-fee,AU00000,2023-08-24T09:45:17Z
transaction,224f38b6-3eed-4072-a725-678fc61de254,posted,TFR Acc14000 TO 12389,-1124.81,937562cc-5755-447f-b021-527cff6b04b8,-8611.94,debit,cash-withdrawal,AU00000,2024-03-01T15:40:42Z
transaction,547c1ed8-c55f-44b1-9356-5ef23b4e1e7f,posted,CTRLINK CARERS Ref: 998R6789201610974V,-884.51,65743c85-d66e-4165-8a02-898f8dd1d1fe,-9496.45,debit,bank-fee,AU00000,2023-10-14T13:10:12Z
transaction,55be1e95-1b2f-4405-b2ac-8b16a1e14a96,posted,AGL RETAIL ENERGY LTD (GAS),-3775.94,b8e555f1-af89-410e-9c2e-eb685ca9429e,14399.21,debit,cash-withdrawal,AU00000,2024-02-23T05:34:52Z
transaction,32704957-1050-4b4d-b7c0-14f2b9f607ac,posted,Online Gaming Purchase,-1382.31,b1285aa3-29ac-41b7-9ac1-436feb3a8820,13016.9,debit,bank-fee,AU00000,2023-07-11T20:51:49Z
transaction,3650cdac-65c3-4c0e-8675-04cb1a595222,posted,Netflix Subscription,-808.44,157e7512-35ad-48ef-a017-f18d9811a7a7,12208.46,debit,payment,AU00000,2023-05-14T23:26:11Z
transaction,3b1c11fb-ccaf-415b-b409-47c61dbd8f25,posted,Gasoline Purchase,-274.34,2bc14d14-e780-447b-8450-1dadf0b04a43,11934.12,debit,bank-fee,AU00000,2024-01-25T05:18:38Z
transaction,a6043b92-474f-4690-8647-1610804ab19b,posted,Music Streaming Subscription,-935.73,7a304a3b-a065-4487-ad71-d3cf64da5088,10998.39,debit,payment,AU00000,2023-08-23T05:38:47Z
transaction,3c6f0724-2671-4cf3-9404-d85203ee01b8,posted,Restaurant Dinner,-1232.96,a42b938f-0d3b-4814-96db-b516b932b269,9765.43,debit,cash-withdrawal,AU00000,2023-08-29T13:03:32Z
transaction,16221a49-4b0f-4a7c-8a25-0838bf4fbd68,posted,Wdl ATM WESTPAC IGA BALGOWLAH BALGOWL AU,-2147.38,c2a53bf3-b30b-4b39-9a70-e7314cbbcdbd,7618.05,debit,payment,AU00000,2023-06-20T20:11:16Z
transaction,512fa702-7e86-4cc5-a855-bca424584df0,posted,Movie Ticket Purchase,-134.33,79133449-6b28-468b-9259-3f1e5e17c6f8,7483.72,debit,cash-withdrawal,AU00000,2024-05-04T14:13:22Z
transaction,3146f405-87ef-401a-a503-38d84f102ad3,posted,TRANSFER TO JOANNA SMITH CAMPING,-3546.28,847edfb1-1d28-47bc-a872-77de8e93328e,3937.44,debit,bank-fee,AU00000,2023-12-08T08:20:15Z
transaction,351c2903-9076-4923-adee-60c8f80c82c9,posted,CTRLINK CARERS Ref: 998R6789201610974V,-506.24,5c2e5967-7405-496a-925b-5bb9f730c366,3431.2,debit,payment,AU00000,2024-01-12T11:05:45Z
transaction,c4bdd870-15e7-4e02-8a7e-bcdd0a38fbe5,posted,AGL RETAIL ENERGY LTD (GAS),-3444.12,7278b435-550e-467c-838b-44f65c8df05d,4607.2,debit,cash-withdrawal,AU00000,2024-04-27T05:15:36Z
transaction,e66813ac-09ff-4fa8-ad35-c9dea591e4ad,posted,Mobile Phone Bill Payment,-1119.5,7dfd9fa7-429e-469b-a775-606833a8d761,3487.7,debit,bank-fee,AU00000,2023-07-17T13:42:56Z
transaction,62d3a407-14b9-47b2-b4a6-095a0eb65b3c,posted,Transfer Platnm Homeloan 346454,-4030.96,15fc7fe1-eba4-442c-b09c-2569c0fd90b0,-543.26,debit,payment,AU00000,2023-11-12T12:45:26Z
transaction,0d8d7797-c22b-4c0d-aff2-c49749616a97,posted,Pharmacy Purchase,-229.98,a99177b4-67ee-4bd1-a6a8-24a41511e42b,-773.24,debit,bank-fee,AU00000,2023-07-10T06:14:16Z
transaction,304f5752-c3d6-4da8-8770-d69971572479,posted,Payroll WFRMS 15439393,10017.39,6a156ec3-5627-4648-b793-ac4867443196,9244.15,credit,transfer,AU00000,2023-07-09T14:34:16Z
transaction,7104b64b-9cc4-49bf-a6a0-bc10e991a601,posted,TRANSFER TO JOANNA SMITH CAMPING,-3508.87,02f6e164-0c8b-4faa-8b66-de55def522f2,5735.28,debit,cash-withdrawal,AU00000,2024-01-20T17:53:38Z
transaction,91a6e976-8f12-4752-8600-317b8bbaeeed,posted,Netflix Subscription,-1858.66,e5b9f93f-9394-4b2a-a69d-e2091e943477,3876.62,debit,payment,AU00000,2024-04-18T19:05:38Z
transaction,b61c0a3c-4427-4a30-b678-9e4fe16d2d92,posted,Hair Salon Appointment,-1016.97,6ef8886c-55fd-4e24-8d82-3d223d890efa,2859.65,debit,payment,AU00000,2024-02-20T09:10:20Z
transaction,4ed0063f-19c6-43a1-91ca-f9e65c480d75,posted,Pharmacy Purchase,-1317.7,3786fa7d-0102-43f3-880e-675658740cde,1541.95,debit,cash-withdrawal,AU00000,2023-11-28T17:20:12Z
transaction,65a684d3-7f3e-48f0-9522-c8371b6b9f11,posted,Bookstore Purchase,-1949.16,c3f39d8d-84ab-49f9-9451-eb38d7dfe917,-407.21,debit,payment,AU00000,2024-03-16T15:52:08Z
transaction,dcb7ed41-30e5-4f0c-8d9c-a48db61790ac,posted,Online Gaming Purchase,-3538.74,3dcea691-05c1-41ef-921c-8eb8219b0ec1,5229.37,debit,bank-fee,AU00000,2024-04-16T08:24:36Z
transaction,d2cd67dd-581d-43e3-8028-0d91cf2b4b9d,posted,Home Improvement Store Purchase,-4623.06,ae8f5bdb-4ce0-44d2-9026-06df1050cbf0,606.31,debit,bank-fee,AU00000,2023-10-14T05:54:52Z
transaction,840769fb-1263-487b-929d-43ca803c31e5,posted,Wdl ATM WESTPAC IGA BALGOWLAH BALGOWL AU,-3684.61,cc26f095-4435-41f7-ad83-504c06e5d5c8,-3078.3,debit,bank-fee,AU00000,2024-01-27T10:12:47Z
transaction,c6362367-f116-4a60-9a2a-95f50972290a,posted,Mobile Phone Bill Payment,-1331.05,86d22baf-3fc5-4971-9128-a139b08a1e98,-4409.35,debit,bank-fee,AU00000,2023-06-28T16:09:08Z
transaction,a893c2e3-3e5c-4f11-80d7-7990d2d58215,posted,Public Transport Fare,-4356.77,2b2675cd-b8dd-442c-a95f-03ba88312da3,-8766.12,debit,cash-withdrawal,AU00000,2023-08-01T00:07:49Z
transaction,b03f6338-a43b-4f22-9655-9f99d4905b25,posted,Non Hooli ATM Withdrawal Fee,-1523.38,ab55d7e6-b03c-4f1a-97e2-0fe0d3aa3314,-10289.5,debit,bank-fee,AU00000,2023-05-26T18:15:57Z
transaction,b5634e15-4386-457f-813d-36e41a058ba4,posted,Online Gaming Purchase,-3634.69,ccc1eec8-85c8-4bc4-9971-cc3c8cb02a10,-13924.19,debit,cash-withdrawal,AU00000,2024-02-29T11:17:14Z
transaction,fc3497af-3515-46fc-9ce1-f7433c035a3e,posted,Netflix Subscription,-2083.16,594c3283-dc3d-4ac3-8311-bc5b3a42c94b,-16007.35,debit,payment,AU00000,2023-07-07T08:27:41Z
transaction,5c186365-f56e-4a8b-bad7-7f70dc22025e,posted,Clothing Store Purchase,-3783.21,ea3ea4eb-25ce-4e35-a51d-5e377f7bf780,-19790.56,debit,bank-fee,AU00000,2023-10-21T12:35:37Z
transaction,f657bd88-1779-4f7a-bbb8-29720c97ea30,posted,AGL RETAIL ENERGY LTD (GAS),-463.68,36757613-21bf-4e56-adc4-0d12e0a9253e,-20254.24,debit,cash-withdrawal,AU00000,2023-11-07T10:03:55Z
transaction,1ac4efe0-7051-4c4c-a7df-d28dfbd3b26a,posted,Non Hooli ATM Withdrawal Fee,-3508.23,cd1aee42-d161-4188-ab90-363f15e9c876,10512.43,debit,cash-withdrawal,AU00000,2023-12-02T20:39:11Z
transaction,a351e6e2-fcf4-4a05-abc5-47426a361a3d,posted,AGL RETAIL ENERGY LTD (GAS),-3831.39,256870a8-cf48-4c6e-87a4-c9ce7805e0cf,6681.04,debit,cash-withdrawal,AU00000,2024-01-24T10:39:49Z
transaction,4b661a57-fb98-49a3-95bb-b5c714eb1780,posted,Car Maintenance Expense,-290.11,d003fd7a-83ac-4d4e-a80d-6d14c722ed78,6390.93,debit,bank-fee,AU00000,2023-06-02T19:46:24Z
transaction,896a3921-0c70-41fa-98bc-7e2309cc187c,posted,Online Gaming Purchase,-1694.38,23395760-1638-46ac-9a9a-13e4d1f7dd6f,4696.55,debit,cash-withdrawal,AU00000,2024-03-21T10:30:48Z
transaction,a0021a46-0305-4de4-8c47-f3c495df648b,posted,Transfer Platnm Homeloan 346454,-4117.73,e712fa6b-c7cb-4aa1-b9b1-4a99a8d302d6,578.82,debit,bank-fee,AU00000,2023-07-01T13:17:35Z
transaction,0c416d40-4c75-4ba4-8f26-c613fec17ebd,posted,AGL RETAIL ENERGY LTD (GAS),-3229.21,bab3d3ba-7275-43f7-af75-bc6d11929edf,-2650.39,debit,cash-withdrawal,AU00000,2023-09-22T16:43:22Z
transaction,cfb4e714-6452-4492-99f5-c08ba9501556,posted,Transfer Platnm Homeloan 346454,-4809.74,295a1f56-a161-4996-a233-e7347452c953,-7460.13,debit,payment,AU00000,2023-12-12T12:55:38Z
transaction,35e75aaa-94a5-4f4a-9d49-914edcfd3783,posted,Wdl ATM WESTPAC IGA BALGOWLAH BALGOWL AU,-2122.02,53af4176-5785-47e3-9d00-3fe685fc8728,-9582.15,debit,cash-withdrawal,AU00000,2023-11-26T19:14:11Z
transaction,bbbc8f48-946b-4980-85cc-4fc96ec82670,posted,Non Hooli ATM Withdrawal Fee,-4842.81,25ae8c58-4077-4669-9494-909175e79e7b,-14424.96,debit,cash-withdrawal,AU00000,2023-11-17T23:54:20Z
transaction,17090f28-e084-48fc-8bff-13219968a16c,posted,Gym Membership Fee,-86.67,3da88abe-1f30-46db-945a-ec374b4d6250,-14511.63,debit,bank-fee,AU00000,2024-03-09T05:52:13Z
transaction,554ba900-fb82-4227-81c9-43cbf3746b1b,posted,Public Transport Fare,-668.4,f7ce63e3-1486-4c68-b1a1-e4d4c71c9288,16473.12,debit,cash-withdrawal,AU00000,2023-09-14T10:21:55Z
transaction,45f1be93-410a-4a66-a678-ca57b2c3c2a4,posted,Hair Salon Appointment,-2931.86,b288635a-0d50-4aba-a113-75b8000a112b,13541.26,debit,cash-withdrawal,AU00000,2024-01-20T13:52:19Z
transaction,6ea6021d-7540-416f-9d77-3c4d881a296c,posted,AGL RETAIL ENERGY LTD (GAS),-81.72,f796a06e-7796-4675-811d-7d621b157fcd,13459.54,debit,cash-withdrawal,AU00000,2023-10-21T09:49:46Z
transaction,d1c83e0e-a03e-4054-96b8-ee42bedf9806,posted,Non Hooli ATM Withdrawal Fee,-3072.5,f8aacf75-fe88-4d36-a061-650941144ac0,10387.04,debit,payment,AU00000,2024-04-22T04:35:31Z
transaction,647273b8-5b64-4cfe-81d8-b27a36a8f13d,posted,Payroll WFRMS 15439393,11077.9,351658ba-a49f-4156-bfb9-8986af2d67ca,21464.94,credit,transfer,AU00000,2023-06-27T15:43:50Z
transaction,d522376f-141f-4a2a-be53-a844b759a97f,posted,Pharmacy Purchase,-4374.96,0b60b82f-f546-4dcb-9649-e3c333d52ee6,17089.98,debit,cash-withdrawal,AU00000,2024-02-14T09:28:34Z
transaction,e74aa7d4-85c2-45ce-a09e-64ecd7a8c75b,posted,TFR Acc14000 TO 12389,-932.16,b5f4054e-34e4-4836-a578-c34439610e5c,16157.82,debit,cash-withdrawal,AU00000,2023-11-27T18:41:57Z
transaction,c1c824e5-412b-442f-9566-03b732d825cf,posted,TRANSFER TO JOANNA SMITH CAMPING,-858.73,72e0740c-7401-4110-b7ca-5fab682e424d,15299.09,debit,payment,AU00000,2023-10-13T09:47:03Z
transaction,79fcf323-ecc8-4b69-ace6-687dada54341,posted,Online Gaming Purchase,-4522.89,018b95f0-46c2-4a67-b356-a4d284634975,10776.2,debit,bank-fee,AU00000,2024-01-04T08:33:03Z
transaction,448cb8ab-39ae-40ef-a8fa-f73e5d01069f,posted,Pharmacy Purchase,-50.66,d1ce0535-57f6-41b9-be14-1fa407cdc9f1,10725.54,debit,bank-fee,AU00000,2023-12-24T21:51:42Z
transaction,f75a0481-952e-4e80-86d7-2190ad07d13c,posted,Movie Ticket Purchase,-2686.97,c95abcad-7514-4aa7-b9cd-4b67b15f6de2,16701.99,debit,bank-fee,AU00000,2024-03-28T06:53:06Z
transaction,bea2710e-c4bb-4d72-8739-7f9e8fc78c04,posted,Car Maintenance Expense,-1471.35,485eb296-2505-472e-9a9e-6d597237bf10,15230.64,debit,cash-withdrawal,AU00000,2023-07-20T23:32:35Z
transaction,7a092224-0c83-4602-88f4-b249407e2086,posted,Mobile Phone Bill Payment,-3195.05,3d8b7507-d1f1-417a-bfcf-19dfb37e6778,12035.59,debit,bank-fee,AU00000,2023-12-15T21:22:18Z
transaction,45b74ff3-5a8c-44df-a62a-1952f2d81d71,posted,Manly Maths Tutor Wages,-837.2,f3e3e54a-f920-40ae-8ace-01b00fc8701b,11198.39,debit,cash-withdrawal,AU00000,2024-04-16T05:38:23Z
transaction,11b0d42b-57c5-4f3e-bbb9-7a74caf0e48e,posted,Car Maintenance Expense,-1050.12,cb5ce2ac-0863-43bc-85ca-7c6d083448c7,10148.27,debit,bank-fee,AU00000,2024-01-10T20:32:46Z
transaction,9091613a-9507-41f8-b813-925986fb7316,posted,TFR Acc14000 TO 12389,-1428.5,2bd2e1ba-cecd-4d2e-8eb1-5a31074de9b0,8719.77,debit,payment,AU00000,2023-11-17T08:51:57Z
transaction,2988e077-f479-4e26-bdc6-9b002613dd33,posted,Gasoline Purchase,-2582.39,ce213560-c00a-459d-a978-c07f31b75e1b,6137.38,debit,bank-fee,AU00000,2023-09-09T17:28:27Z
transaction,e662b329-7762-42d9-b30d-684db7292bdf,posted,Restaurant Dinner,-161.55,6aea9308-0bdb-4f53-ba12-17e0b1a7805b,5975.83,debit,cash-withdrawal,AU00000,2023-09-05T13:20:43Z
transaction,11e760cf-a6a9-4d49-9ac3-8b4186301479,posted,Netflix Subscription,-3753.13,39b47faf-869b-42b0-9c5d-41a5e1de19e8,2222.7,debit,cash-withdrawal,AU00000,2023-05-20T06:47:28Z
transaction,d3fc5e4e-6d66-41c4-ad6c-3fd5f09c55c0,posted,Transfer Platnm Homeloan 346454,-2861.07,8fa08f8b-e052-4417-a18a-89a0fae9c893,-638.37,debit,cash-withdrawal,AU00000,2023-08-07T12:36:27Z
transaction,c70952c8-b6a8-4887-8247-2042ccc39b38,posted,Netflix Subscription,-2361.24,18ecc48d-3864-468d-b467-cad0c2a5ec52,12552.47,debit,cash-withdrawal,AU00000,2023-05-20T08:07:35Z
transaction,4383a9b3-98e7-450c-a11d-f8deb4f62b2a,posted,Manly Maths Tutor Wages,-2391.05,d38794c5-9c65-4662-972d-5fb27162d578,10161.42,debit,cash-withdrawal,AU00000,2024-02-25T22:21:01Z
transaction,abe649ff-fb9f-4e42-974b-a40cc4958db0,posted,Electricity Bill Payment,-3239.59,b540d93b-597a-475f-b8a4-904f52dd7493,6921.83,debit,cash-withdrawal,AU00000,2024-01-05T13:10:45Z
transaction,582a130e-3957-45bf-8318-47685f414c9a,posted,Music Streaming Subscription,-1107.16,7c9290c5-dc20-4e5e-a4c6-a85f04e26a18,5814.67,debit,bank-fee,AU00000,2023-11-16T03:05:32Z
transaction,b5066c3a-67a6-4818-9378-907ec039f0ac,posted,Amazon Online Shopping,-4432.82,63326308-3f6a-4a1a-a184-a90ae339755f,1381.85,debit,payment,AU00000,2023-07-15T22:03:36Z
transaction,ada83c1e-0cb4-4499-aa69-8a3891f9fb6a,posted,Netflix Subscription,-2996.12,20f3f8bf-454e-40e3-9b13-c758173373dd,-1614.27,debit,payment,AU00000,2023-08-14T22:14:35Z
transaction,48840b68-2da8-49ac-9a3b-7cc5993b79f8,posted,Manly Maths Tutor Wages,-3744.59,e3a172e6-e636-4f5c-9dc0-88617fe6b765,-5358.86,debit,bank-fee,AU00000,2024-02-13T02:36:55Z
transaction,a17c6a93-dfd6-4d0f-aa8a-3074cd6a2c1f,posted,Manly Maths Tutor Wages,-3927.79,602eadd6-ef14-4dd4-8d1f-804e48385340,-9286.65,debit,cash-withdrawal,AU00000,2023-11-14T07:15:59Z
transaction,3c5d4b0e-5960-4131-8aff-1936fc8c5ec9,posted,Gasoline Purchase,-154.66,91ef65d5-e789-41d6-bd0c-00c2bf7f9c8a,-9441.31,debit,payment,AU00000,2023-10-26T10:19:50Z
transaction,5005f82d-85e7-4f51-a630-9321aa5ad9a1,posted,Clothing Store Purchase,-1573.83,bd34e66f-461b-4374-bed5-2ce7852123ac,-11015.14,debit,payment,AU00000,2024-03-10T17:14:57Z
transaction,5c670ff7-f05f-4538-88c1-c2ab3b287215,posted,Movie Ticket Purchase,-77.13,fe3c08ed-23ca-4523-a3a8-2bd8d1f9b121,14590.54,debit,bank-fee,AU00000,2024-05-02T15:42:28Z
transaction,f8dfe9a6-61b2-479e-b876-298d7fe471d4,posted,Non Hooli ATM Withdrawal Fee,-607.21,5bba6e6f-0246-4af8-bfc8-e8ede86e6d6b,13983.33,debit,cash-withdrawal,AU00000,2024-04-28T20:07:19Z
transaction,424f60e5-2cdf-4999-8b34-d6585f2fabf5,posted,Online Gaming Purchase,-4465.66,d888a9be-5648-4afc-86ba-e89ed8ea8ae5,9517.67,debit,cash-withdrawal,AU00000,2023-09-29T06:20:12Z
transaction,4cc71990-ada0-4a05-908a-7b8a496d7e05,posted,Amazon Online Shopping,-4231.85,3f9f94b1-7699-4f0c-b21a-8b2ac4006962,5285.82,debit,bank-fee,AU00000,2023-10-18T15:45:45Z
transaction,a1eae050-ffc7-4536-9b53-165371a953fe,posted,Travel Agency Booking,-3802.63,ccdc9ce4-cf5e-452d-a847-18f4dc3f812e,1483.19,debit,bank-fee,AU00000,2024-01-12T00:36:16Z
transaction,4e90f22b-a176-4205-b82e-f285645c86dd,posted,Pharmacy Purchase,-2432.33,f9de8b21-2ad2-4560-973f-79a3b16ab7cd,-949.14,debit,bank-fee,AU00000,2023-11-04T08:09:39Z
transaction,9ad2dc6c-bb32-4084-8ab2-6e455dca3071,posted,Bookstore Purchase,-3893.01,7f5ffd67-3c80-4a44-a63b-4c6a4644d386,-4842.15,debit,bank-fee,AU00000,2024-01-09T08:30:57Z
transaction,d0d46e5c-2ffe-4e6a-ae88-0e50f2f83b50,posted,TFR Acc14000 TO 12389,-4232.65,3cbd71cd-625b-4cc1-afb5-74b9edd29a53,-9074.8,debit,payment,AU00000,2024-03-27T06:28:11Z
transaction,4fc02364-039c-4c11-8303-f8d2a6f6adc5,posted,Pharmacy Purchase,-4249.19,9becfcab-7d12-4e12-b8aa-da95409e3174,-13323.99,debit,cash-withdrawal,AU00000,2024-01-16T10:32:26Z
transaction,8248a3bb-b453-4d8f-842c-9f3571c8de27,posted,Coffee Shop Purchase,-3749.79,330aa8d7-81f1-4a16-9277-3ab91eb44d78,-17073.78,debit,payment,AU00000,2023-11-15T17:42:01Z
transaction,b0008322-947a-47b1-bfd0-992211d576b7,posted,Movie Ticket Purchase,-49.58,d1104c6c-f0dc-422b-b23d-318e0a40175f,8130.6,debit,bank-fee,AU00000,2023-09-26T06:20:05Z
transaction,6c595aed-0a53-4334-a84b-f637a1536b76,posted,Restaurant Dinner,-4644.33,97939f89-cf8d-44a9-b67f-20322ba163c8,3486.27,debit,cash-withdrawal,AU00000,2024-05-07T07:22:38Z
transaction,aabff5f1-b0ba-454b-bdd8-426bdbdbc136,posted,Movie Ticket Purchase,-3755.43,f340dce5-92d9-4710-8763-d8f5830b3d2d,-269.16,debit,payment,AU00000,2023-06-05T15:11:36Z
transaction,0a145400-21e6-420f-ae38-5a150ddb47d6,posted,TFR Acc14000 TO 12389,-1894.33,7b080939-1013-4397-95d1-442e378d2905,-2163.49,debit,cash-withdrawal,AU00000,2024-04-23T04:43:06Z
transaction,dee253a3-552e-489b-9df4-2a6901d24f15,posted,Gasoline Purchase,-3474.57,a6f68abd-522c-40d6-8411-e0ca8330e2c0,-5638.06,debit,cash-withdrawal,AU00000,2023-09-21T06:29:10Z
transaction,3387d132-d0b4-48d0-bf84-db903fc56d63,posted,Public Transport Fare,-2603.38,03c8ad40-182e-4114-a0b2-4a83ccd81009,-8241.44,debit,payment,AU00000,2023-10-27T07:29:38Z
transaction,1bf099a5-55f3-499b-a20b-2c8f2ad7fa54,posted,Manly Maths Tutor Wages,-657.38,8807c85c-bb6d-46d3-b398-4131709feee4,-8898.82,debit,payment,AU00000,2024-04-01T15:20:49Z
transaction,32944f12-e39a-4ebd-bd33-4aaa3015d62a,posted,Uber Ride,-4438.12,6f8f1e2b-00db-4093-9f18-9b8c3d4bedd3,-13336.94,debit,payment,AU00000,2024-05-09T23:45:33Z
transaction,d464fba2-3875-47de-8bb6-4adbcfa2af58,posted,Public Transport Fare,-3947.16,0e512c14-1dcd-486f-a845-a37f6f2995cf,-17284.1,debit,payment,AU00000,2023-06-22T22:25:08Z
transaction,ac76c955-45a4-4cd1-ab03-763662b35602,posted,Manly Maths Tutor Wages,-3652.49,fb946b19-50d5-4ade-b804-cedf118c5ee7,-20936.59,debit,payment,AU00000,2023-10-12T06:28:27Z
transaction,b2652872-5fb7-4630-bca0-487aa4bbe322,posted,Gym Membership Fee,-3406.09,aaf162b2-dacf-44b4-9e02-50446b4d14c1,2519.34,debit,payment,AU00000,2023-05-25T15:26:08Z
transaction,d1fa6ceb-5e38-4788-b4aa-539a2427493a,posted,Transfer Platnm Homeloan 346454,-1322.11,6a880d3c-6354-42e8-be4f-8cf397dd74f8,1197.23,debit,bank-fee,AU00000,2023-09-08T12:03:27Z
transaction,96dc3a65-245a-49c3-967d-c40e6945a3b1,posted,Home Improvement Store Purchase,-3818.56,bfbbd8ca-50b5-492a-bdc5-e8753feec410,-2621.33,debit,payment,AU00000,2023-10-05T16:33:58Z
transaction,3cc0e2b3-e53f-44d3-bba0-4c11496edff4,posted,TFR Acc14000 TO 12389,-816.9,36a05058-acaf-4d7b-86d8-c739e1e1fef7,-3438.23,debit,bank-fee,AU00000,2023-08-22T09:14:56Z
transaction,f3591574-0536-4f1f-870e-b18795ef3b6f,posted,Netflix Subscription,-635.04,5bfc9e8c-625a-4602-98a6-9e49e13a4c0d,-4073.27,debit,bank-fee,AU00000,2023-10-02T19:15:29Z
transaction,137be068-3745-42f8-99a6-3b745e788070,posted,TRANSFER TO JOANNA SMITH CAMPING,-830.85,79ae3564-d11b-4214-93fa-1d1b41356724,-4904.12,debit,bank-fee,AU00000,2023-05-20T18:21:41Z
transaction,196054f2-83fc-498c-84be-20f032bbaa7e,posted,Home Improvement Store Purchase,-218.42,6f7bede7-11e9-4256-a8c2-6b7374716fd5,-5122.54,debit,payment,AU00000,2023-09-23T05:57:33Z
transaction,7ca0cc80-ea00-4121-a864-ea2475f8b15a,posted,Online Gaming Purchase,-4878.58,ab9b958b-6319-4c5f-929c-8465af4f9f2c,-10001.12,debit,cash-withdrawal,AU00000,2024-03-26T16:06:51Z
transaction,544ab2af-2a93-42ee-88a3-57d3c6ba5084,posted,AGL RETAIL ENERGY LTD (GAS),-4464.72,3a05cc73-3d32-47ee-9b0b-bcad83ef6d70,-14465.84,debit,bank-fee,AU00000,2023-10-28T20:03:17Z
transaction,73275365-38c4-4d07-89c0-5f0fd6138891,posted,Payroll WFRMS 15439393,11715.7,0d2ac77b-1036-4b80-9c96-ec27bcc4fb37,-2750.14,credit,transfer,AU00000,2023-06-11T13:05:12Z
transaction,4904625e-4fde-46a6-a80f-7d5a9942c72d,posted,Online Gaming Purchase,-745.97,4a55b6c1-9531-43bd-bc6a-67ad031c94f7,9144.81,debit,cash-withdrawal,AU00000,2024-03-23T17:15:00Z
transaction,95f971a1-2f70-4533-8487-b7e52ce2ec0d,posted,Gasoline Purchase,-4911.4,b505ef70-e7ff-4182-bf9d-1277904b1674,4233.41,debit,bank-fee,AU00000,2024-01-07T18:55:14Z
transaction,134e4aa2-8c33-4015-8e09-b597b6a8ab61,posted,Non Hooli ATM Withdrawal Fee,-3772.61,dcbce0cb-1ceb-4fce-a43a-17718017edf5,460.8,debit,bank-fee,AU00000,2024-04-28T17:46:54Z
transaction,72c19d1e-c517-4351-9753-01ee583569be,posted,Music Streaming Subscription,-4426.73,56755f6b-4edf-439c-a8ef-69bf8183877f,-3965.93,debit,cash-withdrawal,AU00000,2024-02-28T02:08:12Z
transaction,2c28e6e7-f29e-4d6c-92a5-ad3e3240f573,posted,CTRLINK CARERS Ref: 998R6789201610974V,-4425.55,044e837b-c4aa-45d0-b8f9-8d441c8e16ed,-8391.48,debit,cash-withdrawal,AU00000,2024-02-09T20:36:40Z
transaction,e8ac62b4-244e-45e3-98b1-146b547e59c7,posted,Gym Membership Fee,-532.82,1090e73b-8030-49d3-82e3-c93c8e4ed317,-8924.3,debit,payment,AU00000,2023-12-03T02:03:37Z
transaction,1e76ab9e-564a-4250-9517-6e788720e1db,posted,Music Streaming Subscription,-4329.08,ed6194ed-11bf-4181-9b1e-0f708fb2f1e6,-13253.38,debit,bank-fee,AU00000,2024-02-23T23:12:46Z
transaction,430bfcc9-2458-49f4-8ec0-6b2b61c738c9,posted,Gym Membership Fee,-4634.64,eb79f6a5-52d3-4a1b-8371-3cb0034cba50,-17888.02,debit,payment,AU00000,2024-02-28T02:11:59Z
transaction,9ea295ec-eaf5-4c56-afd4-35b6d1cfe614,posted,Music Streaming Subscription,-2549.0,1d9945d7-1e49-4391-ab31-b2db874d0227,-20437.02,debit,cash-withdrawal,AU00000,2023-06-10T19:39:07Z
transaction,f60ad833-88ef-4849-81ba-c18101349e37,posted,Online Gaming Purchase,-4363.56,4a3d62a7-03e8-43f5-915c-3a523b984d56,-24800.58,debit,cash-withdrawal,AU00000,2023-11-29T19:31:47Z
transaction,afefe8b1-5fbf-4352-9bc5-e338f97be530,posted,Online Gaming Purchase,-4430.46,0d1efd39-9341-475f-93d4-3a43e2afdcee,13711.86,debit,payment,AU00000,2024-04-13T03:30:56Z
transaction,519b323f-3ab7-4781-b7b7-103bf7ef66a9,posted,Car Maintenance Expense,-3194.71,281727fc-d814-45e1-9758-09dc81dd0551,10517.15,debit,payment,AU00000,2023-10-07T11:20:43Z
transaction,d7fc2144-8b42-4a5c-90ea-0a13e0c2ddb8,posted,Clothing Store Purchase,-465.54,d1372d6a-f726-40b8-a526-ac199b576a21,10051.61,debit,bank-fee,AU00000,2023-05-20T15:49:14Z
transaction,516f17ce-4b87-4512-bc03-c5301940c433,posted,Netflix Subscription,-4304.05,8263490f-11b7-4fdd-bddb-7472323f7d20,5747.56,debit,payment,AU00000,2023-11-24T05:50:36Z
transaction,f02bd50e-44b7-414e-801d-c02e31d9c8ea,posted,Hair Salon Appointment,-3359.41,4b52a7f7-80ac-464a-ac06-66e039077376,2388.15,debit,bank-fee,AU00000,2024-03-16T14:23:10Z
transaction,79abf925-8bd8-4b98-833d-f8b37530a4bb,posted,Payroll WFRMS 15439393,11717.13,c0c8b6e4-fb87-4cab-9df6-6e6d005bb3db,14105.28,credit,transfer,AU00000,2023-06-15T22:27:18Z
transaction,540bc90a-bbe3-481a-86ee-e42619c90a82,posted,Clothing Store Purchase,-4101.85,46ce828f-3a56-48dd-b667-b4f02a744392,10003.43,debit,bank-fee,AU00000,2024-03-18T08:46:20Z
transaction,af8e34e7-8ea5-477c-b531-95ae1efcee76,posted,Non Hooli ATM Withdrawal Fee,-3709.0,1eecd99c-ed32-4626-ba20-7e27448b7769,6294.43,debit,payment,AU00000,2023-12-06T06:51:35Z
transaction,be844c61-9cca-40eb-a515-2cc97bb4c6dc,posted,CTRLINK CARERS Ref: 998R6789201610974V,-1179.19,560767a5-32a8-44be-83cf-1f5eb388498f,5115.24,debit,payment,AU00000,2023-11-02T09:33:38Z
transaction,43029a59-8678-477b-968d-b6a8fe6b2954,posted,Gym Membership Fee,-3178.76,11172043-3a4b-4028-af4c-f2a3174bbccc,1936.48,debit,cash-withdrawal,AU00000,2023-10-22T09:15:42Z
transaction,3bfbeba8-299f-48e8-9644-9a60044fc814,posted,Home Improvement Store Purchase,-392.16,a1ad3ea1-cfd4-48bd-ba0a-e0bb3c67e826,18890.83,debit,bank-fee,AU00000,2024-03-01T19:09:45Z
transaction,9107bfde-8734-4367-adfc-dbda8f4b970f,posted,Gasoline Purchase,-1359.4,2bd3274c-215c-4d76-83d7-06b15d8a2860,17531.43,debit,cash-withdrawal,AU00000,2024-01-03T04:50:52Z
transaction,6021b8e6-118b-45ae-82aa-b0e48407d8db,posted,Amazon Online Shopping,-241.17,3d449ac4-c4e5-4f87-bc23-28201fbfa5a2,17290.26,debit,bank-fee,AU00000,2023-10-02T06:59:56Z
transaction,dd5c74d7-6ad5-4a22-9667-4566e012e11c,posted,Hair Salon Appointment,-337.29,638a30bc-58e1-489c-b0c0-63ab03bdf5c0,16952.97,debit,cash-withdrawal,AU00000,2023-10-09T07:11:18Z
transaction,af0b9116-1283-4182-8fc7-10db554c78fa,posted,AGL RETAIL ENERGY LTD (GAS),-307.67,e04c364b-12e8-48cf-b7ff-cb918d3be968,16645.3,debit,payment,AU00000,2023-10-08T16:18:18Z
transaction,60507a33-3a9a-4e89-b0be-f5f09c641fca,posted,Online Gaming Purchase,-3272.65,1f9cb578-0fd8-4006-bdd7-3cb39dea7967,13372.65,debit,cash-withdrawal,AU00000,2024-04-02T03:04:26Z
transaction,a8e5da20-adde-4158-a54e-25e734da2d4c,posted,Manly Maths Tutor Wages,-1104.68,65e44a29-7898-48f2-a159-d00f7dc1c50f,12267.97,debit,payment,AU00000,2024-05-04T21:40:44Z
transaction,43bb4146-7737-46ef-9e05-29d175ec8217,posted,Home Improvement Store Purchase,-3346.81,9879d634-d395-41ff-b373-1e243d507f9b,8921.16,debit,payment,AU00000,2024-03-27T23:59:58Z
transaction,3483be21-4c4e-4d13-a82b-80967aa88ee3,posted,Travel Agency Booking,-3324.37,544cec1a-be3a-4388-81e4-2494b891729b,5596.79,debit,payment,AU00000,2023-08-30T15:43:57Z
transaction,1ddc69a2-9f5a-4822-ae27-667f2cec73f2,posted,Movie Ticket Purchase,-4205.45,4dd97e5d-b880-47da-9974-8a61c2b10b2b,1391.34,debit,bank-fee,AU00000,2023-05-13T17:42:31Z
transaction,0cd1842b-6990-4b1a-9f06-4fed02728960,posted,Hair Salon Appointment,-231.32,a2bfb965-bcf7-4716-bcb2-c7db39286337,7458.6,debit,bank-fee,AU00000,2023-07-11T13:21:26Z
transaction,a1fb27d5-f2b1-499f-b730-be96dd38ded4,posted,TFR Acc14000 TO 12389,-724.0,2eea42a7-b9b9-4b8b-a1ad-8dbc1976f49e,6734.6,debit,payment,AU00000,2023-08-13T05:50:56Z
transaction,64e52690-41c8-4d29-a80e-05e35f6b957c,posted,Manly Maths Tutor Wages,-2004.33,cd7dcfc6-be2b-403e-9c54-aafcc37779c1,4730.27,debit,cash-withdrawal,AU00000,2024-04-12T08:17:11Z
transaction,f71c99d0-b452-4bc9-8a2e-20787e6c2837,posted,Bookstore Purchase,-3258.82,62aea75e-5db0-42a9-95de-aad19c4653eb,1471.45,debit,cash-withdrawal,AU00000,2023-08-03T01:22:19Z
transaction,df3caa7c-59e6-49fe-b284-e14bebafebae,posted,Travel Agency Booking,-1915.3,706ecdb0-ba9c-47ce-9f42-6c7023409018,-443.85,debit,cash-withdrawal,AU00000,2024-01-03T08:09:02Z
transaction,5383b2a3-e2cc-4e04-b8f8-f5bc67e2fa62,posted,TRANSFER TO JOANNA SMITH CAMPING,-3280.97,65b7b449-71a1-446e-85bd-67086e93444b,-3724.82,debit,payment,AU00000,2023-11-19T13:32:49Z
transaction,75cca48b-725d-403f-b1ed-1b336743ac06,posted,Pharmacy Purchase,-2706.19,6e47c628-e34f-4995-9348-f6b8365028b6,-6431.01,debit,payment,AU00000,2023-11-21T08:34:38Z
transaction,1cbd06f0-2e40-4185-8f95-ca90bcee653d,posted,Manly Maths Tutor Wages,-247.44,dfb9daaf-ff4a-49b5-81be-0b61ae76bd03,-6678.45,debit,payment,AU00000,2023-08-03T21:12:08Z
transaction,1b361354-4959-430f-a802-1ac90f138156,posted,Coffee Shop Purchase,-1134.61,ea4b5a89-ab95-47ae-9a27-1e4d2dd68379,-7813.06,debit,bank-fee,AU00000,2024-03-18T06:07:06Z
transaction,6eff5772-9f95-4b2b-82f3-565253e41642,posted,Movie Ticket Purchase,-1617.5,e85c5576-bef6-41a1-81bc-69fbc13828f6,-9430.56,debit,bank-fee,AU00000,2023-05-14T20:37:39Z
transaction,6e2b20a1-8b7b-496a-bc08-d548652ca3e3,posted,Manly Maths Tutor Wages,-673.44,8b7a754b-3b39-4087-87e3-65dfa90d16cf,8815.55,debit,bank-fee,AU00000,2023-10-12T00:16:24Z
transaction,3e97c3a8-fc71-4367-acfe-a3231796b322,posted,Pharmacy Purchase,-3636.16,4dd08d46-6779-46c2-aefa-25d7ecdec810,5179.39,debit,payment,AU00000,2023-11-09T08:52:54Z
transaction,5521b04a-3215-4c09-834c-0d6f9bae7b2b,posted,Public Transport Fare,-1563.65,15bdff28-a799-4a6a-b92e-150aed726e94,3615.74,debit,cash-withdrawal,AU00000,2024-03-26T20:10:34Z
transaction,0d4e5fe9-8bff-4a6e-b7b8-4b8a3e5697cb,posted,Electricity Bill Payment,-2563.48,4a78002e-d4d1-48ff-abea-26ca9209eced,1052.26,debit,cash-withdrawal,AU00000,2023-11-01T03:22:11Z
transaction,ac8bf7c0-ef84-4d40-9142-d4668da19310,posted,Online Gaming Purchase,-2506.98,febd5db3-185b-4d15-b049-be5b971e454d,-1454.72,debit,payment,AU00000,2024-02-24T10:44:37Z
transaction,2783c4c3-bc38-4d7f-971c-365467bf60b0,posted,Pharmacy Purchase,-3870.43,b77016da-0e55-4eca-8642-084d85f65ecf,-5325.15,debit,bank-fee,AU00000,2024-03-04T20:34:06Z
transaction,b8deffe5-5967-4e6a-8a08-f00daed870b4,posted,TFR Acc14000 TO 12389,-609.99,6f589c9a-2722-4054-9997-8d6e3eceb6c2,-5935.14,debit,payment,AU00000,2023-12-14T19:59:03Z
transaction,76ca34ca-1e73-469e-b028-7fc515eca798,posted,AGL RETAIL ENERGY LTD (GAS),-2313.81,38632c1e-5b4e-4ca9-a503-633c739dbc33,-8248.95,debit,bank-fee,AU00000,2023-06-03T15:37:18Z
transaction,747c86f7-a7a8-4843-992c-189281b417f7,posted,Pharmacy Purchase,-126.55,2533989f-bd0a-43c9-b996-7a40905870de,-8375.5,debit,payment,AU00000,2024-02-18T11:10:45Z
transaction,0238ecd3-2bb6-47a7-908b-79cbb3538007,posted,Gym Membership Fee,-1479.34,d89e8ead-88eb-4cc8-938b-e58ea7ae0142,-9854.84,debit,bank-fee,AU00000,2023-05-16T13:37:56Z
transaction,afcd7fd8-fa72-4ccb-aaf8-c81faed1202c,posted,Pharmacy Purchase,-1495.64,c37c92ed-73d8-473e-b8ca-874f70b26eda,11354.61,debit,cash-withdrawal,AU00000,2024-04-27T11:41:51Z
transaction,d49fdb78-0672-4c12-8ac7-09d260e9d0f9,posted,Electricity Bill Payment,-706.46,26bd1217-dbf6-487c-8980-6f29bf6a2f30,10648.15,debit,bank-fee,AU00000,2023-11-24T06:21:42Z
transaction,9d6ce503-b690-4ab6-9a1f-2825210f7656,posted,Pharmacy Purchase,-4015.82,689b4491-8a9f-47b9-b7b2-e655bd88985b,6632.33,debit,payment,AU00000,2023-09-22T09:32:19Z
transaction,cd925dd3-0bc8-48b3-9d43-32f43d46b745,posted,Gym Membership Fee,-3302.88,e133d99d-1acb-4d04-bd36-03375ac90932,3329.45,debit,cash-withdrawal,AU00000,2024-03-14T18:43:49Z
transaction,490b10dd-d704-47a4-bd10-e73377fc159c,posted,Restaurant Dinner,-1950.91,c3db9d87-6152-4f19-92e3-f3533558f0ba,1378.54,debit,cash-withdrawal,AU00000,2023-10-17T10:09:05Z
transaction,3f3fbcfd-8401-45b0-a574-4de1626c19b0,posted,TFR Acc14000 TO 12389,-1285.66,400cf9e5-0f42-4105-ac03-b8f17c467f19,92.88,debit,bank-fee,AU00000,2023-12-30T08:41:19Z
transaction,9d81e983-7f3b-4da8-9590-6d1924f1a442,posted,Mobile Phone Bill Payment,-873.58,cfda2127-bf3b-4f7b-b66d-252b4ed45b25,-780.7,debit,payment,AU00000,2024-03-07T03:22:03Z
transaction,536820a9-ea27-483d-8892-d809f07068cc,posted,Wdl ATM WESTPAC IGA BALGOWLAH BALGOWL AU,-1373.94,54a70859-8ca9-4dce-9c91-69914fba979a,-2154.64,debit,payment,AU00000,2023-06-24T12:40:08Z
transaction,5b299b0b-1933-46e3-bb11-79253484024c,posted,Car Maintenance Expense,-1202.85,e91290ae-20a3-4c6d-be28-24a97dd9ebda,-3357.49,debit,payment,AU00000,2023-05-31T12:21:21Z
transaction,497a21a1-fcff-4f7f-aeb5-f189bdd198a2,posted,Wdl ATM WESTPAC IGA BALGOWLAH BALGOWL AU,-1569.72,275a8d7c-759f-4f29-8b55-02e6d44ae852,-4927.21,debit,payment,AU00000,2023-06-17T13:50:38Z
transaction,fea78c69-9fb8-4984-8068-181394325d1d,posted,Clothing Store Purchase,-385.14,c0e5fa8e-b5fc-49df-98b9-a1648a0e7454,15930.47,debit,cash-withdrawal,AU00000,2023-06-23T04:38:24Z
transaction,7f89fbd4-873e-433b-9be8-9835b18e75eb,posted,Manly Maths Tutor Wages,-440.38,dd2a5daf-87c1-4334-889a-f122e1cc2d5c,15490.09,debit,bank-fee,AU00000,2024-04-21T04:33:04Z
transaction,41547176-97da-43a9-ba8b-8e208c20ad55,posted,Netflix Subscription,-2230.26,eaaa04ee-6f8f-4e95-b8d8-906933041d77,13259.83,debit,cash-withdrawal,AU00000,2023-09-02T17:37:41Z
transaction,b24c1750-3ded-4666-b06d-23553ac465e6,posted,CTRLINK CARERS Ref: 998R6789201610974V,-358.36,d52ecd08-4688-4ce5-a4f2-6bdfcab7b285,12901.47,debit,payment,AU00000,2023-11-27T11:12:38Z
transaction,11ec6ab2-4c3e-4457-9d7d-069ec84c152c,posted,Netflix Subscription,-188.84,811ebbeb-b12f-48af-910a-36dcbffa673c,12712.63,debit,bank-fee,AU00000,2023-07-14T22:09:04Z
transaction,d67093c2-dfed-497d-a218-346f327b7ce9,posted,Car Maintenance Expense,-898.03,56778483-5191-415c-91ea-bda7f599c38d,11814.6,debit,bank-fee,AU00000,2023-07-31T20:57:13Z
transaction,db84564b-a119-46ca-9e27-82c5235dfeb6,posted,Mobile Phone Bill Payment,-3385.38,9562b48d-e462-4918-94b5-d6ed5f8c2bd0,8429.22,debit,payment,AU00000,2023-10-24T16:04:07Z
transaction,a6d0faac-960f-40d9-87c0-a5496961ab9a,posted,Bookstore Purchase,-1697.1,3bdd0027-e869-486d-838f-9e35b21a3e0a,6732.12,debit,payment,AU00000,2023-07-13T02:49:49Z
transaction,19197adc-86a9-4c9a-ba0e-a618f72b4ecf,posted,Amazon Online Shopping,-2097.94,cfe049e4-b69f-4336-acd1-38e2715f5abd,4634.18,debit,cash-withdrawal,AU00000,2023-06-10T17:36:28Z
transaction,6b1e60b9-31d5-4340-be00-b254bc5e2343,posted,Movie Ticket Purchase,-4981.22,2b49338f-d967-4f7f-b83f-8cf54ef8b0de,-347.04,debit,payment,AU00000,2023-11-24T22:38:28Z
transaction,2d5014cc-fe74-4e22-a29e-3c74d9224632,posted,Wdl ATM WESTPAC IGA BALGOWLAH BALGOWL AU,-1867.24,e9fec38b-a909-4830-babd-34c7da1f40cf,13159.05,debit,payment,AU00000,2023-09-18T15:53:02Z
transaction,79e30e9d-a514-4efa-83c9-952d5d222b66,posted,Clothing Store Purchase,-2267.97,dd864fff-a514-4e37-b5d2-b1b6aac461ae,10891.08,debit,payment,AU00000,2023-12-23T02:18:08Z
transaction,475e85b6-3466-46ab-a132-71c5cc0089c9,posted,Travel Agency Booking,-2105.25,f3d6039b-e1a7-4a3a-aeca-4bdbdb516bc3,8785.83,debit,bank-fee,AU00000,2024-03-13T04:53:48Z
transaction,bd6ff118-c580-4555-a808-32023c425186,posted,Uber Ride,-2330.42,7b2d52d1-fc0d-4e31-8420-ce525d1460f3,6455.41,debit,cash-withdrawal,AU00000,2023-05-13T21:45:00Z
transaction,51816ffc-70d2-4b10-a781-5c26ae39a4be,posted,Coffee Shop Purchase,-479.78,aa0a5a38-c270-4d89-b879-a8beba508f74,5975.63,debit,cash-withdrawal,AU00000,2024-02-23T05:01:28Z
transaction,4bd2f95e-94da-48d7-b4c2-70d48af6d128,posted,Clothing Store Purchase,-1215.56,7fb0a847-ad1e-4258-9086-66454197bdd1,4760.07,debit,bank-fee,AU00000,2023-05-13T08:36:53Z
transaction,f201c9a1-23a4-4390-b987-dc450a924f52,posted,Car Maintenance Expense,-3652.0,eaa56472-0043-40e8-ad16-923f0d07b1d3,1108.07,debit,payment,AU00000,2024-01-15T03:23:26Z
transaction,e97b710b-3d7c-47c4-aeaa-aa9254e94101,posted,Gym Membership Fee,-4728.17,7f7c9a58-993e-47c1-ace0-214960ab896c,-3620.1,debit,payment,AU00000,2023-08-13T00:54:15Z
transaction,546d59a7-417f-41af-b6cc-efe78848d2ec,posted,Mobile Phone Bill Payment,-2853.61,8c64b544-ad48-4512-9701-5d37fbcb1a76,-6473.71,debit,bank-fee,AU00000,2023-11-21T07:47:53Z
transaction,74a44b84-afe0-4926-a8e4-cd1b3026ff12,posted,Travel Agency Booking,-1929.38,ecebd1a0-be75-412f-8c4f-441cda23225c,-8403.09,debit,bank-fee,AU00000,2023-11-28T22:52:39Z
transaction,613acfee-1649-43bc-82f1-64cb9552a9b7,posted,Car Maintenance Expense,-2752.61,f44372a3-a82c-4bb3-8e79-8f413ffd257e,10167.43,debit,bank-fee,AU00000,2023-09-11T17:17:32Z
transaction,67113e3b-18be-4d9d-8c63-976805f3d57a,posted,Manly Maths Tutor Wages,-841.03,f8dabea2-b879-404b-addf-7bad19aac49c,9326.4,debit,cash-withdrawal,AU00000,2024-03-03T16:41:44Z
transaction,71cec461-2fd0-43ca-8f58-c4a779df3321,posted,Public Transport Fare,-3025.08,4f29714c-d4fa-4f93-bd07-5a51e5b22dcd,6301.32,debit,cash-withdrawal,AU00000,2023-08-08T01:23:57Z
transaction,44a4eb4a-18d6-4a44-a069-c8a4eece26f5,posted,Gasoline Purchase,-3659.77,e3ab3a0a-e103-41cf-adbd-11db4dca4cab,2641.55,debit,bank-fee,AU00000,2023-11-19T11:37:27Z
transaction,beeed78a-3a7e-46f7-87b4-7e09e39fb550,posted,Uber Ride,-2388.17,8590e509-8e41-487e-9313-2f07d68dae39,253.38,debit,cash-withdrawal,AU00000,2024-02-02T01:21:46Z
transaction,738e28f7-9208-44dd-8918-6a94223e270e,posted,Netflix Subscription,-3494.79,85fee524-7607-4be7-8e2d-c481b3345dff,-3241.41,debit,cash-withdrawal,AU00000,2024-01-27T09:36:48Z
transaction,3a5677da-1b3c-467b-a165-bf8df3005288,posted,AGL RETAIL ENERGY LTD (GAS),-1558.05,ee4a612e-5940-4083-91f2-5bfec0474f3a,-4799.46,debit,payment,AU00000,2024-04-15T13:37:11Z
transaction,6c391154-ba38-4aff-a647-b5b5e37644f7,posted,Restaurant Dinner,-1578.82,ee055bb9-821f-457e-8a7e-b41780a60542,-6378.28,debit,payment,AU00000,2024-01-04T15:54:58Z
transaction,2c88b502-a5bf-44f4-be74-b424d86ee98c,posted,Manly Maths Tutor Wages,-3595.96,43e7f50a-9fea-41db-aa38-1244b9ac7407,-9974.24,debit,bank-fee,AU00000,2023-07-03T16:42:19Z
transaction,a6fef6c5-7d3e-4be7-87bf-3b3ea65f5a1d,posted,Car Maintenance Expense,-3783.41,80c06ec0-f788-4de4-b048-a01d2cefd2c6,-13757.65,debit,bank-fee,AU00000,2023-07-03T18:30:52Z
transaction,a44fd263-2c89-48ab-9fa7-147940cfa022,posted,Online Gaming Purchase,-1315.68,1f90629f-ee40-4e8a-a667-3dd10a7729a0,14738.72,debit,bank-fee,AU00000,2024-04-26T01:38:01Z
transaction,d900740a-228d-422f-ab3c-55f35984211a,posted,Amazon Online Shopping,-4925.59,b4fd7057-1a67-4117-a2b7-7f7874d798eb,9813.13,debit,bank-fee,AU00000,2024-01-19T13:41:51Z
transaction,98128dbf-3a2a-44cc-8233-7a6db00af0aa,posted,TRANSFER TO JOANNA SMITH CAMPING,-631.71,4508368f-afe0-4050-af07-e654854e2ee5,9181.42,debit,cash-withdrawal,AU00000,2024-02-19T13:15:28Z
transaction,efe24d9f-83e5-4287-b15d-8747584a5e53,posted,CTRLINK CARERS Ref: 998R6789201610974V,-1687.18,c4a648c8-b93f-4d5c-a04a-6f8ab0feddea,7494.24,debit,payment,AU00000,2024-01-21T20:54:50Z
transaction,50945b66-b988-43f3-9fe4-a8327a18a6e9,posted,TFR Acc14000 TO 12389,-1393.56,48a24074-fae1-4277-be22-775e761e82b8,6100.68,debit,bank-fee,AU00000,2024-03-10T11:55:49Z
transaction,3316b135-ac65-4a36-b68b-74ec81230e42,posted,Netflix Subscription,-4933.69,c0510b8d-be80-4b91-bd16-7f6689bed57a,1166.99,debit,cash-withdrawal,AU00000,2023-06-12T16:18:01Z
transaction,18f4329f-6792-419c-a869-bce70309659d,posted,Travel Agency Booking,-4949.39,3ac30fdf-ad9e-45ea-83db-53fa7540756d,-3782.4,debit,payment,AU00000,2024-02-19T22:15:21Z
transaction,2b5ae26e-9165-43bd-a2ac-ab2973cc138e,posted,Amazon Online Shopping,-99.72,d42b7951-6135-4dc9-94b4-5402fac28da2,-3882.12,debit,cash-withdrawal,AU00000,2023-11-08T06:56:53Z
transaction,3673e3cf-0f48-4721-81c2-c9874b6e3c36,posted,Online Gaming Purchase,-2030.18,3bd4ba16-819c-4ff6-95d9-a6922086676a,-5912.3,debit,payment,AU00000,2023-12-27T19:43:24Z
transaction,f2eb9eed-a9a3-42c5-9366-bd1f7e88385e,posted,Music Streaming Subscription,-511.11,696c5618-d98e-477b-a1cd-3b25a6bf6f24,-6423.41,debit,bank-fee,AU00000,2023-10-12T10:42:30Z
transaction,ac704611-1dde-4aaa-9d4e-c767f493e071,posted,Clothing Store Purchase,-4958.83,d15a5e9f-2e0b-469a-bd61-bb5b1ee79b36,12500.62,debit,payment,AU00000,2023-10-25T13:32:07Z
transaction,da70c7d2-90bb-4186-b87c-52f9d4fc4a90,posted,Bookstore Purchase,-482.56,4f9932c5-3e3e-4e15-9ab4-bb314e3d3b97,12018.06,debit,bank-fee,AU00000,2023-08-26T08:33:26Z
transaction,11de8ee4-f1f4-4821-9a80-3b890f0841b7,posted,Coffee Shop Purchase,-4677.82,d8cfd724-1384-45b5-b5b6-3a1a32bce798,7340.24,debit,payment,AU00000,2024-04-21T21:45:08Z
transaction,887e69c8-08f7-4442-a61a-9cad8e6e8527,posted,Transfer Platnm Homeloan 346454,-3588.88,a152d866-f72d-4f06-a3f2-3b06cdf846a7,3751.36,debit,cash-withdrawal,AU00000,2023-08-02T02:26:52Z
transaction,1e5590c5-9010-4496-a6d9-5b53b995d9e1,posted,Bookstore Purchase,-3815.28,5fa4cc14-10fa-460b-8fdc-233945ae1d7e,-63.92,debit,payment,AU00000,2024-04-21T15:58:40Z
transaction,e8fcb6c5-feb8-4c1d-86cd-6fb4d6cf4ee8,posted,TRANSFER TO JOANNA SMITH CAMPING,-1996.41,5173cdc3-25cb-4b5c-9e3d-4a76b888ffde,-2060.33,debit,bank-fee,AU00000,2023-12-05T02:59:56Z
transaction,12725ea9-e5eb-4ada-a315-4f39f28d8ffb,posted,Transfer Platnm Homeloan 346454,-2254.43,edf6335f-bd2f-4c1b-a3b5-696c31831425,-4314.76,debit,bank-fee,AU00000,2023-09-04T23:27:34Z
transaction,6732f963-fae2-43db-880b-6a645aa26d83,posted,Netflix Subscription,-2370.32,57bba2ab-db9e-4547-8494-1beb349ac480,-6685.08,debit,cash-withdrawal,AU00000,2024-03-29T05:37:47Z
transaction,4c5f0e50-bd36-4a32-8b29-f0947bfad05a,posted,Restaurant Dinner,-3974.54,e8f93eb6-4579-4dd4-8bdd-e158ede9b262,-10659.62,debit,bank-fee,AU00000,2024-04-01T19:09:42Z
transaction,8e50c97c-5b07-49fc-ac48-e02e95ed20e0,posted,Manly Maths Tutor Wages,-3550.1,0db47fdb-1577-4da8-837d-1ad7e409a762,-14209.72,debit,cash-withdrawal,AU00000,2023-11-02T22:21:05Z
transaction,f8d8d11e-14ba-495e-9cc8-c508984abf31,posted,AGL RETAIL ENERGY LTD (GAS),-3671.95,d1c0af89-fae8-4c5e-ae2f-f803bf0bb609,3237.72,debit,payment,AU00000,2023-06-24T06:35:18Z
transaction,438a2a79-8a38-41f2-b8f9-891a112feaf5,posted,AGL RETAIL ENERGY LTD (GAS),-1826.98,ebfa0db3-941f-4eab-92d0-0014fcf91ce5,1410.74,debit,cash-withdrawal,AU00000,2023-06-06T22:56:20Z
transaction,44ae9fb6-45a0-4034-aafe-60d725f3a196,posted,Online Gaming Purchase,-1782.19,5b53f430-4820-44ef-af28-cd42c717a959,-371.45,debit,payment,AU00000,2023-11-19T00:52:54Z
transaction,b87db997-6b7c-4852-8077-7a2fce810857,posted,TRANSFER TO JOANNA SMITH CAMPING,-1035.78,115678bf-bba9-423e-831a-da7183ed1286,-1407.23,debit,payment,AU00000,2023-06-02T00:17:29Z
transaction,f70b1646-5539-43a6-a795-3fcd53ae43ef,posted,Gym Membership Fee,-1002.04,4d841ebf-b33d-43c6-b1c7-920873a6b529,-2409.27,debit,payment,AU00000,2023-12-13T16:03:50Z
transaction,06ae7145-684b-4fea-9b5d-fb4c5da3e787,posted,Car Maintenance Expense,-3856.17,54fc44ea-bf41-4611-b102-50fc2e5389d1,-6265.44,debit,bank-fee,AU00000,2024-04-17T15:53:23Z
transaction,12caa330-5614-4b28-afe7-beb2ca53e6e0,posted,Electricity Bill Payment,-3858.12,77f575ab-ce13-48b9-955b-67ebda3f031d,-10123.56,debit,cash-withdrawal,AU00000,2023-11-22T15:04:14Z
transaction,211b2f46-cf87-4d4f-8e02-fb897ebcecf7,posted,Netflix Subscription,-1493.47,99e0f156-7d9b-470f-94a5-f03d05b0afe4,-11617.03,debit,cash-withdrawal,AU00000,2024-05-04T22:36:17Z
transaction,14ff9de6-1608-4e77-b8e8-51d736d4e0ca,posted,Car Maintenance Expense,-2242.31,7ab96055-d86e-4e75-ae94-d3714b4b42cc,-13859.34,debit,bank-fee,AU00000,2024-02-29T15:36:13Z
transaction,499f7af4-47e1-4d53-9bd7-1c2700a1f14e,posted,Bookstore Purchase,-3030.34,c7899b61-2761-48fb-bc22-21339772af05,-16889.68,debit,payment,AU00000,2023-11-29T22:47:36Z
transaction,5690ae33-e9c6-408f-8cfc-c9f4f16719d4,posted,TRANSFER TO JOANNA SMITH CAMPING,-4104.2,014d0cc6-b7f5-4970-acaa-c267289fd1aa,12176.13,debit,bank-fee,AU00000,2023-11-02T19:58:42Z
transaction,cf834445-5273-4d86-8efc-c79017c75196,posted,Pharmacy Purchase,-183.83,47fcec49-0c15-4dc2-a6fa-eef587434e95,11992.3,debit,payment,AU00000,2023-09-18T02:16:40Z
transaction,f8d8e338-2886-4dbe-be4e-006501cc24ce,posted,Gasoline Purchase,-3999.54,8631b03d-465e-4c97-a3b9-28614d841c31,7992.76,debit,bank-fee,AU00000,2024-04-07T23:02:12Z
transaction,daa043df-b1ca-45f6-bfab-79bafcf0aa44,posted,Transfer Platnm Homeloan 346454,-3054.26,f7f45d79-fbb3-4eb0-afc1-b65f9264504b,4938.5,debit,payment,AU00000,2023-08-03T03:54:15Z
transaction,b9730f67-890a-485a-95ec-8dda543fc127,posted,Movie Ticket Purchase,-2214.96,eba26d1d-b421-4f2a-b259-268c479a272c,2723.54,debit,bank-fee,AU00000,2023-05-13T03:55:46Z
transaction,9d4b3f44-ccab-4f5c-ba8b-6ad910e06dfb,posted,Coffee Shop Purchase,-1392.43,3b7b9fb8-8fd9-4359-9379-97a9076f7757,1331.11,debit,bank-fee,AU00000,2023-09-05T01:09:09Z
transaction,af2e25b1-dd3e-493b-bd3f-8df878521cfc,posted,Movie Ticket Purchase,-1235.84,9797c584-3166-4b9e-acf9-f288dcf88f0a,95.27,debit,bank-fee,AU00000,2023-12-16T15:51:35Z
transaction,14401def-d648-4d66-9c56-9566094bbdbb,posted,TFR Acc14000 TO 12389,-4711.05,c06e3002-1553-4cac-9b87-2a75e844c090,-4615.78,debit,cash-withdrawal,AU00000,2023-10-26T14:41:09Z
transaction,cc5e31fd-ab0a-4988-98f4-db0f3e22252c,posted,Coffee Shop Purchase,-4108.05,ae799b2e-fcac-43b4-aadb-22536f7f6076,-8723.83,debit,payment,AU00000,2024-02-20T11:29:02Z
transaction,06d314e7-c4b6-4d89-8d30-47a6a78305b6,posted,Bookstore Purchase,-4816.23,a847b6a0-64ab-480b-8140-a4e0a4a93582,-13540.06,debit,bank-fee,AU00000,2023-06-29T02:09:00Z
transaction,b82daeb9-3c43-478a-93ae-4a84853bc5ac,posted,Online Gaming Purchase,-55.0,fb164194-087b-43a5-b560-d3ede1ba2f16,16836.0,debit,bank-fee,AU00000,2023-11-21T23:05:45Z
transaction,bf1b6c5c-54bb-4cf8-90f6-f6d45766d0f3,posted,Pharmacy Purchase,-439.89,f1dff94e-17fa-4bf9-ad1d-15fb30db7352,16396.11,debit,cash-withdrawal,AU00000,2024-02-04T09:27:23Z
transaction,8546bacb-567f-4f13-9065-c34ffd024cb2,posted,Movie Ticket Purchase,-3537.74,19bb9cd0-2876-4b0e-8425-79bae19c6076,12858.37,debit,bank-fee,AU00000,2024-05-05T03:40:34Z
transaction,717a7a98-d181-4896-a0ca-a49a05a29b8c,posted,Uber Ride,-4879.37,d3a7661e-a6a8-45cb-a43b-6718b66b8b35,7979.0,debit,payment,AU00000,2023-05-18T10:28:52Z
transaction,9c7d83a6-3a31-4940-9ba5-2f0b9bb0af6e,posted,Manly Maths Tutor Wages,-2305.41,1e92cb64-b7d4-49ac-a52a-4218f2b73594,5673.59,debit,bank-fee,AU00000,2023-10-30T14:02:03Z
transaction,48419b1e-6949-419f-a2f2-5ac5f7842b45,posted,Travel Agency Booking,-4310.22,d273ade0-f673-4f03-8251-90f25e360aee,1363.37,debit,bank-fee,AU00000,2024-02-03T16:22:18Z
transaction,9519fbd9-bdc2-4511-a69c-eeab26d54828,posted,Pharmacy Purchase,-461.87,4afc0fb4-f06d-495f-b5ed-4ffd25cfb329,901.5,debit,cash-withdrawal,AU00000,2023-11-29T02:36:57Z
transaction,96bda18d-c4e3-450d-bf8d-22ea8e39da4c,posted,Car Maintenance Expense,-4033.73,0f10cb43-a6cc-4071-ab57-1e4f15e40c49,-3132.23,debit,bank-fee,AU00000,2024-02-23T00:44:22Z
transaction,a4a3ec6d-43b4-45f8-b674-697e725cbfa6,posted,Gym Membership Fee,-1893.13,840a5944-13db-4704-baa2-496d6a168d13,-5025.36,debit,cash-withdrawal,AU00000,2023-05-31T20:58:24Z
transaction,5dd68157-8d2f-446d-af84-b182ee4dc9cc,posted,Coffee Shop Purchase,-4289.44,4b42d10e-fef7-4102-9aa4-9503b62abfff,-9314.8,debit,payment,AU00000,2023-10-22T10:38:47Z
transaction,0307bfe8-cf21-45f7-9351-fbf6f7deafcf,posted,Car Maintenance Expense,-1701.17,38d49fa5-2419-4d26-bd24-70e0db7fd85a,7758.63,debit,payment,AU00000,2023-09-28T15:55:27Z
transaction,33a63d19-ba94-4375-a28c-1e43a1914f81,posted,Manly Maths Tutor Wages,-1621.16,ebd43a5e-c54e-477c-bcc3-9fce3f31b400,6137.47,debit,bank-fee,AU00000,2023-07-15T01:40:46Z
transaction,f075173e-f9d2-4c4b-beaf-04e336799e26,posted,Bookstore Purchase,-3485.71,ad5ebb03-81d3-44e1-b599-9300b86da2f2,2651.76,debit,payment,AU00000,2024-02-18T01:41:16Z
transaction,e32f2c8c-d496-4679-90f7-1d7bad930b48,posted,Mobile Phone Bill Payment,-993.26,2be92806-565b-4f22-af1e-ce00a27b15fc,1658.5,debit,bank-fee,AU00000,2023-08-18T11:17:19Z
transaction,e048051f-a2e9-49c2-8616-d01d2608b210,posted,Gasoline Purchase,-2490.21,60c8b0d3-0e2b-431a-89ec-24eaebb121e3,-831.71,debit,bank-fee,AU00000,2023-09-28T13:35:59Z
transaction,c6751855-e606-427a-b3f5-623dd152bb09,posted,Gym Membership Fee,-1746.74,c53a2453-7854-4bd6-8d8c-b0d7f5071e24,-2578.45,debit,cash-withdrawal,AU00000,2024-03-27T06:09:46Z
transaction,fe15d99f-1714-4f0a-90ca-0776a1cf17ab,posted,CTRLINK CARERS Ref: 998R6789201610974V,-788.93,feac4b55-e185-4898-bcc6-6e76e2a5d6dc,-3367.38,debit,payment,AU00000,2023-10-23T23:17:07Z
transaction,773c8779-e089-4275-81a9-c9fec4e853cd,posted,Non Hooli ATM Withdrawal Fee,-1728.81,ac9e409e-1512-44ab-b108-01e16643c2e5,-5096.19,debit,payment,AU00000,2023-10-25T09:02:05Z
transaction,47832e43-7439-4776-b07f-6e7578c3aa2d,posted,AGL RETAIL ENERGY LTD (GAS),-901.88,5db87690-32e4-4351-91c6-47ff08bdab1f,-5998.07,debit,bank-fee,AU00000,2024-04-17T21:31:53Z
transaction,85c01129-9408-42c8-ace7-bc0b5a6d77c6,posted,AGL RETAIL ENERGY LTD (GAS),-1588.84,33dfea0e-1682-4296-b147-a9f276a1fd11,-7586.91,debit,payment,AU00000,2023-12-13T20:28:51Z
transaction,1b155662-8671-48da-985f-d74c7a1927ac,posted,Online Gaming Purchase,-4249.75,7720012d-7c94-4f6d-9476-0c353c5af274,5114.8,debit,cash-withdrawal,AU00000,2024-01-30T00:18:06Z
transaction,7dff8652-f4ff-4645-beb3-751000431935,posted,Gym Membership Fee,-4158.21,9888a077-b454-42d3-b774-e83269801ff6,956.59,debit,payment,AU00000,2023-10-20T20:30:10Z
transaction,3bd97434-a24e-4417-a2a4-22296e3d0572,posted,Travel Agency Booking,-2711.28,9a7c1653-5740-49ec-92d0-1d2ae53df14d,-1754.69,debit,bank-fee,AU00000,2023-05-16T04:29:41Z
transaction,eb5f40df-e09f-46c9-befc-6f94e3bf606d,posted,Home Improvement Store Purchase,-3611.91,630849e7-f892-4ea1-8ed6-1f2208ab936a,-5366.6,debit,cash-withdrawal,AU00000,2023-08-16T11:28:45Z
transaction,6a31fa7b-b06b-45de-b735-a36cabebb537,posted,Amazon Online Shopping,-71.25,5ab277b2-19d2-4fd3-9499-ecba054d004f,-5437.85,debit,bank-fee,AU00000,2023-12-10T16:45:50Z
transaction,e7c3e81c-1d8d-41e0-83ba-6ba10a8eafd3,posted,Hair Salon Appointment,-1434.22,e2bde90b-32b2-4c7d-a31b-c13b0c740edd,-6872.07,debit,payment,AU00000,2024-01-12T15:19:44Z
transaction,19fc975a-f9c5-409c-ba81-412af97aa134,posted,Music Streaming Subscription,-3423.73,ab135509-6776-4341-803c-4a2bb51a3243,-10295.8,debit,bank-fee,AU00000,2023-08-15T02:21:21Z
transaction,6b866fea-967c-4f34-939a-30da5401e8b1,posted,Music Streaming Subscription,-3382.24,abce0284-a991-49a5-ab15-8667b9b9a0ef,-13678.04,debit,cash-withdrawal,AU00000,2024-04-13T02:33:16Z
transaction,88885fc3-c7df-4a35-bafb-4af09afaca1d,posted,Home Improvement Store Purchase,-3708.06,3cb905f6-e465-4be1-aa7e-e51b46beb272,-17386.1,debit,bank-fee,AU00000,2024-05-02T07:19:40Z
transaction,e9e5f4da-ae76-4dba-95fc-66c01dbedf10,posted,Car Maintenance Expense,-1631.24,a7f6707b-2420-44e1-8a2c-c9be667d6252,-19017.34,debit,bank-fee,AU00000,2023-09-27T04:01:42Z
transaction,60e7ff6d-9c4c-4bea-9492-52deb1b9a411,posted,Coffee Shop Purchase,-210.97,65625206-d859-41bc-a8a1-32a3cacda4cc,4833.44,debit,cash-withdrawal,AU00000,2024-04-17T02:03:48Z
transaction,ce5dab27-cc1f-4c35-bd70-3b84b0e4502a,posted,Uber Ride,-1804.91,c599b352-d42d-4270-bb3e-cf9d8c5af8ad,3028.53,debit,bank-fee,AU00000,2023-11-12T20:22:16Z
transaction,30bdc8dc-5def-41cb-8517-30710efb974d,posted,Restaurant Dinner,-3691.76,d08ab6fa-bdee-41d8-b2f4-a54fdb5ee4fb,-663.23,debit,payment,AU00000,2024-04-19T11:29:02Z
transaction,08fa50ca-ea20-4dd9-a1e1-b3ec7486a63b,posted,AGL RETAIL ENERGY LTD (GAS),-178.32,e3a98da6-5ca1-4246-a404-deae75142bca,-841.55,debit,bank-fee,AU00000,2024-01-20T18:54:20Z
transaction,3e009298-d6fe-4544-ac3e-b03984d7e31e,posted,Netflix Subscription,-3463.71,7d4ce3f6-b1c4-4c65-ab6d-a724a2315df3,-4305.26,debit,cash-withdrawal,AU00000,2024-02-05T02:09:57Z
transaction,4c46f3da-5ddd-4365-a864-fbd1e67d7488,posted,Transfer Platnm Homeloan 346454,-3241.26,33a4b3d9-ac81-43fb-99c4-6ec4c341b0b3,-7546.52,debit,cash-withdrawal,AU00000,2023-06-27T15:32:49Z
transaction,9d547888-e984-4377-8999-7eaee334c76b,posted,Public Transport Fare,-1952.55,b76ee962-cc3d-4c5f-8f5b-991fdf31dec8,-9499.07,debit,cash-withdrawal,AU00000,2024-01-28T00:04:31Z
transaction,62e20bb3-2d43-4884-87d9-8697504bc5a1,posted,Electricity Bill Payment,-3481.3,c0705e3b-f181-4ac9-b363-4e6f97544a19,-12980.37,debit,bank-fee,AU00000,2024-01-30T04:41:50Z
transaction,87b0ed04-c01c-4526-9237-fa074194e268,posted,Netflix Subscription,-2422.45,c2152d39-e00f-4002-892b-467acc7d0d64,-15402.82,debit,cash-withdrawal,AU00000,2023-06-01T09:34:34Z
transaction,e130d1da-f15b-4682-8ec5-b183b05c9892,posted,Car Maintenance Expense,-3498.36,a6896502-41ec-41e6-978c-eea2b52adb64,-18901.18,debit,cash-withdrawal,AU00000,2023-08-17T12:39:55Z
transaction,57045bc0-98af-4f06-b350-fe77bc87c889,posted,Payroll WFRMS 15439393,10794.67,252c37c1-7ddc-4151-9174-d6da10b25859,28141.6,credit,transfer,AU00000,2023-11-25T06:40:36Z
transaction,f8159e4a-1062-4fa5-b949-967de5b49958,posted,Online Gaming Purchase,-3688.24,544a71dc-4e0d-4e1d-93d7-e226bdb30c28,24453.36,debit,payment,AU00000,2023-10-25T05:40:32Z
transaction,0f0ccc2a-31cd-4bbc-8cd7-315d09f759d8,posted,Online Gaming Purchase,-3107.73,0f7c7d7f-40cf-4dc2-9ac9-cf0b838ccafa,21345.63,debit,cash-withdrawal,AU00000,2023-05-25T19:15:40Z
transaction,40a39517-8e29-493d-a1c6-65c2451c40e5,posted,Netflix Subscription,-3293.32,dfc886c6-4b63-417d-9de4-81429e2b11ff,18052.31,debit,cash-withdrawal,AU00000,2024-02-29T22:28:40Z
transaction,e4c5dc91-81b0-4b64-b0d6-0d0b34e221ce,posted,Gasoline Purchase,-4216.57,f6b3be31-6506-466e-abc6-909b08442422,13835.74,debit,cash-withdrawal,AU00000,2024-03-04T20:00:10Z
transaction,4c94d846-7939-4016-a154-1e929349d64e,posted,Amazon Online Shopping,-1518.31,3fd975eb-73c3-4dd1-a16d-7955dcd2a9bf,12317.43,debit,payment,AU00000,2023-07-17T17:22:08Z
transaction,8b284bb6-6480-4bb0-b47b-4ef755442ba4,posted,Payroll WFRMS 15439393,10558.63,9774be2d-3ed2-4e82-a03c-70eb3373971a,22876.06,credit,transfer,AU00000,2024-04-29T07:53:22Z
transaction,152d7dc0-7d73-47de-b191-7443439dfcd9,posted,Home Improvement Store Purchase,-4045.88,3523e959-85d9-4002-bbb1-374eee849b9a,18830.18,debit,payment,AU00000,2023-12-17T06:51:53Z
transaction,87690166-b298-44e8-9f6a-de30a5714194,posted,Restaurant Dinner,-4900.53,441e99e3-2b08-4194-b952-e3311518ad76,13929.65,debit,payment,AU00000,2024-02-04T06:59:05Z
transaction,8194aa4b-de99-47f6-931a-f0db83faf13e,posted,Payroll WFRMS 15439393,11425.7,ea8efb37-94c2-4b94-811f-a22779ff0e7b,25355.35,credit,transfer,AU00000,2023-05-12T11:10:10Z
transaction,7863ecb4-465c-4000-af90-e7119eee2d22,posted,Transfer Platnm Homeloan 346454,-303.54,cb2f41bb-020f-40c4-bf66-cf60f7ba0485,15403.89,debit,payment,AU00000,2023-11-30T22:14:32Z
transaction,2b45d777-c3d4-4e94-8e9f-2c7f25c99b37,posted,Pharmacy Purchase,-662.59,194bdb53-9170-4352-9942-463d670e6113,14741.3,debit,bank-fee,AU00000,2023-06-10T07:28:31Z
transaction,4799ceaf-07ae-4769-9025-2afc2a96b53f,posted,TRANSFER TO JOANNA SMITH CAMPING,-1168.37,266adae2-016d-4e37-a02d-c974116481be,13572.93,debit,cash-withdrawal,AU00000,2024-04-10T13:40:00Z
transaction,3ca0bae6-0252-43a7-be8c-a0ec7a161417,posted,Gasoline Purchase,-357.76,17b6eb2a-7fb4-43a9-821f-25c404f9d5be,13215.17,debit,bank-fee,AU00000,2023-12-10T20:41:19Z
transaction,a2e85ff3-e317-4406-809e-90d47789275d,posted,Gym Membership Fee,-1594.29,93900164-c51c-4dff-8a86-f7a46d59dda9,11620.88,debit,bank-fee,AU00000,2023-06-16T04:01:41Z
transaction,46d71d17-0e17-4899-8440-83980d3f047c,posted,Netflix Subscription,-4865.35,08af1467-c63f-4d48-9766-f77d53d99664,6755.53,debit,cash-withdrawal,AU00000,2023-07-28T05:47:23Z
transaction,0c4da3b3-19b3-4173-b758-212cdc418b97,posted,Amazon Online Shopping,-3397.94,061e23d2-1821-45d6-8a15-0aaab2d33881,3357.59,debit,payment,AU00000,2023-11-08T09:54:15Z
transaction,4a9c563e-78a1-46a3-a81e-9ec46e6aac16,posted,Transfer Platnm Homeloan 346454,-210.59,9fc81720-732b-473a-96cf-e21f4b88f6d8,3147.0,debit,cash-withdrawal,AU00000,2023-09-13T07:20:38Z
transaction,96c0b04a-76fa-419f-9359-6d966a1ecc0d,posted,Payroll WFRMS 15439393,11656.31,49bef78d-eb79-473a-935e-335766cef574,14803.31,credit,transfer,AU00000,2023-11-07T02:27:23Z
transaction,835dcd3a-3688-4def-8bc8-7fb5a030de23,posted,Pharmacy Purchase,-1301.89,09cc521f-a8f9-4b32-b3e0-907fa6325265,13501.42,debit,bank-fee,AU00000,2024-01-27T22:40:33Z
transaction,688b9fa3-f361-4fdf-aa18-60e613f82a47,posted,Restaurant Dinner,-541.22,a9509217-d08c-4100-a8a0-97547c8a9212,17724.25,debit,bank-fee,AU00000,2024-01-14T19:14:54Z
transaction,7b94f545-ff87-4706-aeef-96b76eb0772f,posted,Pharmacy Purchase,-3626.93,70cdd106-7b92-419b-bc74-3249bee8619b,14097.32,debit,cash-withdrawal,AU00000,2023-07-09T21:25:28Z
transaction,4cd22c73-8a7b-4dac-b2ae-57b4dc87bbe3,posted,Coffee Shop Purchase,-2571.67,374fd4ae-9c10-4755-aa96-43ac0ea2460e,11525.65,debit,payment,AU00000,2024-01-20T11:49:46Z
transaction,278e8966-b783-456b-aa3e-634adff24cb7,posted,Manly Maths Tutor Wages,-4256.73,53078258-4162-4720-bbea-5f981351b477,7268.92,debit,cash-withdrawal,AU00000,2024-01-21T19:58:42Z
transaction,38f03792-8b2b-4a31-a1d4-a8ab64d4a701,posted,TRANSFER TO JOANNA SMITH CAMPING,-1853.52,ea08191c-4eef-4a15-ba7c-8ab6c4c66972,5415.4,debit,payment,AU00000,2023-07-07T04:36:31Z
transaction,a8eb0083-e685-4234-8958-1676f54320c4,posted,Netflix Subscription,-636.42,0239dada-1ed6-417d-a911-bdf11d650794,4778.98,debit,bank-fee,AU00000,2023-10-02T06:48:25Z
transaction,818d4736-b279-4048-813c-282b92d4340e,posted,Public Transport Fare,-1587.02,373b7437-b0cf-4747-972e-68131acc5bcd,3191.96,debit,bank-fee,AU00000,2024-04-24T21:14:00Z
transaction,25f666ee-0252-42b5-a1a8-403ccfd79900,posted,Netflix Subscription,-4421.67,f2884467-6ec7-465e-9638-045ab8909966,-1229.71,debit,bank-fee,AU00000,2023-09-03T12:05:41Z
transaction,fa664e1d-b20f-465d-8453-fb4743974c9e,posted,Gym Membership Fee,-4900.47,8afadca7-befe-491a-a450-c55354646c1d,-6130.18,debit,bank-fee,AU00000,2023-11-05T17:46:41Z
transaction,643c459d-e4d9-4045-9c26-d3a5f92f432c,posted,Coffee Shop Purchase,-3301.69,36fc7e9f-be33-466a-b027-30128a8865c2,-9431.87,debit,cash-withdrawal,AU00000,2023-05-29T08:29:22Z
transaction,acd6683a-f771-4598-af8b-3f2005a10c28,posted,Uber Ride,-1524.57,6aa1abc3-924d-4bcc-b9c8-d67c3ca2ce71,13404.38,debit,bank-fee,AU00000,2023-07-31T15:02:54Z
transaction,b1acb266-bc9f-4baf-bdba-113f395a345e,posted,TFR Acc14000 TO 12389,-1533.07,214ede17-f279-4659-ae2e-98fcfd8979a3,11871.31,debit,payment,AU00000,2023-08-22T09:41:59Z
transaction,324cc111-c367-4530-a16c-48933ced7093,posted,CTRLINK CARERS Ref: 998R6789201610974V,-280.37,1fa69f87-9c81-4aee-b139-f272f0c2c132,11590.94,debit,cash-withdrawal,AU00000,2024-03-25T06:14:59Z
transaction,f109ee88-1ec5-4736-a670-5763a96875c6,posted,Restaurant Dinner,-1032.08,1095903c-e12f-4599-8267-df07eb908974,10558.86,debit,bank-fee,AU00000,2023-07-12T04:50:29Z
transaction,4bc6af59-fecf-4355-9666-31dcab372673,posted,Online Gaming Purchase,-3918.53,8b061908-0bde-4de0-9775-b0b1b792cf72,6640.33,debit,payment,AU00000,2023-12-31T21:13:13Z
transaction,58a3464b-55b8-4b2a-90b1-6ae47215b329,posted,TFR Acc14000 TO 12389,-1408.63,7c494764-932f-467f-bc1c-a674c400b283,5231.7,debit,bank-fee,AU00000,2023-05-21T11:04:12Z
transaction,8410a0cb-f2ba-4174-a4c5-36036def6458,posted,Public Transport Fare,-293.69,824c7917-f33d-4bdb-b92c-996d5d6d45bc,4938.01,debit,payment,AU00000,2024-04-11T17:22:39Z
transaction,ed4a444e-2576-451f-a93f-6dfd16c87438,posted,Amazon Online Shopping,-2103.92,aa2a5756-a8a8-46d1-8fac-417a6eec0da3,2834.09,debit,payment,AU00000,2024-03-11T10:15:02Z
transaction,b07aecb9-9950-4179-b94d-51d373f91f55,posted,Amazon Online Shopping,-3900.24,fcb4f90b-74af-447b-9550-87cb84e37750,-1066.15,debit,cash-withdrawal,AU00000,2024-02-09T20:54:43Z
transaction,7e8de663-dfea-4c89-9e20-a7d4d904fef5,posted,AGL RETAIL ENERGY LTD (GAS),-1647.4,8e98d99f-f660-413f-8885-5d7ac855f633,-2713.55,debit,bank-fee,AU00000,2023-06-30T02:38:11Z
transaction,2a83ee14-1478-432c-bd8b-7c2005ae0404,posted,Manly Maths Tutor Wages,-4652.43,3141129b-53ad-4f05-b83f-23af8542ce8d,14888.89,debit,bank-fee,AU00000,2023-08-24T22:27:26Z
transaction,1c9f6007-6969-47e9-954d-628a5e62332d,posted,Public Transport Fare,-3283.97,92534aaf-5fee-4120-b39b-94510b715d6e,11604.92,debit,cash-withdrawal,AU00000,2023-11-18T17:06:22Z
transaction,507dd475-5cf3-4a27-abaf-2d029093a0c1,posted,Amazon Online Shopping,-3403.26,e43fcccc-7ec2-4009-a96e-3c90c5702e9c,8201.66,debit,payment,AU00000,2024-03-17T23:56:20Z
transaction,2bb6fd89-321b-4841-ba23-16dd68321d2a,posted,Online Gaming Purchase,-3951.09,0d803f88-2ffd-4b05-a41d-654ea265b149,4250.57,debit,payment,AU00000,2023-06-24T10:33:59Z
transaction,29b79522-02ce-4de5-98e9-cfdd828caa14,posted,Public Transport Fare,-1637.54,f81873b6-4d72-43fd-a52b-97ded4417efa,2613.03,debit,cash-withdrawal,AU00000,2023-12-21T19:29:24Z
transaction,b7f09d81-9cdd-4c39-87ea-5b442ce6e6cd,posted,Home Improvement Store Purchase,-3116.87,ddd7db17-f02b-4e1b-89af-4dd19d2bf6da,-503.84,debit,bank-fee,AU00000,2023-06-30T16:10:29Z
transaction,a97bc5ed-8fda-4e56-a2b4-d99af1860a80,posted,Manly Maths Tutor Wages,-1260.76,d8ebe72c-5ad0-4aa3-abf1-333f2a4698e4,-1764.6,debit,bank-fee,AU00000,2023-09-13T11:58:17Z
transaction,d1c74a00-067f-4ab0-af7d-f8ae9082a883,posted,Pharmacy Purchase,-3815.82,b6ec529b-74da-4c10-b57d-ca35491dea9a,-5580.42,debit,payment,AU00000,2023-10-02T01:41:11Z
transaction,7a8f38c0-7171-4de6-96d4-0fa81563dc88,posted,TRANSFER TO JOANNA SMITH CAMPING,-1305.86,5eea1af2-1366-40b3-9c37-33f364e22cde,-6886.28,debit,payment,AU00000,2024-04-25T14:02:03Z
transaction,a07adf5b-73be-43c2-a95c-33f23eabb42e,posted,Movie Ticket Purchase,-1858.66,2a5b0ca2-e178-4b37-a2aa-220305bf0c3a,-8744.94,debit,bank-fee,AU00000,2024-02-08T19:54:22Z
transaction,2506838e-a0c9-4e0b-b49c-ac5b8cde7ee0,posted,Music Streaming Subscription,-2098.21,7f67b38c-7e62-4678-9e1f-c06fb1d6934e,15046.47,debit,cash-withdrawal,AU00000,2024-04-05T18:10:04Z
transaction,9e6434e4-6f64-467a-bc87-1fe2b8f3d17b,posted,Mobile Phone Bill Payment,-269.29,7e217684-7305-4319-9687-d95b2ff4ca28,14777.18,debit,payment,AU00000,2023-07-06T23:45:21Z
transaction,62a4ae4f-c9bf-4284-aa09-470828f82601,posted,Manly Maths Tutor Wages,-798.74,a2af4ad9-cc75-4be9-a3a4-8490a24a0cd2,13978.44,debit,cash-withdrawal,AU00000,2023-12-04T08:43:53Z
transaction,6a02c94b-85c1-4082-8f59-26153f92ae34,posted,Amazon Online Shopping,-1718.23,e7c45fa3-ca13-4d29-acab-172e08d01092,12260.21,debit,cash-withdrawal,AU00000,2023-07-23T11:45:12Z
transaction,f85c8751-c4e2-4063-acbb-41bb3c7ab65e,posted,Movie Ticket Purchase,-1480.03,0e58b36c-15dc-45ee-a305-57a5c904f754,10780.18,debit,payment,AU00000,2023-12-15T06:11:41Z
transaction,14867cf7-d30c-4b59-891d-48b4a4663562,posted,Mobile Phone Bill Payment,-2563.42,a72eb58d-8352-49a0-a798-82b41ae7e70d,8216.76,debit,bank-fee,AU00000,2023-10-13T11:26:32Z
transaction,5b2be1af-051f-4f5c-a2c1-e7b16f3af88b,posted,Restaurant Dinner,-2165.49,0aca895e-3d70-4499-b943-fe9c7a92b422,6051.27,debit,payment,AU00000,2023-06-02T06:34:56Z
transaction,f2e2b52b-e674-4338-b5a6-b8c9a4d49eeb,posted,Music Streaming Subscription,-3432.65,a47eae3a-0eb9-4cdc-bc16-3f8b74d9e59b,2618.62,debit,bank-fee,AU00000,2024-02-01T23:01:05Z
transaction,76b3ef40-79cf-4ade-9f6d-f161f466b701,posted,Travel Agency Booking,-418.3,0cbac1b6-408b-462f-8348-dd5f249cc62f,2200.32,debit,cash-withdrawal,AU00000,2024-03-22T16:29:24Z
transaction,a2dfbc6d-77d7-4072-bdac-89a614b09782,posted,Public Transport Fare,-1222.73,9fd84461-eb48-4884-882a-4c0c488529c7,977.59,debit,cash-withdrawal,AU00000,2023-07-30T03:53:16Z
transaction,3c45cea4-28aa-4390-8595-3a8e6ad53f57,posted,Electricity Bill Payment,-1279.26,5403c98f-cc31-480f-ac3c-fad32731062e,10978.99,debit,cash-withdrawal,AU00000,2024-03-19T21:38:32Z
transaction,c7db0520-9819-492e-8722-8fa33cefd284,posted,Gym Membership Fee,-946.85,21576ab6-ad42-4ea2-b161-70f03cd39afd,10032.14,debit,cash-withdrawal,AU00000,2023-06-03T18:04:57Z
transaction,761ae56a-a85f-4ccb-9685-d56b6d525383,posted,Restaurant Dinner,-4354.16,e07e9894-1edc-403a-8a05-d270d31129d6,5677.98,debit,cash-withdrawal,AU00000,2023-09-18T16:08:23Z
transaction,4900ee6c-2a7a-480e-a969-d95106a04de4,posted,Mobile Phone Bill Payment,-437.86,3582d313-5114-448c-8d19-5652aca8390f,5240.12,debit,bank-fee,AU00000,2023-10-05T18:13:45Z
transaction,50075541-c40f-4f1d-a6e7-d50f787223eb,posted,Clothing Store Purchase,-4413.97,6066aeef-096b-4bb5-b517-3985c101328b,826.15,debit,bank-fee,AU00000,2024-04-10T14:03:21Z
transaction,ef83575b-fe8d-46be-b77d-3f2a54765492,posted,Netflix Subscription,-2621.0,ca2e8586-fb49-490e-a0c3-f138c7d83c70,-1794.85,debit,payment,AU00000,2024-03-26T10:56:26Z
transaction,28d45820-422a-483a-a484-09125a6b8336,posted,Netflix Subscription,-2635.35,4813b75e-fc31-44fc-ae56-aa79e26ff088,-4430.2,debit,cash-withdrawal,AU00000,2023-11-30T06:59:20Z
transaction,ee5011ad-8d50-4d32-924e-a885471f129a,posted,Electricity Bill Payment,-900.13,9b3da635-ddd2-4991-877c-9611299ce13c,-5330.33,debit,cash-withdrawal,AU00000,2023-06-03T22:24:13Z
transaction,538f742c-fbc4-4c80-aae9-9b9c8853f7b1,posted,Non Hooli ATM Withdrawal Fee,-901.37,5bbf01bc-0ef7-4ea4-9bdf-f0f8327bb728,-6231.7,debit,bank-fee,AU00000,2023-11-18T02:18:23Z
transaction,a26fa227-184e-4a9a-9bfb-ed89698817c7,posted,Payroll WFRMS 15439393,11899.97,41c6b172-3726-40bb-9e4e-8364b6c6bb3f,5668.27,credit,transfer,AU00000,2023-12-11T08:16:42Z
transaction,1c5a777a-e24d-41c8-872c-11d559a8a25c,posted,TRANSFER TO JOANNA SMITH CAMPING,-46.84,b4fedec1-2d35-4f15-aa2a-04ef0d9f67a5,13055.8,debit,bank-fee,AU00000,2023-05-31T08:00:30Z
transaction,908b46b5-d399-4bfd-bab9-57efc3409d52,posted,Uber Ride,-2326.01,8b20b56a-bb64-49b0-bd44-577921035c58,10729.79,debit,bank-fee,AU00000,2023-05-23T14:19:13Z
transaction,8ab89d65-fd44-44fb-a89f-a7d75c3997f5,posted,Payroll WFRMS 15439393,11948.85,eaec8c1a-2a3b-4b89-9b30-8d4c4a9eb06c,22678.64,credit,transfer,AU00000,2023-07-10T20:22:14Z
transaction,ede57201-09e6-4483-8500-d623fe46e8f7,posted,Restaurant Dinner,-463.24,5319ef43-bfa5-4a78-8c0d-cf231d24d418,22215.4,debit,cash-withdrawal,AU00000,2023-11-28T11:24:26Z
transaction,cc461ded-3a4a-465a-880e-d33403c7c5a2,posted,TRANSFER TO JOANNA SMITH CAMPING,-1459.89,404a6c3b-ae3c-48e5-9148-f91939cbc949,20755.51,debit,payment,AU00000,2023-07-25T01:11:14Z
transaction,a62866c8-0ad6-4b1a-896d-7ade7164137d,posted,Manly Maths Tutor Wages,-4123.36,f6da4b32-8a43-46e9-86f0-a26a105e4e6a,16632.15,debit,payment,AU00000,2023-07-19T03:53:29Z
transaction,3809e252-0758-4ba3-847c-e9fdb65fe007,posted,Home Improvement Store Purchase,-854.84,ab8fd133-adb0-4612-ad83-23c38e3e2eb1,15777.31,debit,cash-withdrawal,AU00000,2023-07-03T04:51:30Z
transaction,d8eb9ced-697c-479d-a71b-245c6951f416,posted,Clothing Store Purchase,-3288.8,f80a3dd2-ae10-4131-8210-e4bbf7e1ea98,12488.51,debit,cash-withdrawal,AU00000,2023-09-08T09:23:37Z
transaction,9736e69f-9fb0-419e-8d03-ada4c915928e,posted,Pharmacy Purchase,-3470.4,0c354961-4d2f-4f01-b0d6-c67fb15bb23a,9018.11,debit,cash-withdrawal,AU00000,2023-07-28T23:37:18Z
transaction,06610d53-d230-4df7-948d-326c5caf9f0c,posted,Non Hooli ATM Withdrawal Fee,-4121.7,ed4b2053-0488-4e6f-8254-df03830d8db4,4896.41,debit,payment,AU00000,2024-02-22T22:00:50Z
transaction,da983985-72c1-4727-96c1-d079c4df819f,posted,Netflix Subscription,-1542.25,8b7e0850-22b4-412a-bd33-0a4b5969be9a,7785.26,debit,bank-fee,AU00000,2023-08-03T05:58:13Z
transaction,b6c98f5e-1793-4883-91dc-bb22b8608553,posted,TRANSFER TO JOANNA SMITH CAMPING,-852.3,2600c76c-19cd-40d5-a404-eff9d74176b4,6932.96,debit,bank-fee,AU00000,2024-02-18T17:38:35Z
transaction,26bf0e5b-ed9e-4d65-8f30-c55ac24d9c92,posted,Uber Ride,-945.48,0a3ee4e2-e33c-44bc-ab39-c573e6e7f8e0,5987.48,debit,bank-fee,AU00000,2023-10-06T16:24:16Z
transaction,cf97eb5c-39da-442d-93bf-0909127a08ce,posted,Gym Membership Fee,-442.16,3f21d704-d1e4-410e-8299-0a4a4f1f3200,5545.32,debit,payment,AU00000,2023-06-14T18:42:45Z
transaction,233350d5-2e2d-43f4-9503-f6f16fb06a09,posted,Bookstore Purchase,-3764.1,ca9d92ac-69a6-4afd-ace3-47e8381a9874,1781.22,debit,bank-fee,AU00000,2024-02-26T03:18:52Z
transaction,9eaf5809-a3a5-4c86-9199-e8ec1ec3cdc0,posted,Movie Ticket Purchase,-2121.35,46f11ef6-348e-4336-97bd-cfe19f265ebc,-340.13,debit,cash-withdrawal,AU00000,2023-06-03T16:26:28Z
transaction,decb1670-030f-4b4f-a4a3-887654e2b8e1,posted,Movie Ticket Purchase,-411.02,c1ac3014-0741-498e-879b-1f96bb5af809,-751.15,debit,payment,AU00000,2024-02-14T13:33:30Z
transaction,8aea989b-2085-4ff6-a85f-0f1d0e0bf846,posted,Music Streaming Subscription,-2765.02,eac6ad8b-7977-4089-b856-b4e645d36028,-3516.17,debit,payment,AU00000,2023-08-07T08:09:52Z
transaction,10833f2d-9740-4d9b-bf8e-d7631230f819,posted,TRANSFER TO JOANNA SMITH CAMPING,-4260.3,d23e40fd-a57a-4115-8e1f-3512d1e920aa,-7776.47,debit,bank-fee,AU00000,2023-11-03T22:27:15Z
transaction,589f21ca-e32e-442b-8ae9-dfda6ad5c67f,posted,Movie Ticket Purchase,-3705.18,cdafa06a-b739-492e-9790-5135898b277c,-11481.65,debit,bank-fee,AU00000,2024-04-08T17:48:11Z
transaction,63d05f22-36a1-475d-80ca-f0dc599257d3,posted,Manly Maths Tutor Wages,-3071.36,94e7a6ec-e4af-4246-86f7-15fde57c296d,13351.11,debit,payment,AU00000,2023-06-28T19:30:56Z
transaction,b1374887-bb5a-4a79-8258-f9a0b729d742,posted,Mobile Phone Bill Payment,-3784.24,9fbbf3f8-8566-4afd-a8a5-d688fcce4f6d,9566.87,debit,cash-withdrawal,AU00000,2023-12-31T20:33:46Z
transaction,d130243e-95d4-4fca-acaa-1dc38267083f,posted,Home Improvement Store Purchase,-4916.85,5994344a-61d1-43c2-bf36-73fbb53398a4,4650.02,debit,cash-withdrawal,AU00000,2023-06-17T14:42:33Z
transaction,f5ea6fbe-d4a5-4305-a4a4-48f40b1fddc8,posted,Pharmacy Purchase,-3662.27,c05768f5-20e0-4abe-8f73-0d5aef52bde8,987.75,debit,bank-fee,AU00000,2023-12-31T16:12:45Z
transaction,1d0e9b34-87fa-4aa4-a34f-5a77a076f691,posted,Pharmacy Purchase,-1348.62,aced5738-a1df-4704-896d-eef269f5361a,-360.87,debit,payment,AU00000,2023-11-28T16:05:35Z
transaction,0f9e4eaf-09b3-42b9-9657-b3683ea95525,posted,Hair Salon Appointment,-4224.34,e69e4627-d800-44c8-ba07-737da64a6265,-4585.21,debit,payment,AU00000,2024-04-17T23:47:32Z
transaction,1cd445ef-6747-4317-90b3-93e32bb673e6,posted,CTRLINK CARERS Ref: 998R6789201610974V,-1477.5,f998ce1c-54cc-46df-af10-8c48fec59854,-6062.71,debit,cash-withdrawal,AU00000,2024-03-31T11:04:40Z
transaction,19053fdf-1d77-4b52-be50-c91061e06c60,posted,Coffee Shop Purchase,-4114.41,bd254d44-1ee9-4dd1-9dad-7af37c61ecf8,-10177.12,debit,cash-withdrawal,AU00000,2024-02-20T09:27:02Z
transaction,afc32a8d-aa8f-408c-9cdd-97d25deae065,posted,CTRLINK CARERS Ref: 998R6789201610974V,-3835.33,06ecef02-8107-4887-a90f-a7b7e7186d2f,-14012.45,debit,cash-withdrawal,AU00000,2024-04-07T12:49:41Z
transaction,de05fd5c-8a52-4a32-8669-df0f86590e98,posted,TFR Acc14000 TO 12389,-560.72,662960ef-72c4-4938-9e97-ba1839aef110,-14573.17,debit,cash-withdrawal,AU00000,2023-09-04T17:15:14Z
transaction,ae11381e-8d96-465a-83b2-38b2a68b8dea,posted,AGL RETAIL ENERGY LTD (GAS),-761.27,a0d40e81-7e53-4b66-9b82-f7a7b47e028e,8645.92,debit,payment,AU00000,2024-01-30T18:05:51Z
transaction,258d9829-7e5c-4346-903a-08489a6f3dbe,posted,Transfer Platnm Homeloan 346454,-1418.73,f73be4da-e080-49de-b665-f2834b1a9d0e,7227.19,debit,payment,AU00000,2024-04-10T00:27:49Z
transaction,68bb1c4c-aad8-4c1e-bc06-d4c7f78b8c13,posted,Gasoline Purchase,-650.42,6b647a9c-b3bb-4196-a411-3cca4e6da886,6576.77,debit,bank-fee,AU00000,2024-04-24T15:49:17Z
transaction,9fe49c64-8a70-4420-b59b-f1e78eefb6ca,posted,AGL RETAIL ENERGY LTD (GAS),-1989.38,b3068d04-3a04-4e00-a125-d40a814df07f,4587.39,debit,cash-withdrawal,AU00000,2023-05-22T01:37:31Z
transaction,29faea9f-7ade-47a2-9162-9b729f6195ac,posted,Netflix Subscription,-3835.98,d1f98bac-a3a8-4b18-baad-6ada223cce73,751.41,debit,cash-withdrawal,AU00000,2023-10-22T10:02:33Z
transaction,201cd3b3-025e-4169-868e-6356907729f5,posted,Payroll WFRMS 15439393,10639.66,dd6a131f-f14c-4bf3-aac8-501288785268,11391.07,credit,transfer,AU00000,2023-11-06T04:10:24Z
transaction,da08a4da-da6f-4858-9df5-292bff056625,posted,Home Improvement Store Purchase,-1589.58,fe909941-af34-4580-98c6-271561f4ec84,9801.49,debit,payment,AU00000,2024-01-29T21:13:57Z
transaction,3843e09f-9c78-4b9e-8f19-5018d02f37b4,posted,Gasoline Purchase,-4681.56,d3b88802-4aad-4441-979e-9664d04b627c,5119.93,debit,cash-withdrawal,AU00000,2023-12-31T04:08:09Z
transaction,a494d719-0477-4ca1-8cf0-dd720a99697a,posted,Uber Ride,-568.36,b5d3acfa-5457-4ce5-bac2-5868cc1349ff,4551.57,debit,bank-fee,AU00000,2023-11-25T08:15:13Z
transaction,7d9e09b1-5182-4965-bf59-22825e1c46e5,posted,Movie Ticket Purchase,-2555.28,88841496-c906-466d-90d8-33b508e58e72,1996.29,debit,bank-fee,AU00000,2024-04-02T00:52:53Z
transaction,4dd25d06-5baf-42c4-a6fc-6256b390817f,posted,Pharmacy Purchase,-3134.78,a87d4010-2fd4-4966-add7-f1b7d0010dd1,16072.72,debit,bank-fee,AU00000,2023-10-30T01:29:03Z
transaction,707c34d0-13b1-4ad2-8549-9c07154f2cb7,posted,CTRLINK CARERS Ref: 998R6789201610974V,-379.25,cc44c4f2-9dfb-4a33-9a9d-24a177d2736a,15693.47,debit,payment,AU00000,2023-11-18T22:26:32Z
transaction,69b9cda4-13bf-462a-8a46-2b9343f72e9a,posted,Pharmacy Purchase,-188.46,581641b9-285f-4d88-a42e-fa9b3f6b1196,15505.01,debit,bank-fee,AU00000,2023-11-12T09:15:51Z
transaction,1d458e0c-ab4d-41e4-a2e5-330bd8f65c39,posted,Movie Ticket Purchase,-907.62,af08a5e8-372f-407f-b41b-a33723000134,14597.39,debit,payment,AU00000,2023-09-17T19:07:58Z
transaction,8912bfd4-0507-4460-82c9-cbe93eb8655d,posted,Netflix Subscription,-2979.62,00210170-72fc-4e2b-8da7-b53f90e1bbb6,11617.77,debit,bank-fee,AU00000,2023-09-13T00:36:29Z
transaction,7231362a-58c2-4484-8fef-2a71f2db4d1f,posted,Non Hooli ATM Withdrawal Fee,-1367.77,faf76c5e-19dd-44d8-8711-19bab554036f,10250.0,debit,bank-fee,AU00000,2023-08-27T09:02:34Z
transaction,ba03898f-3bbb-4b29-8310-dfb6832a2d80,posted,Gym Membership Fee,-954.82,facebce1-a82c-4662-bceb-8002f7c25bbf,9295.18,debit,payment,AU00000,2024-03-11T11:25:08Z
transaction,2003a637-c4e4-4786-853b-509f07caae93,posted,Transfer Platnm Homeloan 346454,-543.89,c93d55f6-3540-4a4e-a21a-6c04d8363e34,8751.29,debit,cash-withdrawal,AU00000,2023-07-20T21:13:26Z
transaction,d507e6f1-c446-44c9-b325-d32f330da84c,posted,Public Transport Fare,-4244.24,c512896e-022b-41dd-aa15-dca4588ff8ac,4507.05,debit,payment,AU00000,2023-12-30T11:48:16Z
transaction,7c3bdcb9-c84f-48e5-81df-bd22c36b13ea,posted,Travel Agency Booking,-1125.03,2aa4d830-b771-4534-950c-fa400222c56e,3382.02,debit,cash-withdrawal,AU00000,2023-08-27T01:37:28Z
transaction,8673a3db-714e-4935-ab11-7bc942fc56e2,posted,Non Hooli ATM Withdrawal Fee,-1754.96,5cdfbdb6-08dd-4c6d-badd-660b65bd27a7,15713.81,debit,cash-withdrawal,AU00000,2023-10-18T05:53:07Z
transaction,fecd669e-ac1c-4084-8c6a-4508cafe01ab,posted,Wdl ATM WESTPAC IGA BALGOWLAH BALGOWL AU,-1508.43,22cf2d0c-39b0-4ad5-bc8f-d783d14cd335,14205.38,debit,cash-withdrawal,AU00000,2024-04-25T11:38:28Z
transaction,3537eae0-e520-4e95-888f-0446ce272468,posted,Clothing Store Purchase,-4045.34,5d95075e-3e08-407a-972d-55574433678d,10160.04,debit,bank-fee,AU00000,2023-10-05T04:55:55Z
transaction,7bf83a79-7cc3-4431-b191-2ba31f971e03,posted,Transfer Platnm Homeloan 346454,-4206.32,2be1e4f3-1721-4fb9-8d79-deffbda98a6b,5953.72,debit,cash-withdrawal,AU00000,2023-06-05T03:33:50Z
transaction,c7192636-d7cb-4e1b-a4ee-9f5613db898f,posted,AGL RETAIL ENERGY LTD (GAS),-3996.21,41bc2bfa-3003-4fb6-8c0d-08923cb1707c,1957.51,debit,cash-withdrawal,AU00000,2024-03-15T02:55:49Z
transaction,8f6120fa-b09f-45b8-8381-5ef291ccca8a,posted,Transfer Platnm Homeloan 346454,-688.29,56b80e31-914b-4fa4-85ab-ca17040df99e,1269.22,debit,payment,AU00000,2024-01-25T11:55:48Z
transaction,6e485201-abe2-485d-9cdf-2eaa46726054,posted,Bookstore Purchase,-4914.76,74f2adf2-e040-4e11-8cc0-331b2c198e89,-3645.54,debit,cash-withdrawal,AU00000,2023-06-12T12:11:29Z
transaction,54ccb5b3-22d8-42ae-9a14-33ad2e805030,posted,Online Gaming Purchase,-347.99,a9426474-aa38-41f8-8cc2-271c42a782e4,-3993.53,debit,payment,AU00000,2024-05-10T07:10:38Z
transaction,1115a693-0308-4d24-859c-69af2d17e792,posted,Payroll WFRMS 15439393,10801.23,e022a504-05fc-4f58-8fac-fc50ef36dcfc,6807.7,credit,transfer,AU00000,2024-01-20T21:12:44Z
transaction,dc986c8d-7bd6-44a0-b366-003014faa041,posted,Online Gaming Purchase,-2771.91,38d27fe6-2a16-4240-8727-e64f1965286c,4035.79,debit,bank-fee,AU00000,2024-04-23T00:59:43Z
transaction,a098d7cd-4ced-45e1-9d34-2aaae6474fcf,posted,Movie Ticket Purchase,-3573.11,3aa43741-294f-4224-9963-00923720ff32,14476.7,debit,cash-withdrawal,AU00000,2024-03-24T18:39:51Z
transaction,110c78a2-f881-48b6-a3a2-bd894bf484f6,posted,Gym Membership Fee,-1023.36,d703f1cc-48ef-47ab-9395-6bc35c87cf6e,13453.34,debit,bank-fee,AU00000,2024-02-19T16:39:30Z
transaction,882bfb35-e026-438e-a18d-1effea02e559,posted,Payroll WFRMS 15439393,11874.39,1c328831-4649-4628-8607-b395f19bc60f,25327.73,credit,transfer,AU00000,2023-05-23T12:35:52Z
transaction,26c4a3d7-a61d-4973-915d-631fe8d5a3df,posted,Manly Maths Tutor Wages,-1733.37,cea70475-99c8-417f-b709-8fc31d6579b0,23594.36,debit,bank-fee,AU00000,2024-02-03T01:43:07Z
transaction,5c766a70-fbcc-44b1-8672-198dda0d26b8,posted,Uber Ride,-4185.17,6039008a-63cb-47ba-8477-eaf4e7590795,19409.19,debit,bank-fee,AU00000,2024-03-02T20:07:27Z
transaction,70d4b63d-4fe6-4316-ad46-f22788ecd7bf,posted,TFR Acc14000 TO 12389,-212.68,c97e52a8-7aa4-46fe-848a-c64a06015c6d,19196.51,debit,cash-withdrawal,AU00000,2024-03-18T08:22:24Z
transaction,1c60d5ef-113c-4185-9bb0-559af78d650d,posted,Music Streaming Subscription,-2800.62,90b2f758-b750-4fc3-8025-cda1df15edca,16395.89,debit,payment,AU00000,2023-09-28T09:25:08Z
transaction,e5a08464-325f-4357-80db-a1c6c3fd8065,posted,Electricity Bill Payment,-987.38,a9b2c30e-5873-4370-b798-76523d6633b5,15408.51,debit,payment,AU00000,2024-05-05T08:04:26Z
transaction,de4f1a4e-386c-4e4d-aa84-354b3e0bf2a9,posted,Music Streaming Subscription,-3244.65,6fbcaef7-702f-4a82-91d1-0b0434845944,12163.86,debit,cash-withdrawal,AU00000,2023-12-14T10:03:09Z
transaction,dbe98408-3351-472a-a14e-b943a24789fb,posted,Home Improvement Store Purchase,-3652.87,a6fbf217-c852-4850-b2a0-b03314c2a0d5,8510.99,debit,cash-withdrawal,AU00000,2023-06-10T19:41:17Z
transaction,5568b033-c812-43ec-882e-120b2b2609a1,posted,Bookstore Purchase,-819.28,9aaf22cf-6783-4471-83fb-395f1694ab73,14909.98,debit,payment,AU00000,2023-10-24T20:08:11Z
transaction,e4935845-ba9d-412c-a097-46b788ce1865,posted,TFR Acc14000 TO 12389,-2479.24,0cf55057-9e66-497e-a8ac-3936e34fbe5c,12430.74,debit,payment,AU00000,2023-10-26T16:52:30Z
transaction,7350f57b-4950-4a22-a797-019195a43118,posted,Wdl ATM WESTPAC IGA BALGOWLAH BALGOWL AU,-2302.34,b3f1cce4-f4a4-4a2b-8a33-c248dd2b0be3,10128.4,debit,cash-withdrawal,AU00000,2023-05-24T20:41:07Z
transaction,8d7880fb-22f0-418c-a9f1-514aea15d933,posted,Amazon Online Shopping,-4222.81,2f2229ee-8339-4113-96a4-d8d5c6b6d905,5905.59,debit,cash-withdrawal,AU00000,2023-06-15T17:38:46Z
transaction,dc019251-a1a4-4a41-bcec-7cb5104ec9ac,posted,Uber Ride,-3809.01,3bd20203-c5e1-4948-bd66-3e6c4abd2446,2096.58,debit,bank-fee,AU00000,2023-07-14T02:27:55Z
transaction,b679f88d-71f9-4641-8784-97d4b010ea68,posted,Bookstore Purchase,-205.84,5997e4f4-5d7f-4ab8-9be8-91a4a888b158,1890.74,debit,payment,AU00000,2023-10-31T02:12:07Z
transaction,640c4ec1-8a25-42db-912a-3f063d4d69bb,posted,Restaurant Dinner,-421.93,03c50cd4-3b0e-4f28-937e-2333800fc541,1468.81,debit,payment,AU00000,2023-07-08T17:47:00Z
transaction,909e2c2e-71cf-41ba-80cd-291b19d34dda,posted,Pharmacy Purchase,-908.57,7c64bb59-30f6-4101-9db5-ef0c92cfa7e4,560.24,debit,cash-withdrawal,AU00000,2023-07-30T16:59:01Z
transaction,dfd6b266-a05d-464d-aab1-5ac7f5bb9d58,posted,Non Hooli ATM Withdrawal Fee,-775.44,91dfbbf8-e627-4b7d-810f-b9dec0889f51,-215.2,debit,bank-fee,AU00000,2023-05-31T15:35:31Z
transaction,84f7a63a-4283-4c85-a226-8034273c553d,posted,TRANSFER TO JOANNA SMITH CAMPING,-4550.92,8d7ce6da-a4b4-4b9e-bed0-a996a1ae6d49,-4766.12,debit,payment,AU00000,2023-07-30T13:41:34Z
transaction,a80a5835-0ac4-44a0-87ad-ecc93e9a2479,posted,Uber Ride,-197.15,f8ffe8aa-8b42-4e24-a2a3-c3d577a02de4,19044.55,debit,bank-fee,AU00000,2023-05-31T23:52:32Z
transaction,a9f93127-e250-4990-85dc-09c4bf026c05,posted,Pharmacy Purchase,-3848.69,cf442a61-35d0-4cd1-9ef4-86e4d9d22496,15195.86,debit,bank-fee,AU00000,2023-05-14T22:39:00Z
transaction,0d5481f3-8301-4c62-aad6-c9072ca598bc,posted,Home Improvement Store Purchase,-1558.15,4cd9cc3c-0993-4993-8a99-18836a4f774b,13637.71,debit,payment,AU00000,2023-07-30T18:12:55Z
transaction,e51f5bdb-080d-4d0f-aa78-42ca022629ab,posted,Pharmacy Purchase,-4945.88,281ca850-8bfd-4a46-833d-09fac2c6422d,8691.83,debit,cash-withdrawal,AU00000,2024-02-08T05:21:19Z
transaction,c505fd46-4a14-4d14-9a3b-df8f68eb6805,posted,Manly Maths Tutor Wages,-3871.63,caaab0fa-dfd0-49f7-b86b-d6c729d705cb,4820.2,debit,cash-withdrawal,AU00000,2024-01-06T11:30:48Z
transaction,137c30e8-6e52-4e0a-8290-2ac40f84bdb2,posted,Clothing Store Purchase,-2256.91,6705d61a-fb25-479a-99a4-437c2f6a7935,2563.29,debit,cash-withdrawal,AU00000,2024-02-15T04:09:03Z
transaction,b18d4ff5-9279-4615-8cec-5720becc5c58,posted,Car Maintenance Expense,-474.92,2bee0b81-a99e-457a-b97c-26770d5ec52f,2088.37,debit,bank-fee,AU00000,2023-10-17T03:43:46Z
transaction,3e85a95a-6999-4f1d-ba49-433c14908252,posted,Travel Agency Booking,-586.09,cfa0bd7e-4fbb-4f11-bd9a-6cf1afbaf717,1502.28,debit,cash-withdrawal,AU00000,2023-09-25T09:46:17Z
transaction,a6188e2d-0d82-40af-9e62-742dc83da643,posted,Home Improvement Store Purchase,-893.57,9cfe384a-2a1a-469c-8843-cfd437a9e14d,608.71,debit,payment,AU00000,2023-11-03T18:37:24Z
transaction,8efe5093-115d-4959-b5cb-4b9224ab65df,posted,Coffee Shop Purchase,-2201.09,438d7d04-35f5-4d2d-8d6e-da1d53066c9a,-1592.38,debit,cash-withdrawal,AU00000,2023-11-17T10:53:36Z
transaction,cfe3b5c0-963b-4b62-a556-d78c905d9cab,posted,Coffee Shop Purchase,-2684.97,32ddb4a5-f653-45ea-8119-ac8cc9e09323,11841.67,debit,payment,AU00000,2023-11-12T15:56:51Z
transaction,86db4ef1-5906-43bf-89a1-32ef1801837c,posted,Wdl ATM WESTPAC IGA BALGOWLAH BALGOWL AU,-2900.58,f1d58592-0b65-4536-a9d6-6ff75efc4077,8941.09,debit,payment,AU00000,2024-01-24T11:06:56Z
transaction,30b48f1e-bbb4-4e87-92e7-8fd76c0c788d,posted,TFR Acc14000 TO 12389,-4986.18,c4f2613d-8fa0-49ae-b7de-5ff973e70b07,3954.91,debit,bank-fee,AU00000,2023-10-16T00:35:47Z
transaction,ec5e5ada-50ee-482f-9b4a-e4bd6fc51ee7,posted,Non Hooli ATM Withdrawal Fee,-51.2,224708aa-869e-4b16-b150-df50def34e87,3903.71,debit,bank-fee,AU00000,2023-10-03T11:50:08Z
transaction,fd130fcd-d1b6-4678-b732-abb61030c088,posted,Electricity Bill Payment,-3298.93,eb89dd28-e24a-4c49-9b5f-a599bbcdc6a7,604.78,debit,bank-fee,AU00000,2023-09-13T19:34:15Z
transaction,3fe7d3e7-6700-448d-825b-7f16d80eb2b6,posted,CTRLINK CARERS Ref: 998R6789201610974V,-2217.59,e5e0c4f1-c11e-4199-92c6-2b9466629ad1,-1612.81,debit,cash-withdrawal,AU00000,2023-10-23T01:10:06Z
transaction,c6378b90-22fd-4d91-9f4d-4c6dd9bdc04c,posted,Hair Salon Appointment,-2317.89,57f85a18-8718-48ab-aad2-811ec409fbb4,-3930.7,debit,cash-withdrawal,AU00000,2023-05-20T05:55:38Z
transaction,9eeeab99-77c4-48f1-8d4b-e42008d9a78d,posted,Bookstore Purchase,-2192.15,7d5b0c3d-a48e-48a8-b4d4-c1ec7f76f481,-6122.85,debit,payment,AU00000,2023-08-22T04:33:37Z
transaction,06d46d00-d5ea-41ad-a883-7c5712e39e78,posted,Gasoline Purchase,-2489.09,fc68b92e-c8c4-4de2-b9e9-c910168579b4,-8611.94,debit,payment,AU00000,2023-05-25T15:39:18Z
transaction,b45cc763-f351-4027-b93e-2b67250b88ee,posted,Electricity Bill Payment,-4917.98,0421d502-a5c1-4aa4-a66a-1410f7058bac,-13529.92,debit,bank-fee,AU00000,2023-12-26T16:07:25Z
transaction,bf981ca4-9508-4a65-b77e-85f5ea62e6cf,posted,Amazon Online Shopping,-3168.65,d54f064c-ab72-4a23-877d-f6ebb05626ab,11440.91,debit,payment,AU00000,2023-07-07T15:44:21Z
transaction,7163cf42-78ed-4107-8a4c-0beaf0ae2300,posted,Non Hooli ATM Withdrawal Fee,-620.87,03356065-255b-420b-b5ae-8e61d9234ec1,10820.04,debit,cash-withdrawal,AU00000,2024-03-22T19:13:14Z
transaction,af4f350b-968f-4549-95d0-aa1299731abc,posted,Amazon Online Shopping,-227.85,7908c8e7-7beb-436d-9e19-9a18ea645531,10592.19,debit,bank-fee,AU00000,2024-04-26T15:36:20Z
transaction,4c03d88f-b2fa-4615-af77-c7fe6fd298bb,posted,Gym Membership Fee,-2655.35,2df66c7a-53e5-4a76-8dbe-21533bd05c22,7936.84,debit,cash-withdrawal,AU00000,2023-07-22T10:32:26Z
transaction,a504eeda-adbb-4d7d-b438-82a8853d8fdc,posted,Car Maintenance Expense,-3595.79,7f067ba1-5010-4b97-b5a3-0a2631224e86,4341.05,debit,cash-withdrawal,AU00000,2023-08-12T12:01:46Z
transaction,7df07dea-6632-4bd9-a3d8-cbe839359bce,posted,TRANSFER TO JOANNA SMITH CAMPING,-2900.99,3e025c59-0902-466b-b4de-15e16adb6bd4,1440.06,debit,payment,AU00000,2023-07-27T03:46:45Z
transaction,b38910ba-c933-46a8-b86c-1344abb5e7a6,posted,Travel Agency Booking,-3071.2,07b56716-8cda-478b-be98-448da5c6b761,-1631.14,debit,payment,AU00000,2023-12-04T19:41:00Z
transaction,f86dfb5a-a107-415c-9649-60c0b7b8e0cc,posted,Clothing Store Purchase,-1657.55,639e5f9b-e9ce-4ead-a7cc-49a2858f9906,-3288.69,debit,cash-withdrawal,AU00000,2023-10-04T21:47:01Z
transaction,2aa26293-aed6-4b5d-9bf7-34d3f1c9ae65,posted,Wdl ATM WESTPAC IGA BALGOWLAH BALGOWL AU,-1496.18,b845d338-fdac-4b48-90ae-09cce166d417,-4784.87,debit,cash-withdrawal,AU00000,2024-02-28T11:44:00Z
transaction,533adc8b-483e-4967-a7ba-ea586d618350,posted,TRANSFER TO JOANNA SMITH CAMPING,-4141.75,a77d3124-ec6f-47ff-99ef-a702a7823368,-8926.62,debit,bank-fee,AU00000,2023-07-03T23:30:40Z
transaction,4e04cc39-cfd2-460b-8308-23d73a08a063,posted,Mobile Phone Bill Payment,-4332.26,a4f16cb0-c54c-46eb-b700-ff433f489ef2,8783.01,debit,payment,AU00000,2023-10-10T22:17:44Z
transaction,95f8fdc2-4c54-445a-87c6-240c44d0ae1c,posted,Home Improvement Store Purchase,-1176.25,00fc4c00-a9a2-4dc2-92c8-4941b9c27dae,7606.76,debit,payment,AU00000,2023-05-20T14:35:41Z
transaction,966306c1-0e92-4905-b0e5-b0b6ca5b230e,posted,Electricity Bill Payment,-3493.72,1e51f4e7-4c16-472b-88a1-700416259274,4113.04,debit,payment,AU00000,2023-10-15T10:34:28Z
transaction,8b3287bc-6500-4b2b-b260-ee461f7cb7ed,posted,Music Streaming Subscription,-2389.48,0eb584f4-c3a4-4b49-ba85-895aa5f027f6,1723.56,debit,cash-withdrawal,AU00000,2023-09-27T15:25:25Z
transaction,bca0b96d-460f-49b9-a471-922f8256efaf,posted,Bookstore Purchase,-2979.44,769b30cc-8bdb-42d8-9a6f-3859dfe641a4,-1255.88,debit,bank-fee,AU00000,2024-01-12T15:23:07Z
transaction,d5853b17-25d0-4549-bc7e-1c18f5439e54,posted,Electricity Bill Payment,-2662.9,b625d32f-716f-45c4-9ff5-96d349d8edaf,-3918.78,debit,payment,AU00000,2023-07-17T06:26:30Z
transaction,74f7f60e-f3a1-455e-84eb-d75ba5a2e168,posted,Non Hooli ATM Withdrawal Fee,-1930.75,9c90df96-122f-468e-8a61-8cfe3c937bec,-5849.53,debit,bank-fee,AU00000,2023-06-25T10:02:34Z
transaction,73c2572c-468d-45c0-9063-46b5eab3e96d,posted,Restaurant Dinner,-1375.9,f728edea-349a-4d64-8087-2179fe833801,-7225.43,debit,cash-withdrawal,AU00000,2024-01-20T20:34:06Z
transaction,47dd6df8-38b4-4148-9280-7c4ca7feaf0b,posted,Travel Agency Booking,-1276.64,d88c8b42-a6a2-484e-bf40-d554620535c1,-8502.07,debit,cash-withdrawal,AU00000,2023-07-20T03:31:41Z
transaction,25ea3e27-c48e-48e3-aed3-e2590f9c639a,posted,Transfer Platnm Homeloan 346454,-1912.57,42f5a6e3-6c4a-4751-a4dc-3a4a59841855,-10414.64,debit,cash-withdrawal,AU00000,2024-05-02T19:16:59Z
transaction,8f297faf-301a-4c71-9488-f44fb909ee8c,posted,Gasoline Purchase,-1797.12,e0bfd08c-3b48-4c58-9ef2-43c5aa1ce2d0,17585.85,debit,bank-fee,AU00000,2023-07-17T23:16:59Z
transaction,e7bc2102-380f-4683-8730-557415303e92,posted,Home Improvement Store Purchase,-4889.32,fe7befd6-986f-4e00-b4c1-7fe1c437a615,12696.53,debit,cash-withdrawal,AU00000,2024-01-23T04:53:36Z
transaction,7cac108a-95cc-4474-84b6-6aa0d6cbf414,posted,Travel Agency Booking,-4130.72,ec3016b4-1ef4-4356-bf9b-ea0a4d3bd457,8565.81,debit,payment,AU00000,2023-06-21T20:16:39Z
transaction,50965526-6683-44db-9508-c1b8ae2f5344,posted,Gasoline Purchase,-2534.58,3cc4f339-5b36-4c87-8398-fc468c7418ae,6031.23,debit,bank-fee,AU00000,2023-07-17T08:40:18Z
transaction,6523a442-4d31-45ce-adbc-dc943e3cce72,posted,Gasoline Purchase,-816.29,29b5fa0a-0442-4dd8-822b-d69293e484eb,5214.94,debit,bank-fee,AU00000,2024-01-26T00:01:55Z
transaction,8b3d3150-6614-4379-b54a-d188f466446d,posted,Online Gaming Purchase,-919.59,4e95fff2-5ddb-474f-898c-0511c4f10ab0,4295.35,debit,cash-withdrawal,AU00000,2023-05-29T20:23:00Z
transaction,9510e2a9-0a52-4aa2-b107-942dbb425574,posted,TFR Acc14000 TO 12389,-3239.97,189dfc6e-8e41-4046-8416-7856c11e25ed,1055.38,debit,bank-fee,AU00000,2023-10-21T20:48:16Z
transaction,9452fd0d-bc2b-4e55-9a32-a59ed7f5ba2d,posted,Travel Agency Booking,-1423.18,37b98eb4-c35e-449f-8209-88a7a45f834f,-367.8,debit,payment,AU00000,2024-03-22T00:29:30Z
transaction,4fefb66b-521f-48e3-ae0f-1172754f2b97,posted,TFR Acc14000 TO 12389,-1795.14,157e4cb4-c4b8-495b-a8b7-a8b13ef3d62a,-2162.94,debit,payment,AU00000,2024-02-23T11:03:04Z
transaction,b762454d-b5af-4a00-aea5-f924e297746f,posted,Manly Maths Tutor Wages,-143.02,c6e72145-4382-4423-b84a-9ed468b9afbf,-2305.96,debit,bank-fee,AU00000,2023-07-15T05:52:19Z
transaction,b7d75f44-0860-4ad6-9009-04bf5e799ae8,posted,Uber Ride,-4107.23,ced6651b-eb81-49a5-ad2b-a8239ac5d2b2,10568.35,debit,cash-withdrawal,AU00000,2023-09-20T12:48:14Z
transaction,3b492f2f-0495-47d0-8f67-e307b46e4864,posted,Travel Agency Booking,-4831.53,e72cbd2b-91bf-4b6e-9447-ec6324e4dc48,5736.82,debit,cash-withdrawal,AU00000,2024-05-06T05:07:59Z
transaction,a76a5a3d-790f-4c98-a19a-4ac4c1ea22e5,posted,Pharmacy Purchase,-1482.89,c0338238-f7fb-445b-aedd-355c6044ac95,4253.93,debit,payment,AU00000,2023-05-16T10:49:00Z
transaction,8ca2fdd2-45f8-4f9e-86db-cfc3942089ac,posted,Non Hooli ATM Withdrawal Fee,-3742.12,1b2978e8-b2d1-4522-a738-aac0391de5b5,511.81,debit,payment,AU00000,2023-10-20T11:10:10Z
transaction,6c0a3577-a62b-4eea-970a-aac414830dbf,posted,Movie Ticket Purchase,-1021.29,b561ee98-f2a2-4a59-9395-ea403a8b1088,-509.48,debit,cash-withdrawal,AU00000,2023-07-08T23:12:37Z
transaction,99369491-5194-446a-9e30-6d001312fae3,posted,Amazon Online Shopping,-840.81,efc92d87-5f30-4c21-b340-6799240c571d,-1350.29,debit,payment,AU00000,2024-03-10T02:28:58Z
transaction,f1ed1734-6bf6-41c6-8fd6-217815eeaa38,posted,Wdl ATM WESTPAC IGA BALGOWLAH BALGOWL AU,-333.07,2dfdb517-8fde-4f1a-9388-5fab5f0ee3c9,-1683.36,debit,payment,AU00000,2023-10-08T01:30:12Z
transaction,13cba9b3-a748-40c8-95db-f1f48993d4e8,posted,TFR Acc14000 TO 12389,-3752.14,5385d97c-625d-47f1-9195-d4fcf58e8a99,-5435.5,debit,bank-fee,AU00000,2024-03-17T16:33:32Z
transaction,2ed785ca-acbc-4df5-a99c-b84082bd5fc5,posted,CTRLINK CARERS Ref: 998R6789201610974V,-1700.9,aa9b3443-d867-4b26-8348-cf04da62110f,-7136.4,debit,cash-withdrawal,AU00000,2023-12-09T12:22:41Z
transaction,ee2dda5c-f12c-4f5a-8c5a-1c8a780045d1,posted,Car Maintenance Expense,-2620.16,ec5700dd-6896-48ab-a441-6ad2671003ad,-9756.56,debit,payment,AU00000,2023-09-28T19:37:29Z
transaction,a4f7fbbf-c464-4e66-b069-f4e8fe70d646,posted,Gasoline Purchase,-1630.6,1f95809a-bf90-488c-9af7-06fd2e0693c7,10685.46,debit,payment,AU00000,2023-09-04T03:49:46Z
transaction,df30ff6c-39a4-47c6-a15d-cc0b720a76c4,posted,Public Transport Fare,-2386.4,b8436702-4a47-49b2-b4e2-f3b5def361d3,8299.06,debit,payment,AU00000,2024-04-23T07:11:50Z
transaction,a963396d-f87e-4a12-8790-967a3e31b472,posted,Electricity Bill Payment,-2090.06,227c8bb1-1a6b-4977-b222-e89354cdf485,6209.0,debit,payment,AU00000,2024-03-12T08:21:58Z
transaction,31324d4c-b707-4565-8d1b-a8ba7480addf,posted,Wdl ATM WESTPAC IGA BALGOWLAH BALGOWL AU,-4557.9,fc742bb8-4d2d-41c3-ab5f-93f375f81669,1651.1,debit,cash-withdrawal,AU00000,2024-05-02T22:23:55Z
transaction,7b9e510e-7655-40de-9782-9f69e41bb46b,posted,Payroll WFRMS 15439393,10112.4,ad30a9f9-af70-46a2-9c6b-7b5e246cfb30,11763.5,credit,transfer,AU00000,2024-03-02T04:24:21Z
transaction,8ed8965a-c082-46e5-ba51-719ddb529acb,posted,AGL RETAIL ENERGY LTD (GAS),-2389.75,3ca97fce-593e-446f-9f74-dd22119b0106,9373.75,debit,bank-fee,AU00000,2023-08-26T16:48:09Z
transaction,90f19a49-70c8-4e2d-8759-373d2098f675,posted,Electricity Bill Payment,-2790.76,9f76ef37-e57b-4d7d-a44a-8239d367e17b,6582.99,debit,bank-fee,AU00000,2023-07-09T07:34:19Z
transaction,0f2ae215-2b9a-478e-812f-5dee7e20a3f3,posted,Transfer Platnm Homeloan 346454,-205.57,33ee70db-f1f5-46fd-8fcc-7344bbcac83a,6377.42,debit,bank-fee,AU00000,2023-10-15T05:50:45Z
transaction,fdbddddf-0680-41b9-a148-49753cb26bfd,posted,Clothing Store Purchase,-2596.57,12ace391-923f-4523-acf4-72c8b7df882a,3780.85,debit,bank-fee,AU00000,2023-10-07T01:14:22Z
transaction,f0715e12-db69-4496-912a-09e36066a699,posted,Amazon Online Shopping,-2416.99,03a5bb91-2f56-4240-9173-67d405f6cc24,1363.86,debit,cash-withdrawal,AU00000,2023-09-27T06:01:03Z
transaction,d5126e31-2933-4f0a-860e-3cccd5c785ca,posted,Payroll WFRMS 15439393,11557.95,a36df194-7932-4971-9093-74f04e04faf4,17471.45,credit,transfer,AU00000,2023-05-31T10:37:47Z
transaction,13570041-0189-41e8-802a-a39642be4f5a,posted,CTRLINK CARERS Ref: 998R6789201610974V,-3109.14,e841e3ef-b85f-4ef6-9ab2-821bf6e6afd4,14362.31,debit,payment,AU00000,2024-01-14T08:49:10Z
transaction,6ad86e0f-8a7e-4efc-807b-ce3ee2c70ee0,posted,Manly Maths Tutor Wages,-298.23,7aa81ee4-acbb-4b40-a254-561ce1224f14,14064.08,debit,payment,AU00000,2024-02-27T17:10:43Z
transaction,722ef2fa-3b16-4c57-8713-5ad07e04500d,posted,Restaurant Dinner,-2714.51,7d0c3147-d7ba-4c41-ae82-a9d6e4a46656,11349.57,debit,payment,AU00000,2023-10-15T19:05:02Z
transaction,96954bbd-039b-4dfe-9f39-22d3b696164f,posted,Restaurant Dinner,-4370.2,22b01de4-251e-45c9-a2f8-f5593842f929,6979.37,debit,bank-fee,AU00000,2024-01-27T03:20:18Z
transaction,6c310d2c-2a5e-4660-9a40-1b4c02d5a7db,posted,Clothing Store Purchase,-1750.65,4963f23a-0cec-4c11-a09f-6cccd75db77b,5228.72,debit,bank-fee,AU00000,2023-06-02T23:28:58Z
transaction,30b767e2-2d42-4b0d-bf97-4766c3a30ccc,posted,Netflix Subscription,-1006.34,75c0f1b9-fdb9-4327-97b5-b3b0f7847ea8,4222.38,debit,payment,AU00000,2023-07-21T06:03:30Z
transaction,1d20a66d-8dda-4a6e-ab8c-474eb6ce0d41,posted,Transfer Platnm Homeloan 346454,-2436.74,9b08bedd-30fe-48fc-a57e-68830c47bded,1785.64,debit,bank-fee,AU00000,2023-08-30T08:28:41Z
transaction,101ef678-b188-4a9b-a020-c4156021e1b7,posted,Public Transport Fare,-3966.76,c1153f0d-952e-433e-8f07-c0e100fc4a9c,-2181.12,debit,payment,AU00000,2023-10-29T10:58:49Z
transaction,7d484661-360d-44f2-b846-4a297d94c64f,posted,Gym Membership Fee,-773.31,25666544-240a-4fe9-943b-24cb9154e769,-2954.43,debit,cash-withdrawal,AU00000,2023-08-27T20:17:36Z
transaction,729343ee-0806-4af0-a542-7fbb27db3ab1,posted,Home Improvement Store Purchase,-689.33,3b7f295f-aa05-4d89-a1bd-5301644fc6e9,5297.39,debit,bank-fee,AU00000,2023-12-31T07:50:15Z
transaction,8ab7bf4a-3c2e-4d24-b6b8-4088e16da76f,posted,Clothing Store Purchase,-3675.54,1ac535c8-3669-498c-a9a8-d8ed567c62e5,1621.85,debit,cash-withdrawal,AU00000,2023-09-30T22:28:20Z
transaction,14675660-55c4-4cbe-b040-30956a4deeb0,posted,Manly Maths Tutor Wages,-1810.56,a9c0e426-c65e-431a-bf47-9575681a245b,-188.71,debit,cash-withdrawal,AU00000,2023-09-20T23:26:35Z
transaction,6daf8357-06be-4a87-a3c7-a1d28e10944b,posted,TFR Acc14000 TO 12389,-624.91,571b331c-5a43-40fb-a9ca-b5366afb227a,-813.62,debit,payment,AU00000,2023-10-02T23:25:29Z
transaction,2734659c-4663-4ef3-b693-1feeccfe86d5,posted,Manly Maths Tutor Wages,-3311.75,8e33be8e-b1dd-4126-8349-a477641dd609,-4125.37,debit,bank-fee,AU00000,2024-05-08T12:46:36Z
transaction,3eee8d9d-1c45-4117-b41c-157d9b2501fd,posted,CTRLINK CARERS Ref: 998R6789201610974V,-2447.61,4efa1a42-53d4-4c16-9476-7092d0c703ac,-6572.98,debit,bank-fee,AU00000,2023-11-08T09:34:50Z
transaction,d0e2f2bf-c95f-4e1e-8492-f1a754cf6fc4,posted,TFR Acc14000 TO 12389,-2354.12,f25f27ce-4c38-4daa-a55e-6d68fe02372c,-8927.1,debit,cash-withdrawal,AU00000,2023-12-27T11:51:20Z
transaction,85e30434-1235-47e2-8444-4109b4d3edf7,posted,Hair Salon Appointment,-4327.93,04474084-c20f-46ae-ad9b-a583498de895,-13255.03,debit,cash-withdrawal,AU00000,2023-08-10T19:16:12Z
transaction,786f7355-0f62-4c8d-850a-80073a5616f9,posted,Uber Ride,-1896.86,b955bb23-1a5a-4bce-bba5-982aa4c86638,-15151.89,debit,bank-fee,AU00000,2024-02-23T17:14:39Z
transaction,82356de1-b86e-4f2c-b211-37072f57199b,posted,Car Maintenance Expense,-514.82,77163f66-8b60-4a3a-aec0-f4f0c3c0f5d9,-15666.71,debit,cash-withdrawal,AU00000,2024-03-30T23:00:47Z
transaction,66767b31-0f94-4b10-a8c2-a1e479de93fc,posted,Non Hooli ATM Withdrawal Fee,-322.38,d9879983-469e-41e0-a265-52f14f35e46e,13506.9,debit,bank-fee,AU00000,2024-03-26T19:08:31Z
transaction,248d6682-b65f-452b-a3c2-c8d94b591faa,posted,Netflix Subscription,-834.5,5366407b-2b50-4b09-8849-91df045be70d,12672.4,debit,bank-fee,AU00000,2023-11-01T03:24:41Z
transaction,b04dbe28-d37a-40c1-9083-d03e161ee769,posted,Pharmacy Purchase,-4510.65,e3948d36-3011-47b5-8148-edc49fb0d2b6,8161.75,debit,cash-withdrawal,AU00000,2024-04-18T19:12:32Z
transaction,378d91ca-ca3a-4a03-9a85-3961bc189ed9,posted,Transfer Platnm Homeloan 346454,-627.37,2d44ee07-dc9c-4a44-a549-33c0db0b8175,7534.38,debit,payment,AU00000,2023-06-07T14:37:33Z
transaction,82a5f189-7108-4a33-ad62-2c51123ecba5,posted,TFR Acc14000 TO 12389,-886.49,30d18174-58bd-422d-a781-0058356537d2,6647.89,debit,cash-withdrawal,AU00000,2024-03-11T23:37:59Z
transaction,c5eee457-6e37-4f47-a9bc-546c3816636a,posted,Pharmacy Purchase,-3990.76,164b286e-cf22-46f5-8bfc-b4fc6a358fd0,2657.13,debit,bank-fee,AU00000,2023-07-13T02:00:13Z
transaction,6bec9f40-118b-4854-aba8-3c5b1d8b06bd,posted,Mobile Phone Bill Payment,-3314.58,acdd620f-2552-4065-900a-14a8620a0bc4,-657.45,debit,cash-withdrawal,AU00000,2023-12-27T03:20:38Z
transaction,3ac1bbc4-0544-4970-be34-945d70cf9026,posted,Mobile Phone Bill Payment,-4892.34,ae6fd6f1-6d2f-450a-bb25-186bcc223b9e,-5549.79,debit,cash-withdrawal,AU00000,2024-04-27T07:34:44Z
transaction,2b334a62-1a37-46a0-b26b-3b790c4a1b0f,posted,Home Improvement Store Purchase,-1001.7,3b80f29d-5fa2-4276-959d-62d39a90cdb9,-6551.49,debit,cash-withdrawal,AU00000,2023-05-22T17:42:29Z
transaction,dd9d26b8-7016-4a2c-b72e-e461edf26aa9,posted,Electricity Bill Payment,-3484.33,4e724652-89ee-43a3-95ec-c0f785d118ce,-10035.82,debit,bank-fee,AU00000,2023-08-30T02:04:19Z
transaction,2f913dc8-031f-4e8f-83f9-d61cc84c5e88,posted,Movie Ticket Purchase,-3599.69,4eca8dd0-c01d-418f-b375-b3fbb9ca5f9c,5458.48,debit,cash-withdrawal,AU00000,2023-05-22T05:16:25Z
transaction,ad3908fa-e227-49b6-a628-917eb8ae35b1,posted,Clothing Store Purchase,-2951.19,bad4b903-80cb-469a-94fa-7ce4902734cf,2507.29,debit,cash-withdrawal,AU00000,2024-03-08T16:56:46Z
transaction,8d0304f1-b62d-4289-9197-cbdb1058801d,posted,Clothing Store Purchase,-552.89,5d7813f1-2108-467f-bd54-b1fe3c901e0a,1954.4,debit,payment,AU00000,2024-04-30T16:45:07Z
transaction,a3afd53d-0c90-4187-998e-1858272cb885,posted,AGL RETAIL ENERGY LTD (GAS),-2019.7,72ee1a16-9ba2-43ad-9dc7-83012323fcac,-65.3,debit,bank-fee,AU00000,2023-12-10T21:14:44Z
transaction,dbe7eec6-caaf-4a3d-8221-435ef89b94de,posted,TFR Acc14000 TO 12389,-4800.39,c33b3b28-79d0-4efe-8cca-e8f7e89b4725,-4865.69,debit,bank-fee,AU00000,2023-12-27T00:44:37Z
transaction,451682fa-5a82-4efe-978f-be8cd542da25,posted,Amazon Online Shopping,-2684.18,cbd533f7-0e90-4400-820e-81dd7ce5c41b,-7549.87,debit,cash-withdrawal,AU00000,2023-09-12T17:06:04Z
transaction,a4f7a250-e08d-4720-8f16-83e0cf5f976d,posted,Movie Ticket Purchase,-896.86,214e6fd3-4001-4044-bc89-c20a0a04e161,-8446.73,debit,cash-withdrawal,AU00000,2023-09-06T21:24:45Z
transaction,f8e007d7-1f5d-4305-83b4-f67e3baea3d7,posted,Travel Agency Booking,-2709.43,42c9dfae-6ad4-43ae-bd9b-77e3dffb3578,-11156.16,debit,cash-withdrawal,AU00000,2023-12-06T23:31:33Z
transaction,4699b0ab-23a2-4bef-a354-a19010a33ae9,posted,Gym Membership Fee,-180.15,3830fbb1-3538-47d8-8ea0-d3cc4f57a2d3,-11336.31,debit,bank-fee,AU00000,2023-09-24T00:29:48Z
transaction,72e9a8ad-5787-4fdc-8e5d-b11f8ec825be,posted,Non Hooli ATM Withdrawal Fee,-1602.15,386e0b35-df7a-47d6-b56d-02637e871525,-12938.46,debit,cash-withdrawal,AU00000,2023-05-29T20:40:44Z
transaction,503797df-2aa1-49b1-995b-188debf0be9d,posted,Travel Agency Booking,-1476.8,49f079e5-71e9-4a13-8a41-1e2c406af026,7501.06,debit,bank-fee,AU00000,2024-01-17T18:11:26Z
transaction,bc0f381d-638e-44a0-b5ec-ced176b02e1a,posted,Car Maintenance Expense,-1209.18,32b246f6-105d-425e-a232-ff5436cad055,6291.88,debit,cash-withdrawal,AU00000,2023-09-22T14:17:47Z
transaction,75d02abc-5608-4d21-a56f-fdc3ccae8cb6,posted,Electricity Bill Payment,-1931.5,cb4e2af5-ad72-4f8a-a489-0364604da04d,4360.38,debit,cash-withdrawal,AU00000,2023-10-21T17:05:55Z
transaction,cea823c4-1872-452e-8cb8-7ff111c6fa80,posted,Travel Agency Booking,-1879.72,b55e5fbf-496e-48c4-aad9-40a29c1d69be,2480.66,debit,bank-fee,AU00000,2024-04-21T10:16:16Z
transaction,55be6200-0c81-4076-b373-f9a5893452f2,posted,Gym Membership Fee,-3114.35,5a317f3a-8dfc-4a1a-b506-c67a8010ae69,-633.69,debit,payment,AU00000,2024-01-03T15:35:31Z
transaction,092b4f7b-17cd-46d0-90f2-d7d712ab4a53,posted,Payroll WFRMS 15439393,11968.76,383e2bbd-746e-40a1-872e-d9a3fd8f7d79,11335.07,credit,transfer,AU00000,2024-05-09T03:39:00Z
transaction,609ab8ec-3b0c-4337-a363-5ae00b17df70,posted,Amazon Online Shopping,-2604.07,e2d0e3da-0d01-420d-8e3c-e4c964b56520,8731.0,debit,bank-fee,AU00000,2023-05-26T00:18:19Z
transaction,64bbfa23-787a-476c-840c-b05e4d09d5ff,posted,Restaurant Dinner,-3428.32,8fefac4e-f0fb-4946-9eea-9c548794dc9f,5302.68,debit,bank-fee,AU00000,2024-02-27T04:28:36Z
transaction,ad0d447b-c172-4614-8ae0-4834ea04ce3f,posted,AGL RETAIL ENERGY LTD (GAS),-4065.52,75f9071c-58de-4b2e-9530-a114c4234c44,1237.16,debit,cash-withdrawal,AU00000,2023-10-22T17:59:25Z
transaction,533f03f3-5563-4064-8ede-711810479d85,posted,Transfer Platnm Homeloan 346454,-2825.26,d282a062-f9b0-4410-837b-16d9db974964,-1588.1,debit,payment,AU00000,2023-08-13T10:49:39Z
transaction,cb93763c-fa43-45ba-b6a3-873fa86ea2e4,posted,Car Maintenance Expense,-3388.12,493b801c-e54e-4333-918e-b2f354ad8883,9706.4,debit,cash-withdrawal,AU00000,2023-07-08T19:18:29Z
transaction,cdb70e8d-bbda-48ae-ad0f-1c8c447228bd,posted,Online Gaming Purchase,-4139.41,ef0ba3c1-97ac-4675-8a25-ae5d23d6fb55,5566.99,debit,bank-fee,AU00000,2023-12-05T21:41:02Z
transaction,326789ed-5a49-4453-b207-047d2636214a,posted,Travel Agency Booking,-434.12,63beaa36-0522-4c7e-a71c-b912fac74f2a,5132.87,debit,cash-withdrawal,AU00000,2023-12-12T15:23:30Z
transaction,e70fdfb6-c952-4beb-beab-ca68e63c2a0f,posted,Restaurant Dinner,-4716.77,ca8f9d4c-b387-47f8-acef-2d01230c4dd4,416.1,debit,bank-fee,AU00000,2023-10-15T20:51:58Z
transaction,9fe1463c-2aef-48d8-a256-287a6cef4b23,posted,Non Hooli ATM Withdrawal Fee,-627.37,9a8bc4f5-33f9-4289-a976-d2bd5736d012,-211.27,debit,payment,AU00000,2023-06-07T16:48:28Z
transaction,9527164e-feb8-4e1a-a1c5-a48a3a9e3fdc,posted,Transfer Platnm Homeloan 346454,-690.18,f29aa13c-304b-43a4-b6bd-928b30bbc521,-901.45,debit,cash-withdrawal,AU00000,2023-10-31T20:31:26Z
transaction,0c49c356-cec6-40f0-8777-7676365bb0b6,posted,Music Streaming Subscription,-413.53,6b31149a-c841-4e9d-ab4c-585b6627d2ef,-1314.98,debit,payment,AU00000,2023-11-07T21:48:20Z
transaction,3c6dcbc9-9797-4193-b647-207126222b99,posted,Gasoline Purchase,-4809.27,987c8b84-f4a6-49f5-b61d-ace37d1eb520,-6124.25,debit,cash-withdrawal,AU00000,2024-03-30T14:45:47Z
transaction,585f16c3-a565-467d-87fc-c5d2e4eb7fbe,posted,Gasoline Purchase,-4682.12,e3a07633-2539-4719-81ed-ce8c33b75ee5,-10806.37,debit,cash-withdrawal,AU00000,2023-12-29T08:32:28Z
transaction,585247a2-f424-4047-831c-9af9302f2c20,posted,Pharmacy Purchase,-4645.49,ebd4e69b-4115-431c-a01c-ad7002d7b1ef,-15451.86,debit,cash-withdrawal,AU00000,2024-01-29T18:34:17Z
transaction,7f07d05e-4e21-4ae9-ba95-581ecaad7def,posted,Netflix Subscription,-4692.61,2adb5897-f020-4fd5-86c7-7b2266f33c11,5482.88,debit,cash-withdrawal,AU00000,2023-08-04T02:45:25Z
transaction,a931c3dc-518f-4c92-b663-85849c3694f6,posted,Movie Ticket Purchase,-4141.24,1b1af86b-271c-4708-920b-87a4085a5a2d,1341.64,debit,bank-fee,AU00000,2024-04-08T14:22:10Z
transaction,3ec30a19-01c8-41c0-b738-ab1df6693ec2,posted,Pharmacy Purchase,-3947.79,f221a587-754f-433f-a306-f2b08dc66778,-2606.15,debit,payment,AU00000,2023-09-14T07:11:37Z
transaction,3cd24353-4e97-43c6-9e0a-6ee8b98c7c96,posted,Bookstore Purchase,-4871.61,09939f32-6aaf-468b-99e1-b4629a9c1b9e,-7477.76,debit,cash-withdrawal,AU00000,2023-08-19T04:46:59Z
transaction,0fdd2ac6-eeb9-40d2-80f1-dee2b85c738a,posted,Manly Maths Tutor Wages,-4552.02,328e3aad-f1f1-4462-a1e7-938fd9a4552f,-12029.78,debit,payment,AU00000,2023-11-27T02:47:49Z
transaction,5ece1ef0-26b7-4625-a9e3-9f687d5550e2,posted,Payroll WFRMS 15439393,11456.2,6f092471-4766-4eab-9a5e-79f69b1c7d9b,-573.58,credit,transfer,AU00000,2023-06-23T12:09:43Z
transaction,0e50d49f-2dc1-4a57-b1ff-43f8b13d21a0,posted,Electricity Bill Payment,-1732.34,fb94ec46-c116-4eca-87ee-943f32655fe5,-2305.92,debit,bank-fee,AU00000,2023-09-30T11:20:44Z
transaction,e21c8d40-22fb-4fa4-923f-e3e91279eb1a,posted,AGL RETAIL ENERGY LTD (GAS),-6.77,91150f2a-0949-4937-b16d-0903e50e9a99,-2312.69,debit,bank-fee,AU00000,2023-05-20T03:55:33Z
transaction,24b8cb27-876a-4b8b-99d2-7f2033128373,posted,TRANSFER TO JOANNA SMITH CAMPING,-3667.31,509f5bce-7786-42ad-a25b-6600217a2a01,-5980.0,debit,payment,AU00000,2024-01-24T02:15:20Z
transaction,034a9515-5afc-4835-999a-bb460ebcdaf0,posted,Public Transport Fare,-3994.98,8093130b-0c8a-41c4-8ce2-519be70236f9,-9974.98,debit,payment,AU00000,2024-03-15T08:50:13Z
transaction,7689790d-6406-473e-a9a0-df66c6e3ed3c,posted,Non Hooli ATM Withdrawal Fee,-1351.04,75da7725-77d0-4c2b-9649-0d243e90a388,12637.35,debit,bank-fee,AU00000,2023-09-06T20:31:13Z
transaction,c9ba4081-4e73-48e5-9f40-d4c8c6b60346,posted,Music Streaming Subscription,-1602.66,070c157f-7b10-499a-804d-a64763a7b6f5,11034.69,debit,cash-withdrawal,AU00000,2024-04-27T01:47:47Z
transaction,ec910244-bc9b-44c2-aa12-1568c70daf0c,posted,Clothing Store Purchase,-204.68,5cc4f696-7ec4-4b0a-9f1a-e816289a6975,10830.01,debit,bank-fee,AU00000,2024-04-09T09:57:05Z
transaction,555a7002-1ca2-4fab-a659-2bb2ba5ff507,posted,Pharmacy Purchase,-1271.4,4ddbb087-3c5d-4513-a3c1-57d80b845f1b,9558.61,debit,cash-withdrawal,AU00000,2024-01-09T22:24:00Z
transaction,09c7cd1b-8831-48ad-8d4f-d1b8eaeb3c04,posted,CTRLINK CARERS Ref: 998R6789201610974V,-991.84,a466c44e-121c-4a7c-9b2a-289925a1563d,8566.77,debit,payment,AU00000,2023-07-29T13:27:13Z
transaction,23ee7d09-0388-4461-a2ca-cca1ee350f8b,posted,Music Streaming Subscription,-3180.27,4533a6c8-1077-4c5b-8a90-9c50bd276b2b,5386.5,debit,cash-withdrawal,AU00000,2023-10-10T00:04:30Z
transaction,95eee4d0-5785-4199-9929-f27f67c9a992,posted,TRANSFER TO JOANNA SMITH CAMPING,-3984.99,e7ff11cd-8548-4b14-b120-94d3fa40f3b4,1401.51,debit,payment,AU00000,2023-10-25T13:19:24Z
transaction,8e2cdc97-0d68-4ce1-ad0c-7d6d8ae67d04,posted,Coffee Shop Purchase,-1045.45,ac85ec96-7d43-4f5f-8f0a-1f74daaa5c25,356.06,debit,payment,AU00000,2023-11-11T23:39:22Z
transaction,8e85d313-d460-4be0-a303-014bbdf734b8,posted,TFR Acc14000 TO 12389,-1229.49,df8ff074-3dca-4d35-b8ff-2bd0a036633a,-873.43,debit,bank-fee,AU00000,2023-08-27T02:28:57Z
transaction,7f074f76-6938-4eb8-b0a9-b7a66b3706e8,posted,Car Maintenance Expense,-4173.56,e403f89c-f6a8-4cb5-9743-8d0489102ff1,-5046.99,debit,payment,AU00000,2023-11-04T23:10:38Z
transaction,ac6411fd-2cd2-4e98-8258-8d34a0ae138f,posted,Manly Maths Tutor Wages,-251.15,178b3a25-abd5-4d91-94b2-056477c84ffb,19220.93,debit,cash-withdrawal,AU00000,2023-07-03T04:49:02Z
transaction,b6e7565d-0a41-41fe-967c-43e2afd7b573,posted,Coffee Shop Purchase,-2613.99,af308efb-6c86-499e-badf-a23e5ad64a6d,16606.94,debit,bank-fee,AU00000,2023-09-19T17:14:45Z
transaction,9b5e471a-7aea-4631-afa9-d0a6b342694f,posted,Restaurant Dinner,-2758.11,40c20c4a-e745-4099-aa3e-7905da3f92a3,13848.83,debit,cash-withdrawal,AU00000,2024-01-24T01:07:32Z
transaction,dfe9302e-e449-43df-ad8e-1fc99e66c2f4,posted,Clothing Store Purchase,-384.72,80e9dd6c-1082-4948-b2e4-3af91a7ce82b,13464.11,debit,payment,AU00000,2023-07-23T01:05:10Z
transaction,30756636-c5f9-4519-926a-3e5f9e1ae2cf,posted,Electricity Bill Payment,-4475.4,a4c1e0b6-8c6e-4f4d-a1a5-ec0458d15edf,8988.71,debit,payment,AU00000,2023-11-21T14:13:19Z
transaction,d410aa94-7cbc-480f-abd5-a0067428e04b,posted,Bookstore Purchase,-2111.79,8b10edd6-ef10-479f-a82b-7f79f17d4147,6876.92,debit,bank-fee,AU00000,2024-01-06T13:15:39Z
transaction,7c807fb9-bf38-4e95-a912-f79cdaa1ac1f,posted,Restaurant Dinner,-1577.09,97ae0a60-44e9-4330-a03b-1623cb2b4953,5299.83,debit,cash-withdrawal,AU00000,2023-09-08T18:10:54Z
transaction,daf415f3-c407-4e30-96b1-a063b79bfe3c,posted,Non Hooli ATM Withdrawal Fee,-3917.4,34622b7d-0fd0-42bf-be5b-ef2bb3957db3,1382.43,debit,payment,AU00000,2024-01-20T04:27:32Z
transaction,61436b9b-d97e-48bd-9d7f-1a5a4d80f857,posted,AGL RETAIL ENERGY LTD (GAS),-4715.17,2b3782ad-d5d9-4682-872b-56939f958b81,-3332.74,debit,cash-withdrawal,AU00000,2023-07-17T18:41:15Z
transaction,ab952752-6394-45aa-8236-6cc6bdc489ad,posted,Wdl ATM WESTPAC IGA BALGOWLAH BALGOWL AU,-4108.43,3cd3aa9c-dd57-48e3-90bf-50fd7b383a13,-7441.17,debit,payment,AU00000,2023-09-28T04:54:32Z
transaction,f21c63c4-3e92-44ff-8a35-f4f349d6b0ef,posted,Manly Maths Tutor Wages,-3797.93,bc462cf1-772d-4b91-a9f0-a0b584cc3fad,8885.84,debit,payment,AU00000,2024-04-29T14:20:12Z
transaction,ae3ddf4e-2116-4606-973a-66767f287842,posted,Movie Ticket Purchase,-3651.82,481541f5-c45b-42d0-8338-d61503be2851,5234.02,debit,cash-withdrawal,AU00000,2023-10-08T19:32:42Z
transaction,77aa214f-b59c-4a96-b45e-9c9289036427,posted,Gasoline Purchase,-2152.31,b52dc929-c318-4c9e-b434-39f8b4a9dee1,3081.71,debit,bank-fee,AU00000,2024-01-22T18:34:45Z
transaction,a9c5bfb3-5cc7-4e7f-9551-c639b41b5299,posted,Hair Salon Appointment,-1500.06,13c53950-362e-4f03-b02d-7277bcfea553,1581.65,debit,bank-fee,AU00000,2024-01-22T04:01:52Z
transaction,3051ce1d-1ff3-4e79-8a54-4c3720173c02,posted,Coffee Shop Purchase,-582.63,e5a82d2b-428c-48f4-bcf1-dc7836d26f87,999.02,debit,cash-withdrawal,AU00000,2023-10-09T13:54:19Z
transaction,334dd05a-a6a3-4a08-a5d6-d7bee8a23e51,posted,Travel Agency Booking,-452.24,9dc3b84c-c8cd-42b1-b1f9-c0d3e3989572,546.78,debit,cash-withdrawal,AU00000,2023-08-06T14:44:57Z
transaction,ff7b350c-0f7e-47d5-a852-41f3dda15744,posted,Pharmacy Purchase,-1497.47,b67244fe-d41a-4221-b49d-19843f708915,-950.69,debit,bank-fee,AU00000,2024-01-11T01:02:46Z
transaction,346fa52e-3ec0-460b-a8de-9736f6f390c2,posted,Gym Membership Fee,-1932.86,347686ef-2136-4a46-bc44-cb02a6436ccc,-2883.55,debit,payment,AU00000,2023-05-30T10:48:29Z
transaction,53eddef0-b741-41ba-b4a3-9496b65fedab,posted,Restaurant Dinner,-943.2,f4b7b4c2-57a6-4172-9308-7b222b9fef3e,-3826.75,debit,bank-fee,AU00000,2023-06-13T04:50:06Z
transaction,afedd1dc-76b7-4536-b2ee-b8f1564081d2,posted,Mobile Phone Bill Payment,-1099.72,deeea182-0b23-4fa8-bac2-da4aa20ed581,-4926.47,debit,bank-fee,AU00000,2024-04-18T03:50:16Z
transaction,70cb3688-2fca-4337-9038-842f40604e7c,posted,Manly Maths Tutor Wages,-1275.26,c791a7fc-6f63-455d-9223-35f30e2e5cd6,10632.93,debit,cash-withdrawal,AU00000,2023-10-25T21:56:19Z
transaction,b29e0751-3806-442a-a6d7-992372c988bc,posted,Gasoline Purchase,-1182.14,8cc617ac-e87f-4262-8d76-886379a099bd,9450.79,debit,payment,AU00000,2023-10-04T06:38:08Z
transaction,195c1267-39e0-4673-9ae4-4d23c3249f13,posted,AGL RETAIL ENERGY LTD (GAS),-4559.81,b8c6e0dc-4698-40f0-bd6e-c3b3775ae308,4890.98,debit,bank-fee,AU00000,2023-12-23T16:52:21Z
transaction,f67f895f-727d-407d-bf4c-36326656ad6e,posted,Car Maintenance Expense,-4377.41,993547d4-706a-4067-ac67-38841076a57b,513.57,debit,bank-fee,AU00000,2023-12-20T00:37:03Z
transaction,8627b5da-35b2-482b-98a2-89f26d74924a,posted,Hair Salon Appointment,-1108.39,8d9fcdfd-c2ba-4e37-b849-211e4fefd400,-594.82,debit,cash-withdrawal,AU00000,2023-12-16T10:19:58Z
transaction,b421fc63-8016-448b-a76d-dc9def89b951,posted,Electricity Bill Payment,-4062.64,55dac0a2-aae9-489d-a561-f883e06940dc,-4657.46,debit,payment,AU00000,2023-11-07T06:41:38Z
transaction,363cd0b8-41ac-420d-b39f-5491f78f30c7,posted,AGL RETAIL ENERGY LTD (GAS),-2020.25,c1cbe7f7-5415-4ad4-8182-520f8ef0d57e,-6677.71,debit,payment,AU00000,2023-06-21T15:49:39Z
transaction,97a28b19-8f9a-419c-b283-efbb80d1d398,posted,Mobile Phone Bill Payment,-4326.97,b526be3f-027e-4112-8504-581105a803fc,-11004.68,debit,cash-withdrawal,AU00000,2024-03-23T12:49:36Z
transaction,e4cfe74f-74f3-43ed-bffd-37da132a7add,posted,Non Hooli ATM Withdrawal Fee,-3960.69,393ffe79-220b-44af-b4e9-99d4f7b20688,-14965.37,debit,bank-fee,AU00000,2023-11-30T05:23:44Z
transaction,dd2eeac4-1d28-484a-8494-b06be833be84,posted,Gasoline Purchase,-2894.25,38b6f732-1131-4c17-97bd-a5e8bc44bdeb,-17859.62,debit,payment,AU00000,2024-04-01T07:32:55Z
transaction,14455e49-9592-4107-8da4-521bf0c4755b,posted,Uber Ride,-4899.81,96d8f264-c3d4-4f25-8674-2683ba5fb569,1613.98,debit,payment,AU00000,2023-05-30T08:23:13Z
transaction,f8cee4ae-f097-4a85-92e4-daa4f802090c,posted,Coffee Shop Purchase,-2915.73,2b7d8d01-a043-4303-829c-4d1ae3fb2524,-1301.75,debit,payment,AU00000,2023-05-31T07:41:37Z
transaction,90126fb6-5877-4a87-bafd-8e0fa0234502,posted,Amazon Online Shopping,-1159.92,9939564a-034d-4091-ab8c-17bd17ae4f7a,-2461.67,debit,payment,AU00000,2023-06-17T08:19:28Z
transaction,bad432ce-607c-4836-ab66-4a7d4a4e111e,posted,AGL RETAIL ENERGY LTD (GAS),-2813.01,068f1e74-36a4-473d-819b-a2ade6bdd47c,-5274.68,debit,bank-fee,AU00000,2023-06-29T01:07:54Z
transaction,ce5841e7-d2bc-47bc-8a5f-b4924b004827,posted,Travel Agency Booking,-3416.7,78fb3bfb-f10d-4bc7-a425-9dc4d686a754,-8691.38,debit,bank-fee,AU00000,2024-02-16T14:54:13Z
transaction,b5b003a7-2e73-4bc8-9b0d-5d3a9b651735,posted,Home Improvement Store Purchase,-2622.49,6dcd9e57-655e-4c49-9a4f-97bd23581732,-11313.87,debit,bank-fee,AU00000,2024-03-27T21:01:11Z
transaction,b6f29643-88f8-4587-9051-bb1f117ce596,posted,Uber Ride,-442.78,82ccf00e-46bf-4a3c-b4e9-36cde50476e2,-11756.65,debit,cash-withdrawal,AU00000,2024-01-22T03:48:50Z
transaction,8e10b60e-4523-4cda-8cec-a118dfdc86da,posted,TFR Acc14000 TO 12389,-4647.48,623ac61f-8442-4aa2-b7f6-1d0b905e2244,-16404.13,debit,cash-withdrawal,AU00000,2023-12-20T15:58:43Z
transaction,400a732a-5625-4033-9035-50cd23f12f8d,posted,Clothing Store Purchase,-777.8,52454786-ae49-40f8-9665-f749eaecc0b6,-17181.93,debit,bank-fee,AU00000,2024-01-15T23:46:39Z
transaction,8d739b61-1645-4ddd-90cf-a1f593a47d4c,posted,Wdl ATM WESTPAC IGA BALGOWLAH BALGOWL AU,-1781.91,e07df9f6-b240-4074-a3fd-27554e78cd10,-18963.84,debit,payment,AU00000,2023-07-26T00:14:05Z
transaction,6a3769b6-479b-4951-8477-ed6b93d40e52,posted,Online Gaming Purchase,-4825.57,d9121a91-68ad-4129-a313-9329ee0ff201,6665.17,debit,bank-fee,AU00000,2023-07-07T17:37:31Z
transaction,9f334247-35be-4fc0-9cd0-b5b614701685,posted,Online Gaming Purchase,-3946.09,d75beb28-e4c3-4440-86a9-3ebdd7437934,2719.08,debit,payment,AU00000,2023-10-28T20:04:51Z
transaction,19f3f2b9-acc1-422a-9f63-2490b4ef1cb1,posted,Restaurant Dinner,-185.09,f69f8960-1d56-410c-a651-6cc1c3dfd950,2533.99,debit,bank-fee,AU00000,2023-10-11T04:28:36Z
transaction,f36c561f-721c-4f82-aafb-c9876dec9bb6,posted,Gym Membership Fee,-3876.64,dcae0adf-b200-409d-bb1a-5a771e115c09,-1342.65,debit,cash-withdrawal,AU00000,2024-02-07T15:03:28Z
transaction,c2eb8ae2-a89e-4bab-ae74-bc17ae557239,posted,Music Streaming Subscription,-4576.33,c03fc88a-666d-4012-b9b0-d066fb352978,-5918.98,debit,cash-withdrawal,AU00000,2023-06-27T23:52:51Z
transaction,b5ef19ca-ca92-475b-8050-a7105f343977,posted,TFR Acc14000 TO 12389,-1558.88,dba3a0e0-103f-435f-b3cf-19447e2cad71,-7477.86,debit,bank-fee,AU00000,2024-03-10T09:45:07Z
transaction,d2093aef-de62-4283-aac1-1e7f14f62ab9,posted,Gym Membership Fee,-2824.67,ebe19a5c-a3e0-4355-b138-26bee90ca38d,-10302.53,debit,payment,AU00000,2023-10-05T17:24:33Z
transaction,26075901-77d8-4d2d-86c1-6d7ce2d9163c,posted,Music Streaming Subscription,-4235.6,d634491e-96b2-4dc3-89bf-a97df528acb5,-14538.13,debit,cash-withdrawal,AU00000,2023-08-12T09:45:52Z
transaction,8c5e5f3f-ee41-450f-bf11-6b08fd4fb5f1,posted,Restaurant Dinner,-2681.41,8957d60e-dc73-4435-ae48-bcdc9414c4a3,-17219.54,debit,payment,AU00000,2023-08-31T20:27:16Z
transaction,c9bcffd3-7b3a-43b9-9383-81514bb7ca9a,posted,Amazon Online Shopping,-1776.63,72ca68ba-235b-4307-a0ff-a7819b4075c6,-18996.17,debit,cash-withdrawal,AU00000,2023-09-23T05:28:44Z
transaction,6bc5d2a9-6ba9-4f95-8f78-f59b7ca5dbad,posted,Bookstore Purchase,-3253.65,311cd935-4c3b-4c11-a0d9-de849d67a795,12603.87,debit,cash-withdrawal,AU00000,2024-02-27T16:06:54Z
transaction,4bef9fbb-b49d-4611-998a-1d03007c7f6e,posted,Mobile Phone Bill Payment,-3283.86,77960795-2df4-46fa-90cc-b7be0b088f13,9320.01,debit,cash-withdrawal,AU00000,2024-04-27T11:30:27Z
transaction,bd1b1602-c09f-4e62-899e-57ff203056da,posted,AGL RETAIL ENERGY LTD (GAS),-241.62,afc8394e-7b5d-48ae-9c01-812d11739446,9078.39,debit,payment,AU00000,2023-11-10T08:20:06Z
transaction,c0a2651b-622a-4805-9eb7-1dd9893aeb2d,posted,Bookstore Purchase,-2215.22,7af17355-5274-4f18-992a-56efcffb76f8,6863.17,debit,payment,AU00000,2024-01-15T16:31:39Z
transaction,7e191ba1-193d-40f3-9de2-ecd35520c86f,posted,Home Improvement Store Purchase,-3893.52,36f7626c-030d-4558-b971-083b7eaa7e66,2969.65,debit,cash-withdrawal,AU00000,2023-06-23T19:48:38Z
transaction,81ec1cd1-033c-4847-9e90-7a658874aeab,posted,Mobile Phone Bill Payment,-3112.89,59e515b8-7885-4807-85f4-be045c2d9af7,-143.24,debit,payment,AU00000,2024-03-20T14:00:16Z
transaction,e83c6d5b-87ac-4839-b720-0a158fbd0b10,posted,Music Streaming Subscription,-577.25,306a049d-782e-48c7-b655-c07cdbfe2734,-720.49,debit,bank-fee,AU00000,2023-09-07T10:31:08Z
transaction,41dcce14-0f20-4949-9429-a4935f6a9a87,posted,Manly Maths Tutor Wages,-4209.17,d7c9c57e-5060-4ff0-854d-af1854a4bc23,-4929.66,debit,cash-withdrawal,AU00000,2024-05-01T08:36:47Z
transaction,66ba68c5-f029-4a87-9cca-f2e78c73a2d4,posted,TRANSFER TO JOANNA SMITH CAMPING,-2660.96,d0440a18-85c1-486b-a4db-e9c8ae46ad4a,-7590.62,debit,bank-fee,AU00000,2024-03-07T10:38:29Z
transaction,f1ae3741-6987-4b61-991a-3ab92e0ed139,posted,AGL RETAIL ENERGY LTD (GAS),-3367.27,eedc7419-c718-4f51-9830-1407d800a871,-10957.89,debit,cash-withdrawal,AU00000,2023-11-12T10:06:42Z
transaction,8a2cddb7-21b5-49a9-a061-a2cedc4178b9,posted,Gym Membership Fee,-380.25,c48f4a04-bd50-4d6e-8a8b-7f1a0a9545d6,10419.54,debit,bank-fee,AU00000,2024-01-11T03:44:23Z
transaction,12dc1625-96b4-42af-bbe7-37c625064b63,posted,TRANSFER TO JOANNA SMITH CAMPING,-1255.08,53a40e67-012a-4af4-b588-6aad01d63b56,9164.46,debit,cash-withdrawal,AU00000,2023-09-09T00:24:00Z
transaction,a3f7103f-0e2b-4241-bc30-51cfe4a59c44,posted,Manly Maths Tutor Wages,-53.37,d7bf0ed7-dae8-45a6-ac59-fee4ae95f200,9111.09,debit,payment,AU00000,2023-08-26T09:11:09Z
transaction,a343cba4-f86a-45b5-ad32-74b2db693a92,posted,Hair Salon Appointment,-4111.69,9f11295f-e3ac-4ff4-8f01-d7bef357c672,4999.4,debit,bank-fee,AU00000,2023-07-31T06:00:58Z
transaction,1a9b8b2d-6d5d-4e31-9c57-84ff584eeeec,posted,AGL RETAIL ENERGY LTD (GAS),-1804.01,bbd68939-5fb2-4fed-9a4b-83344705234f,3195.39,debit,payment,AU00000,2024-02-10T08:59:11Z
transaction,f4764b6d-dc30-484f-8889-3eb6a359f8e1,posted,Uber Ride,-3100.3,d9476da8-d54b-47cf-bec8-7d846451dcad,95.09,debit,bank-fee,AU00000,2024-04-10T20:42:40Z
transaction,f6999f64-b369-41d3-a992-dafeae23b0a4,posted,Transfer Platnm Homeloan 346454,-1819.7,4f963f20-5244-4617-b948-bba62ed80d5c,-1724.61,debit,bank-fee,AU00000,2023-09-07T13:17:51Z
transaction,5626222d-ee5e-4bc5-b2d4-3651c96909a8,posted,Transfer Platnm Homeloan 346454,-4840.21,3fff71cb-cf2f-4175-94c8-0c165a4a6b96,-6564.82,debit,bank-fee,AU00000,2023-07-30T23:31:27Z
transaction,488044d0-f1c2-45e5-aa26-fd91bf661081,posted,Car Maintenance Expense,-3782.79,502bf822-2b4b-4364-9d06-e351ef9b68fe,-10347.61,debit,bank-fee,AU00000,2023-05-26T22:39:04Z
transaction,50433e9e-2801-4571-a93c-5fd678b457af,posted,Pharmacy Purchase,-4060.18,d82d2775-17d3-4576-89f3-9fe364a12828,-14407.79,debit,bank-fee,AU00000,2023-12-19T00:28:52Z
transaction,de62bfb1-f99e-465e-a50a-1fa52810c86f,posted,Pharmacy Purchase,-2418.03,98f7c94f-1ec8-4ca5-862b-c1034bba31c4,5016.02,debit,payment,AU00000,2023-12-25T22:16:32Z
transaction,87d0e024-c78b-4985-a042-a4624f7bce5d,posted,Car Maintenance Expense,-1623.33,34869a75-088e-49b1-89d0-ab5e27ae2549,3392.69,debit,cash-withdrawal,AU00000,2024-05-06T08:45:47Z
transaction,911f5a4a-907b-412f-b6ff-d6b3ad847d38,posted,Wdl ATM WESTPAC IGA BALGOWLAH BALGOWL AU,-4714.55,96a7e1e8-578f-4e21-add1-73c209d78222,-1321.86,debit,cash-withdrawal,AU00000,2023-08-17T09:19:51Z
transaction,e0055ad2-7afc-4918-ab10-21fb822d9928,posted,Bookstore Purchase,-4739.58,400788a0-8ada-4e18-89f6-07caec044df1,-6061.44,debit,payment,AU00000,2023-12-12T09:23:42Z
transaction,f61cc211-9c9b-47c8-b8f5-b78c0396d80c,posted,Restaurant Dinner,-1645.89,f21b3a78-1846-459a-9b39-de39f42ff205,-7707.33,debit,payment,AU00000,2024-02-22T14:39:23Z
transaction,3883e29b-081b-4dcc-a659-7478b5657cd2,posted,Netflix Subscription,-3449.54,d8c16b97-a33a-4f00-9f9c-02ca55dc5d83,-11156.87,debit,payment,AU00000,2023-08-23T09:18:14Z
transaction,d8a88492-cd6a-4d21-bdeb-7b7a90f3fe53,posted,Uber Ride,-4770.48,be9b04aa-3cf7-4d8a-84c4-e7994d50bd48,-15927.35,debit,bank-fee,AU00000,2023-06-10T04:45:14Z
transaction,4e1291f4-e8af-4b8d-9058-c88beb651ddb,posted,CTRLINK CARERS Ref: 998R6789201610974V,-4621.03,8926d01c-9f6f-4922-bc43-816d60e95cd3,-20548.38,debit,cash-withdrawal,AU00000,2023-11-14T00:06:34Z
transaction,35b48923-353e-45d9-962b-c53155a560bb,posted,Manly Maths Tutor Wages,-4207.57,968f96fa-c88e-410a-99d0-3b908e1ac7d2,-24755.95,debit,bank-fee,AU00000,2023-09-25T08:19:15Z
transaction,da3ccb06-92d1-463c-a792-698f3351ce1c,posted,Electricity Bill Payment,-4047.94,307f4b2c-cf62-4729-b7fc-818d90792f14,-28803.89,debit,payment,AU00000,2023-06-21T20:20:12Z
transaction,ab695ce0-4091-4b09-816b-8148249f402c,posted,Hair Salon Appointment,-2369.29,355a363f-dbf0-4598-a441-818a4a93d71e,12428.29,debit,payment,AU00000,2024-04-08T16:36:09Z
transaction,46e1d1f4-f25a-467c-a3d7-45cb89023aaf,posted,Coffee Shop Purchase,-2269.22,d540b67a-a19a-484b-a77b-5176048bbc41,10159.07,debit,payment,AU00000,2024-01-04T19:04:16Z
transaction,a09069a4-e64c-442c-8570-5cd1ef8a04a0,posted,Payroll WFRMS 15439393,11141.56,74db1230-13fa-4117-a29c-20eabd1a9701,21300.63,credit,transfer,AU00000,2024-03-23T01:34:54Z
transaction,a7e1f4c1-38b2-491e-83cc-591017b9ca0d,posted,Hair Salon Appointment,-3505.26,b5a8cf8f-0317-4a23-ba31-550d7353dcf2,17795.37,debit,payment,AU00000,2024-04-07T01:57:04Z
transaction,37320b6e-2f77-4911-8ed6-0eab8cbcc27c,posted,Restaurant Dinner,-1813.07,6665c9c8-c9a2-494f-9f62-b78771d56c83,15982.3,debit,bank-fee,AU00000,2023-12-27T21:43:34Z
transaction,224d6523-f42b-4aa3-a580-671870b10935,posted,Manly Maths Tutor Wages,-2266.2,7c54e02e-d0d9-4103-bf79-a88ef238fd0a,13716.1,debit,bank-fee,AU00000,2023-08-25T08:21:42Z
transaction,a60a7059-6633-4e8a-bb9f-edee06f5fd1c,posted,TFR Acc14000 TO 12389,-2281.75,8e9549b6-7054-4d56-a04d-e43d19a0e82e,11434.35,debit,cash-withdrawal,AU00000,2023-12-17T23:44:34Z
transaction,569b7e3a-3b35-4922-b020-24e5ec1e3ab0,posted,Restaurant Dinner,-4645.17,99660a44-84b7-4226-805b-46eabf299c02,6789.18,debit,payment,AU00000,2023-07-26T11:16:50Z
transaction,d1c58569-78e2-407b-b5c2-84f65300a183,posted,Travel Agency Booking,-2062.96,e2b7be18-e72a-4028-bc36-6c3b879bcc71,4726.22,debit,cash-withdrawal,AU00000,2023-12-21T11:26:49Z
transaction,09ab14a1-3c82-4609-80f0-1661188c8a20,posted,Coffee Shop Purchase,-4006.21,e42c27d9-4631-4548-a627-d0867d1c0a8f,720.01,debit,bank-fee,AU00000,2023-06-05T08:28:08Z
transaction,248c8eaf-be8c-410f-8501-6c1d2973f193,posted,Movie Ticket Purchase,-1822.06,f645333f-925d-41ef-ad97-d57df7009cfb,4562.1,debit,cash-withdrawal,AU00000,2024-02-02T21:54:15Z
transaction,79a9ed6c-b983-4f2c-8320-8227f6cd5cad,posted,Wdl ATM WESTPAC IGA BALGOWLAH BALGOWL AU,-4201.85,909e3ac2-e1d0-408f-af59-a603dd8e7e9e,360.25,debit,payment,AU00000,2024-02-24T23:36:33Z
transaction,78b50064-fe94-47ea-b931-a97566333e5b,posted,Mobile Phone Bill Payment,-4480.82,b2539b43-0305-4152-ba94-f19be80a8317,-4120.57,debit,cash-withdrawal,AU00000,2023-07-13T19:17:47Z
transaction,5defad81-3a25-409e-b0e7-820faf448548,posted,Uber Ride,-1222.5,8b6e18f4-d021-4254-8d37-d4c6a0478a47,-5343.07,debit,cash-withdrawal,AU00000,2024-01-26T06:31:43Z
transaction,ef43c332-201b-4937-ae9b-403e2f9e7fd4,posted,Mobile Phone Bill Payment,-802.12,7542b1d1-f527-41cc-ba3b-7e31c8bd3bf6,-6145.19,debit,cash-withdrawal,AU00000,2023-09-23T07:00:00Z
transaction,ddb92ed7-3c7c-404e-9c7b-3a75cf218fcb,posted,Bookstore Purchase,-4603.89,3a6d0d2e-06e4-4ce2-8717-18b53b7ede8e,-10749.08,debit,bank-fee,AU00000,2024-04-07T06:17:59Z
transaction,21bc4a72-00e9-4e5d-ad48-260a7b4b78a0,posted,Gym Membership Fee,-2830.92,11c05177-96ed-4746-a337-3d9d6dd05fc0,-13580.0,debit,cash-withdrawal,AU00000,2023-10-28T22:02:04Z
transaction,186b6371-eedb-4f42-ae66-a747669c83b6,posted,Home Improvement Store Purchase,-1950.38,fdb347a6-c196-451b-9f88-b01c38ef7905,-15530.38,debit,cash-withdrawal,AU00000,2024-03-14T23:07:51Z
transaction,4141777d-0363-483c-8751-4b8b0937d549,posted,TFR Acc14000 TO 12389,-3507.85,9f22acf1-06f3-4300-b9d6-1f3198f34000,-19038.23,debit,cash-withdrawal,AU00000,2023-05-31T14:48:48Z
transaction,820bc429-be7d-4228-9a2e-eda12247b6e0,posted,Music Streaming Subscription,-571.55,1e4b3815-f5c1-4b81-9860-8cecb8b1f3a2,-19609.78,debit,payment,AU00000,2024-02-19T21:04:41Z
transaction,2d4cee24-c490-4cbc-a119-8b370e5dc8ca,posted,Movie Ticket Purchase,-1941.98,3f9d5691-8c30-4597-b9da-d3e8dce7b854,9972.76,debit,cash-withdrawal,AU00000,2024-05-03T15:15:53Z
transaction,f527910a-2ab8-4736-81ce-0210f213cab3,posted,Uber Ride,-2809.55,947446b3-b8c1-4896-8b5b-d4ba2ec60bc2,7163.21,debit,cash-withdrawal,AU00000,2023-08-06T16:44:43Z
transaction,4e697839-4872-4a92-b232-b6324a46f2fd,posted,CTRLINK CARERS Ref: 998R6789201610974V,-793.39,651ae5e1-5ba9-4498-89cd-7fa54bbc285b,6369.82,debit,cash-withdrawal,AU00000,2023-07-10T22:56:39Z
transaction,ae8eee21-e5bd-4f4a-a870-479c6f4c49f9,posted,Wdl ATM WESTPAC IGA BALGOWLAH BALGOWL AU,-3671.34,784f62d6-acf1-4080-a3ca-5735db401419,2698.48,debit,payment,AU00000,2024-02-12T20:50:35Z
transaction,1952faba-775c-4af2-870e-8d936491135f,posted,Wdl ATM WESTPAC IGA BALGOWLAH BALGOWL AU,-3207.1,3707dae8-f015-4beb-a868-418166cd8acc,-508.62,debit,payment,AU00000,2024-02-17T23:01:08Z
transaction,8be03371-d169-4f68-b9cb-17a2d89aa52f,posted,Hair Salon Appointment,-1190.51,822f008e-06e8-48d2-9018-e6910ba70f70,-1699.13,debit,payment,AU00000,2023-06-25T13:53:01Z
transaction,6ac09bf5-9bf6-4680-8135-8d5ba5ba8170,posted,Public Transport Fare,-30.14,d8f0ff2a-ad34-41a7-81aa-60c96768bfa8,-1729.27,debit,cash-withdrawal,AU00000,2023-06-18T06:05:10Z
transaction,c19ebdba-1c59-4e1b-9822-ddd81bea2471,posted,Mobile Phone Bill Payment,-1643.76,0afbf83a-c976-417b-b141-5d38ed56cd66,-3373.03,debit,payment,AU00000,2024-04-20T11:29:25Z
transaction,86958ecc-5f3f-48e0-aae0-b62547f62f05,posted,Payroll WFRMS 15439393,11642.34,65371c83-068a-4d9c-8527-69ed08a0278f,8269.31,credit,transfer,AU00000,2024-05-05T23:55:24Z
transaction,3d9b58f7-f9cb-495e-b196-db6bff5bfda9,posted,Manly Maths Tutor Wages,-4398.36,f2a09c8c-14af-4982-8052-b5c0ed3d046b,3870.95,debit,cash-withdrawal,AU00000,2023-06-09T04:37:27Z
transaction,6d61e117-0cdd-43f2-91d3-2654dec63b03,posted,Netflix Subscription,-628.97,a1a6072c-421a-4ec3-a97d-2947e31b74db,14903.91,debit,bank-fee,AU00000,2023-06-30T07:41:02Z
transaction,d9b865ed-e582-47f2-970a-1869d43c50e5,posted,Non Hooli ATM Withdrawal Fee,-803.95,d9736114-7d54-4afd-8143-faa68df3dd29,14099.96,debit,payment,AU00000,2023-06-09T06:51:53Z
transaction,1715d0ac-4600-49c1-89ef-c779b748d02c,posted,Restaurant Dinner,-4997.52,9bb544c2-4dd2-4a59-a4f5-ce955c1a666b,9102.44,debit,payment,AU00000,2023-07-19T09:57:19Z
transaction,042516f4-f1e9-42b3-82f6-6eef9cf0d503,posted,Movie Ticket Purchase,-2683.03,8d8e1578-3bcd-4075-b980-510e11a0ec5d,6419.41,debit,cash-withdrawal,AU00000,2023-09-08T16:22:00Z
transaction,0532529d-411f-40b2-8eb8-11a3dca6609e,posted,Car Maintenance Expense,-1299.82,6f49422e-007f-4d0b-8075-5e0f6d87e499,5119.59,debit,cash-withdrawal,AU00000,2023-10-05T22:20:18Z
transaction,a4e8f7be-9aef-48a2-8c36-0af0966a44ce,posted,Coffee Shop Purchase,-1120.35,d14758ef-43e9-4efe-8043-bc6e533de0a3,3999.24,debit,payment,AU00000,2024-02-06T01:19:25Z
transaction,6709233b-e376-448e-ba28-759e601a895b,posted,Movie Ticket Purchase,-163.84,6ee88eeb-eac3-4832-9256-15364b591740,3835.4,debit,bank-fee,AU00000,2023-10-06T20:22:04Z
transaction,3e14729a-cc03-47c3-931a-335b48bc716b,posted,Coffee Shop Purchase,-2828.07,950b1292-cf84-44c4-97e7-7934d247e7a7,1007.33,debit,cash-withdrawal,AU00000,2023-11-17T11:08:18Z
transaction,e18449fb-082f-4039-ad28-0f60dd5df81f,posted,CTRLINK CARERS Ref: 998R6789201610974V,-867.84,686a4dd7-5c96-4512-9600-11538fbde99c,139.49,debit,cash-withdrawal,AU00000,2024-03-28T13:26:05Z
transaction,20ddb963-4d0c-4c0a-a9e0-ea3802b4bddf,posted,Non Hooli ATM Withdrawal Fee,-3793.35,83f956c5-d11d-479c-acb1-3d6586f68158,-3653.86,debit,cash-withdrawal,AU00000,2024-01-07T12:24:43Z
transaction,e1c89c2a-a155-4b4a-bd09-2f21108f58d3,posted,TRANSFER TO JOANNA SMITH CAMPING,-4878.99,ef77729a-2ab8-4484-8f24-14dbe36bcbd2,3599.08,debit,cash-withdrawal,AU00000,2023-06-17T20:44:02Z
transaction,93512f47-b728-4479-87b5-b4f9c5208150,posted,Electricity Bill Payment,-3109.57,e6dfd17c-935f-48bd-b174-e759079d60e6,489.51,debit,cash-withdrawal,AU00000,2023-08-01T23:25:46Z
transaction,88c88ea1-b5f4-4bea-a156-d60fae0171d2,posted,Coffee Shop Purchase,-1736.21,bbf78a01-b9ba-4d9c-93b8-74bd8b153f6f,-1246.7,debit,payment,AU00000,2024-05-10T18:00:55Z
transaction,1d8866ca-ce52-4fa7-91f0-e397a8636977,posted,AGL RETAIL ENERGY LTD (GAS),-1216.65,acee4e0c-1a21-4633-9652-32ed09ee6a30,-2463.35,debit,payment,AU00000,2023-08-06T21:11:17Z
transaction,f743760a-d77e-4fcb-8ccc-ce33555b8903,posted,Gasoline Purchase,-373.98,faf562f6-ca37-4c3b-b086-22dcd417bf1a,-2837.33,debit,payment,AU00000,2023-11-21T08:23:11Z
transaction,73f572e1-2ce0-4b2b-82d0-6d25a8773162,posted,Payroll WFRMS 15439393,11086.03,7b3b2b88-9f7e-4c96-a4c7-9382f1aa9cf7,8248.7,credit,transfer,AU00000,2023-07-09T12:56:51Z
transaction,27cbde81-fc63-4b4c-9acf-0c166d2ebe35,posted,Travel Agency Booking,-317.45,8d295290-abef-45ff-bbfb-bd4d15c4d48d,7931.25,debit,payment,AU00000,2023-11-22T07:51:45Z
transaction,d08a4c72-2fe3-449a-af75-06470f671926,posted,Restaurant Dinner,-4348.11,2a01e919-e24b-4761-b3cc-8b68aa6c3a5d,3583.14,debit,bank-fee,AU00000,2023-08-23T22:37:47Z
transaction,71d922b1-6ead-4ccc-a271-c78eae467bda,posted,Non Hooli ATM Withdrawal Fee,-4293.76,2b1080e7-0291-4921-80aa-2e2b17ec2f57,-710.62,debit,payment,AU00000,2024-02-26T01:12:10Z
transaction,9dcca163-467d-422a-8253-c638ad807d10,posted,Bookstore Purchase,-2991.52,7c5926a6-e2e1-481b-8374-faac80c345af,-3702.14,debit,payment,AU00000,2024-01-05T16:17:28Z
transaction,aecc9054-a362-47f1-b6e6-6a6db56b6a80,posted,Music Streaming Subscription,-234.67,34eb8b65-a1dc-4483-8303-52dc0619d8bb,6038.9,debit,cash-withdrawal,AU00000,2024-05-08T10:07:26Z
transaction,a526e343-fd20-412f-bbae-7066ea7f4e3b,posted,Clothing Store Purchase,-3973.1,89b2547d-6b1e-4a70-b47a-db214a902ea6,2065.8,debit,bank-fee,AU00000,2023-06-17T04:51:22Z
transaction,133f395c-5d78-4624-b091-32b446bcf385,posted,CTRLINK CARERS Ref: 998R6789201610974V,-2199.0,8d4f67ea-3730-4dcb-b06d-f1f4ff75b8e7,-133.2,debit,cash-withdrawal,AU00000,2023-11-10T06:05:00Z
transaction,84aeeac7-d5d0-4864-9cb8-0c7bd6f67174,posted,TRANSFER TO JOANNA SMITH CAMPING,-3137.95,7c83d5f5-ce94-48ec-b1ef-428bb96a238f,-3271.15,debit,payment,AU00000,2023-12-12T22:05:35Z
transaction,f280c0b1-8cee-4503-af70-8946dc87e170,posted,CTRLINK CARERS Ref: 998R6789201610974V,-818.07,19bfa2ac-91de-4c85-bcae-496c1418f68f,-4089.22,debit,cash-withdrawal,AU00000,2024-02-02T23:09:10Z
transaction,e2d477e2-c3ee-460a-855b-bac3e46feb55,posted,Car Maintenance Expense,-1677.96,c173fdf4-4f60-424e-83c3-3e3141d81e80,-5767.18,debit,bank-fee,AU00000,2023-12-07T13:07:49Z
transaction,9b3b7d71-5cec-49ee-92ee-12f75b10ebbf,posted,TFR Acc14000 TO 12389,-1097.92,0adbbb6f-5066-4396-9167-d3a0c2340b36,-6865.1,debit,bank-fee,AU00000,2024-04-27T07:42:40Z
transaction,a61fd675-0ee9-4e50-838e-92702e289fd4,posted,Coffee Shop Purchase,-4728.48,d7a186f3-8ded-4df5-8631-daa3a12e1af4,-11593.58,debit,bank-fee,AU00000,2024-03-18T14:32:13Z
transaction,4e4daf95-12e1-4cef-9382-ea362d8fd7d7,posted,Online Gaming Purchase,-4018.0,e1125d26-1fb3-4916-9746-b86da10e888f,-15611.58,debit,payment,AU00000,2023-09-17T13:07:18Z
transaction,b17862b2-f6f1-4973-b99c-982817cd5404,posted,Manly Maths Tutor Wages,-4871.32,c6a88b0e-8146-4728-a10e-9faefaf2f589,-20482.9,debit,cash-withdrawal,AU00000,2023-06-02T08:14:37Z
transaction,139e9d4c-9e88-41ee-b074-01e2cd50bd7a,posted,Movie Ticket Purchase,-1465.77,0c9d0342-4e6e-4133-be56-3eaa93e94f97,13083.19,debit,bank-fee,AU00000,2023-10-14T19:41:43Z
transaction,4b3fe57d-71c9-4d26-9342-7634f7d19849,posted,CTRLINK CARERS Ref: 998R6789201610974V,-2545.16,94cbb6e8-8921-4dae-9ba8-6c593f252209,10538.03,debit,payment,AU00000,2024-03-04T08:50:19Z
transaction,5b2d340e-654c-44fd-835d-5532558fe0bb,posted,TRANSFER TO JOANNA SMITH CAMPING,-1980.34,1433710e-1695-4e6b-918b-6109639dc8ab,8557.69,debit,bank-fee,AU00000,2024-03-18T06:01:25Z
transaction,ad88d2d2-e785-4384-a3e5-439746b6f63d,posted,Coffee Shop Purchase,-1030.85,9d7091fb-f570-4a08-bbe1-1a9a8363b17f,7526.84,debit,payment,AU00000,2023-09-28T11:01:03Z
transaction,babfb5ed-7fd8-4e7a-b126-fef443a28b2a,posted,Car Maintenance Expense,-194.01,3adb5c72-bd16-4de9-90f9-55fc1e0d46bc,7332.83,debit,cash-withdrawal,AU00000,2023-12-06T09:48:45Z
transaction,6c8eb7fc-f631-4e7c-b037-40ba2212d706,posted,Amazon Online Shopping,-3111.71,75f90537-b997-48ef-8e3f-8466369bead7,4221.12,debit,bank-fee,AU00000,2023-05-13T03:00:00Z
transaction,ba98c8a0-c41e-4f18-869d-7cdf3e9ef8ba,posted,Amazon Online Shopping,-3624.9,edd86776-2cbe-412a-8925-0030e96d353f,596.22,debit,bank-fee,AU00000,2024-01-31T09:26:08Z
transaction,344eabe5-6bf9-4fb9-9eb4-eb2abfa1823d,posted,Travel Agency Booking,-1889.58,deaea2ee-6ab3-442f-bf49-fb6e1bf830a7,-1293.36,debit,cash-withdrawal,AU00000,2023-07-01T17:09:59Z
transaction,4dfe5881-f2ad-4022-bc8d-436ee47f5337,posted,Hair Salon Appointment,-3089.44,7ac2fb8c-ef53-4f05-8b5f-3656c8de56f1,-4382.8,debit,bank-fee,AU00000,2024-04-09T06:27:15Z
transaction,63bde880-e767-4327-9857-6294e1673c1d,posted,Wdl ATM WESTPAC IGA BALGOWLAH BALGOWL AU,-3953.04,e8a350d5-c3ff-4e60-92d3-b4a3cf1906cb,-8335.84,debit,cash-withdrawal,AU00000,2023-10-18T02:09:51Z
transaction,2005de55-8014-434d-aa23-78e4d2bc00c5,posted,Payroll WFRMS 15439393,10991.31,802e16a1-cb96-415a-858e-4c82a5bb694d,30022.7,credit,transfer,AU00000,2023-09-05T16:46:19Z
transaction,7da2a3df-cbe0-4670-9308-923472281a25,posted,Manly Maths Tutor Wages,-307.38,899aa5ea-4f91-4c7d-83b7-eb5a2c60ebed,29715.32,debit,bank-fee,AU00000,2023-07-21T06:39:38Z
transaction,79c37e8e-19dd-48df-afca-35de971b6714,posted,Gasoline Purchase,-500.29,2f946a23-5429-45b8-b602-ce05c0ba8e1c,29215.03,debit,cash-withdrawal,AU00000,2023-12-25T16:18:12Z
transaction,314b986c-a041-4ff5-bc4d-9d30fd3827b0,posted,Gym Membership Fee,-3193.55,01e2e2bd-2985-49e6-8c30-0a6714e024a1,26021.48,debit,payment,AU00000,2023-07-05T10:07:17Z
transaction,a6ca4686-b65e-4adc-9d42-7ebe97d7935b,posted,AGL RETAIL ENERGY LTD (GAS),-4473.37,6386f1cd-2410-4c59-b606-d051e15929b7,21548.11,debit,payment,AU00000,2024-01-12T18:44:06Z
transaction,7f2c2c39-3e94-42c0-b128-eea853f01117,posted,Home Improvement Store Purchase,-1606.76,98c7313d-ac15-487d-a160-9fb7935729c5,19941.35,debit,bank-fee,AU00000,2023-11-02T11:35:46Z
transaction,a9abcfd7-7383-4cb5-8a38-5918e2cffd2b,posted,Gasoline Purchase,-2377.53,a5945ffc-e155-467f-a7a2-419ed9de5387,17563.82,debit,payment,AU00000,2023-10-08T13:28:30Z
transaction,ce8db835-0701-4b55-9e8e-c3fee4dd43a4,posted,TRANSFER TO JOANNA SMITH CAMPING,-4641.35,a1337bd3-69ba-417b-a509-42da49b1a011,12922.47,debit,payment,AU00000,2023-12-25T09:54:02Z
transaction,ef994e95-a496-474b-bb63-e0b03a0278e1,posted,Music Streaming Subscription,-3806.15,7ea91ecb-9921-4a5d-9c3f-4e3b9f8739f6,9116.32,debit,cash-withdrawal,AU00000,2024-03-20T14:17:57Z
transaction,b1686110-ac2c-4429-9976-78c348687cd9,posted,Public Transport Fare,-4580.69,ec8e3265-423e-447a-b266-fd6cea618644,4535.63,debit,payment,AU00000,2023-08-31T09:33:48Z
transaction,7cef3447-b052-4251-bdba-0fd67c230172,posted,Public Transport Fare,-3030.45,64275ba7-085c-42cd-84fc-ae44be591e38,16488.34,debit,payment,AU00000,2024-04-30T02:00:55Z
transaction,95e51cba-add3-45bd-aa16-77c7704f2f19,posted,Manly Maths Tutor Wages,-573.52,403e76b8-c83c-40f2-9722-08c6a1ce9c1e,15914.82,debit,payment,AU00000,2024-05-07T16:00:47Z
transaction,b90f6a5f-7e38-484c-86cf-27ea4213f39d,posted,Pharmacy Purchase,-2059.84,207c5206-5db7-4463-9b56-f0adb31ff11d,13854.98,debit,payment,AU00000,2023-11-08T17:15:07Z
transaction,a2d6d6ca-4ff6-46f4-ae05-b1f3b35fcf53,posted,Non Hooli ATM Withdrawal Fee,-370.9,29609158-bf49-4105-ad19-d87b24f6d5c9,13484.08,debit,cash-withdrawal,AU00000,2023-10-04T14:55:31Z
transaction,4bb2fd18-187f-4517-85dd-9aa742b9397e,posted,Hair Salon Appointment,-2737.41,09ce458c-668e-4d13-9bb0-808b36f8831f,10746.67,debit,bank-fee,AU00000,2023-12-15T15:04:13Z
transaction,0901b25c-b302-40a7-b04a-67a309d85a17,posted,Clothing Store Purchase,-1329.41,0adbb57c-c794-4775-a68c-c500f6386998,9417.26,debit,bank-fee,AU00000,2024-04-15T02:01:52Z
transaction,6a396091-f414-4a9b-b61e-7f0c0cb82398,posted,Payroll WFRMS 15439393,11698.39,f35ab712-51e3-4e73-859d-373f971d871f,21115.65,credit,transfer,AU00000,2023-08-08T06:37:39Z
transaction,d85596cf-d929-419d-ba5c-2ea462d1f191,posted,Travel Agency Booking,-1026.63,0c946149-5c43-46a6-841d-13ee0bc5d161,20089.02,debit,cash-withdrawal,AU00000,2023-11-29T20:11:26Z
transaction,c4b68c29-6bde-4a03-8e89-278875f87a2d,posted,Amazon Online Shopping,-3136.13,ab9e1f43-956e-41d7-8c58-77452298cc21,16952.89,debit,bank-fee,AU00000,2023-07-03T19:44:26Z
transaction,5d6cbf10-e8a7-4440-a633-996a2800d75e,posted,Online Gaming Purchase,-3112.01,b8fae9ff-ddfd-4344-8a1e-8fde6618ca55,13840.88,debit,bank-fee,AU00000,2023-10-12T01:57:00Z
transaction,ba0e1728-e7d7-40a3-8183-c5b67d53d00b,posted,Non Hooli ATM Withdrawal Fee,-2073.32,460135dd-798b-4cbe-a3c0-b3c95d00f26d,6742.9,debit,bank-fee,AU00000,2023-05-31T05:26:23Z
transaction,86feb90a-8460-4325-9fd0-929e8133e3c8,posted,Payroll WFRMS 15439393,10868.99,49795c31-72df-4d70-9f67-853b9fc80be8,17611.89,credit,transfer,AU00000,2023-12-09T16:06:55Z
transaction,4865c828-47f5-4c74-84d4-85a6257e58d8,posted,Gym Membership Fee,-598.03,8d7afe5c-ec78-4979-bbd1-470940dd79bc,17013.86,debit,bank-fee,AU00000,2024-01-03T00:32:50Z
transaction,655019e5-e774-4efc-8ec3-0692c8322b12,posted,Gym Membership Fee,-32.58,778f1921-f1de-48f8-b430-84ac5f48e8ff,16981.28,debit,payment,AU00000,2024-02-12T07:25:45Z
transaction,294a9420-c891-4fdd-8b93-4d73a0f367a3,posted,Amazon Online Shopping,-1683.92,237f23b2-4f8d-4917-a3ef-79ffd3bb5648,15297.36,debit,payment,AU00000,2024-04-06T16:58:05Z
transaction,e5431467-a1c4-44d2-8896-b9e58195d180,posted,Electricity Bill Payment,-4326.15,12515593-1b57-4f41-a9c9-eec4964e1a5e,10971.21,debit,payment,AU00000,2023-10-07T16:00:27Z
transaction,0ada163f-6ed6-434c-aa57-2961a8de6a7a,posted,Coffee Shop Purchase,-4869.51,d60153e2-d8f5-4501-adf2-b0202c5ce3c1,6101.7,debit,cash-withdrawal,AU00000,2023-09-18T09:40:51Z
transaction,3864ea20-c5da-4307-96dd-57dfd30b0b17,posted,Transfer Platnm Homeloan 346454,-2965.22,acd820ef-ac90-4442-bc14-87e0299ba81e,3136.48,debit,bank-fee,AU00000,2024-04-15T13:10:39Z
transaction,327165ea-644d-48e8-93f2-90630f978ded,posted,Mobile Phone Bill Payment,-1286.6,d080e350-22be-47f4-bcdb-142f262b2eb0,1849.88,debit,cash-withdrawal,AU00000,2023-07-02T09:25:59Z
transaction,d54f7bae-afd5-459c-aed3-8731de9272ca,posted,Bookstore Purchase,-2713.53,e813b563-b971-49ad-beaf-ba975181fef5,-863.65,debit,cash-withdrawal,AU00000,2023-08-25T23:28:41Z
transaction,1ddf17fc-627a-460c-a8bb-424d9b74681e,posted,Clothing Store Purchase,-3804.37,ce0639a6-ddf4-466d-9164-8fd2a5e2c1d7,14580.52,debit,cash-withdrawal,AU00000,2023-07-29T01:24:43Z
transaction,0ccf11ab-a8e3-49af-9056-b9e53a6ab5f6,posted,Mobile Phone Bill Payment,-2160.16,642e5985-2f83-4774-8732-f7b704537f40,12420.36,debit,bank-fee,AU00000,2023-08-30T18:57:45Z
transaction,f6a55da9-be52-4ac2-9677-f2e1508e6243,posted,Electricity Bill Payment,-2939.86,9590f000-1bd2-4ad4-84e0-e9c5b53bff52,9480.5,debit,bank-fee,AU00000,2024-04-24T05:29:29Z
transaction,365736bd-cd66-4341-84c7-db0569ac3550,posted,Movie Ticket Purchase,-2402.18,d9dcf177-acff-4058-8ea2-f6d4a65826ca,7078.32,debit,bank-fee,AU00000,2024-04-15T04:55:36Z
transaction,869a901c-a1e8-4adc-9425-ba344f31714d,posted,TRANSFER TO JOANNA SMITH CAMPING,-2288.73,475d5d61-955c-4e75-ae52-1f0ec21c35a8,4789.59,debit,bank-fee,AU00000,2023-10-17T17:52:42Z
transaction,187a9974-7a8e-4cb9-aaf2-ef003d77283e,posted,CTRLINK CARERS Ref: 998R6789201610974V,-2376.4,9df7bd3e-741d-4a45-aa57-1289a7f56e65,2413.19,debit,payment,AU00000,2023-12-04T15:00:57Z
transaction,7ace6571-6d5c-484e-b451-84d50191491e,posted,Gym Membership Fee,-2495.0,ea52b0d2-4253-45a9-81b8-d3dc162399c9,-81.81,debit,bank-fee,AU00000,2024-02-13T05:23:57Z
transaction,e8b9bf0a-90ba-4840-bd21-d8dfda665291,posted,Gym Membership Fee,-3337.3,65b578ce-ddb0-447b-b044-7acfe8a967ed,-3419.11,debit,cash-withdrawal,AU00000,2024-05-04T22:29:06Z
transaction,b578aba9-b709-4fda-9ef2-2791f0a724cc,posted,Online Gaming Purchase,-4237.34,f7418794-7a0b-4960-9a92-9c24b842102a,-7656.45,debit,payment,AU00000,2024-03-22T07:14:37Z
transaction,732e40a2-f6ed-40d2-a139-b7f1866e4e57,posted,TFR Acc14000 TO 12389,-1457.3,ac0f3ad5-8d04-4400-b910-d85f7b7c8347,-9113.75,debit,cash-withdrawal,AU00000,2023-11-07T17:51:50Z
transaction,f28e91c1-ae91-4c22-8a67-eed290fff8b7,posted,Gym Membership Fee,-3469.75,a024b754-3cfc-4928-8eaa-86f0ef69b0fa,15253.39,debit,bank-fee,AU00000,2024-03-20T13:33:46Z
transaction,c2851e5b-6768-4ab5-8f59-eec021f6ed50,posted,Bookstore Purchase,-3730.71,487a1e87-cc88-40cf-a7ea-8031cf97ce48,11522.68,debit,cash-withdrawal,AU00000,2023-10-02T11:52:43Z
transaction,c082216c-2fa5-476d-a729-fa9162f2bda3,posted,Restaurant Dinner,-4424.37,34b0b47b-fa55-45b0-8bd9-a8992012f275,7098.31,debit,bank-fee,AU00000,2023-08-03T16:33:39Z
transaction,aac7b526-5f16-4e49-8d09-9e5c016c975a,posted,Payroll WFRMS 15439393,10167.53,5b9380da-8739-41eb-a0bb-27f86008d688,17265.84,credit,transfer,AU00000,2024-04-26T04:34:49Z
transaction,e7ed5ea6-5e14-4c67-abde-8fc95f40fbdc,posted,Non Hooli ATM Withdrawal Fee,-1717.32,39859834-2876-4641-b1db-dcd00faf5bc3,15548.52,debit,bank-fee,AU00000,2023-10-26T03:07:59Z
transaction,2d80b375-4ecf-430a-bb78-40ba4046d616,posted,Pharmacy Purchase,-2821.75,a754a868-01d1-4b33-b86b-45f2a770af9f,12726.77,debit,bank-fee,AU00000,2024-04-25T15:58:53Z
transaction,4b586a96-f0ad-4aba-b6bf-baead79bef77,posted,Electricity Bill Payment,-1351.5,fdf310c9-0952-489e-9edd-f090ccf67bfc,11375.27,debit,cash-withdrawal,AU00000,2023-07-14T03:51:43Z
transaction,e765e195-1b07-4607-b3fe-4d16ac360174,posted,TRANSFER TO JOANNA SMITH CAMPING,-4123.3,c5566913-02ef-4f41-a623-c8c9a3dfa7ef,7251.97,debit,payment,AU00000,2023-10-27T00:05:31Z
transaction,749ebca9-0544-4298-abec-e51fd3eb8e6c,posted,TFR Acc14000 TO 12389,-3566.17,07add8a1-527d-4f8d-b0a3-679f966b08bf,3685.8,debit,bank-fee,AU00000,2023-08-12T05:33:34Z
transaction,b91242a6-c817-42da-a189-22abd52f6cb7,posted,Public Transport Fare,-4919.7,5fbd0578-fd29-4f45-bd79-355fd94ddf81,-1233.9,debit,bank-fee,AU00000,2023-06-11T11:53:15Z
transaction,ce8262a6-acde-499a-a0d3-a5ed09591e85,posted,Mobile Phone Bill Payment,-3170.38,01e2a3e9-f48c-43e3-80fd-ca1df490ee09,13807.84,debit,cash-withdrawal,AU00000,2024-03-14T19:05:54Z
transaction,e57dfa22-3462-4a11-a431-50825f1e609d,posted,Gym Membership Fee,-3324.56,a50c7e91-4371-4a78-945e-53fca3cfab17,10483.28,debit,bank-fee,AU00000,2023-05-31T19:01:57Z
transaction,1cd5de14-1842-48ad-953e-950fbf4edd5b,posted,Travel Agency Booking,-3892.92,2cd03dc2-088c-4d27-9e33-0e2b59184723,6590.36,debit,payment,AU00000,2023-08-19T20:42:27Z
transaction,477bd277-6ea5-4958-a9f2-2fbd16044f03,posted,AGL RETAIL ENERGY LTD (GAS),-4759.57,26bce354-e131-469e-bf0c-f1ea3670bdf5,1830.79,debit,bank-fee,AU00000,2023-06-28T21:33:44Z
transaction,cb838e77-8bec-48bd-90e6-c3332087fe09,posted,Payroll WFRMS 15439393,11751.25,ffc3e3f4-c152-48df-a520-b1a927611883,13582.04,credit,transfer,AU00000,2024-01-01T00:01:34Z
transaction,693f7d97-04e8-4394-bc79-a1a85792f45a,posted,Gasoline Purchase,-4901.15,8f6050aa-54af-45ea-b7d1-db322837fdab,8680.89,debit,cash-withdrawal,AU00000,2024-03-07T13:56:49Z
transaction,a79a7b08-1b88-4b61-b3cd-6feb51052b23,posted,Restaurant Dinner,-3725.7,baa769df-9924-467c-82c7-8c12adecc622,4955.19,debit,bank-fee,AU00000,2024-02-23T20:51:32Z
transaction,05de0052-a3d1-4d62-950c-21b96651fdfd,posted,TFR Acc14000 TO 12389,-4387.46,8cb59009-ac7d-436c-bdb0-e092a163bf54,567.73,debit,cash-withdrawal,AU00000,2024-05-10T17:03:03Z
transaction,407d95f8-a086-44be-8b9e-64f853228e9e,posted,Restaurant Dinner,-1303.39,649fe03a-406d-4d2b-be23-5de37dc4ade7,-735.66,debit,cash-withdrawal,AU00000,2023-12-31T01:54:03Z
transaction,1586b5d6-b16f-466e-aeb8-e4c6e53beb36,posted,Car Maintenance Expense,-1338.09,dd20a09d-ed92-4d32-a310-310e06b028e6,-2073.75,debit,cash-withdrawal,AU00000,2024-02-29T00:20:26Z
transaction,f02dad9d-0bca-473b-b3df-056e92138457,posted,Manly Maths Tutor Wages,-4697.41,24b33851-7101-4510-98bd-d386f72ff397,8963.29,debit,cash-withdrawal,AU00000,2023-05-26T01:40:20Z
transaction,f391fb41-6860-4f76-97d4-3533c41b91cf,posted,Coffee Shop Purchase,-635.46,8e2be2a7-22dc-4b3e-a7bf-54b8e4cf576e,8327.83,debit,payment,AU00000,2023-06-26T08:16:50Z
transaction,858eb464-ae01-47a2-b3f1-4680ff4ed9fa,posted,Travel Agency Booking,-2305.88,8062950d-660c-490f-98ae-924ac67a2a33,6021.95,debit,payment,AU00000,2023-05-18T11:24:20Z
transaction,d2608028-19ce-40f8-9342-9b6f06b0aa9f,posted,Pharmacy Purchase,-3048.61,8904cb23-64e7-47f7-a2fa-f07a718f0be1,2973.34,debit,bank-fee,AU00000,2024-02-01T16:54:54Z
transaction,efc8149c-aa75-4b33-a6aa-abf4c5b0a5ad,posted,Non Hooli ATM Withdrawal Fee,-1254.2,8a6d72c7-c780-40bc-8792-780eb21053d6,1719.14,debit,payment,AU00000,2023-10-02T14:31:37Z
transaction,98b84940-b725-4301-bfcb-9dc86ef2b1b7,posted,Gasoline Purchase,-4372.07,c48c0306-67d9-432b-a89b-e2701f4569a1,-2652.93,debit,cash-withdrawal,AU00000,2024-01-27T12:02:12Z
transaction,1067cf85-5535-4372-8b5e-747d95f55b0a,posted,Car Maintenance Expense,-1964.78,1088e928-45ef-40a0-8eba-3309324dadb7,-4617.71,debit,cash-withdrawal,AU00000,2023-11-09T13:14:15Z
transaction,0e7e633f-deab-452c-aac6-1232fd74380a,posted,Mobile Phone Bill Payment,-2630.99,9f9cac9d-ab12-49c6-9475-bce642add26b,-7248.7,debit,cash-withdrawal,AU00000,2023-09-06T08:40:23Z
transaction,efdd0ab0-582e-45ee-ace9-5475458e999f,posted,AGL RETAIL ENERGY LTD (GAS),-4410.99,3d0b9b7f-2a2a-4a5e-b864-f4b84fbd71cb,-11659.69,debit,bank-fee,AU00000,2024-03-15T01:50:52Z
transaction,6fbe6732-dbac-4d68-9dc3-6276b390a035,posted,CTRLINK CARERS Ref: 998R6789201610974V,-3537.05,7395b705-d54f-475a-8b57-26e5cad707c7,-15196.74,debit,cash-withdrawal,AU00000,2024-03-13T23:20:24Z
transaction,9320f729-5ab2-4125-9851-a4ac0b90bc4c,posted,Coffee Shop Purchase,-2943.4,64cfe479-a908-4c68-8847-502835e95bbc,7915.67,debit,cash-withdrawal,AU00000,2024-05-03T10:06:35Z
transaction,52966230-afd1-48d0-8f04-78b5da3a3d59,posted,TRANSFER TO JOANNA SMITH CAMPING,-3984.43,f267e8f5-241b-4d8d-b184-8f4134d1f71c,3931.24,debit,payment,AU00000,2024-02-02T23:34:39Z
transaction,91ab1432-8b3a-4957-81b3-0ad05d32a28f,posted,Bookstore Purchase,-1694.62,fd90bb2b-c71a-43ce-8ff4-26bcac579f96,2236.62,debit,cash-withdrawal,AU00000,2023-09-30T21:53:48Z
transaction,35042fd8-2426-4d82-a252-f86c04e131a0,posted,Home Improvement Store Purchase,-19.11,32c36764-4958-4381-a6ce-82a22b642f29,2217.51,debit,payment,AU00000,2024-05-07T01:12:12Z
transaction,8e2dd012-3073-4f7f-aabf-14d742109d51,posted,Transfer Platnm Homeloan 346454,-1540.53,86ce1368-8332-4523-8d43-b83b28b3f406,676.98,debit,payment,AU00000,2023-07-24T09:22:36Z
transaction,2c49eb60-30aa-4879-9e42-dfb84695d9ad,posted,Gym Membership Fee,-4577.49,600df2c7-488a-46e6-8bed-9638047e75a1,-3900.51,debit,payment,AU00000,2023-08-01T09:19:25Z
transaction,53ef42bd-6e60-4235-be1b-e10be04ac803,posted,Car Maintenance Expense,-4933.53,93b175bb-240a-4105-a69b-b461838fd5e0,-8834.04,debit,payment,AU00000,2023-09-04T16:41:36Z
transaction,07bb8cd6-4089-4c71-8335-a68929fd97ba,posted,Non Hooli ATM Withdrawal Fee,-3734.47,82f2a11d-f127-4c12-b699-ddbf6270779f,-12568.51,debit,payment,AU00000,2023-09-21T03:58:02Z
transaction,69d0cf15-b9ee-456b-86c9-6142513c6486,posted,CTRLINK CARERS Ref: 998R6789201610974V,-2597.43,62064d9f-aa0f-411e-acd9-fcd2ada7cc70,-15165.94,debit,payment,AU00000,2023-06-13T23:59:56Z
transaction,5bcc0e08-1882-4927-9ca1-1d556a343412,posted,Netflix Subscription,-2467.89,3c99df59-8c03-431f-92f5-5333b2995b31,-17633.83,debit,cash-withdrawal,AU00000,2024-03-01T08:01:15Z
transaction,bbcc5bed-918b-4e64-8c2e-a27f02fc1899,posted,Amazon Online Shopping,-602.81,f6b0b0c6-e044-4aec-9100-90c2d19f9125,4590.91,debit,bank-fee,AU00000,2023-12-01T14:11:00Z
transaction,9364ef0d-8dce-4372-9b82-86935f0e5292,posted,Clothing Store Purchase,-2467.32,5d8f6b97-24e9-4cf3-8bb0-8f3ebcdfe690,2123.59,debit,payment,AU00000,2024-01-12T09:20:10Z
transaction,3805411f-c885-42fa-932f-4a25b28bd109,posted,Gym Membership Fee,-3487.56,5e69ee69-bd7f-431f-b0b6-3f0b42c9b228,-1363.97,debit,bank-fee,AU00000,2024-01-03T22:03:54Z
transaction,debe395d-2bb1-48bc-81d0-970393da0c24,posted,Travel Agency Booking,-466.27,944d494e-bbde-4444-8c7c-09ad8fa8937f,-1830.24,debit,cash-withdrawal,AU00000,2023-07-16T10:00:45Z
transaction,b1741333-02a2-48c4-899d-1e413170ef20,posted,Movie Ticket Purchase,-4390.28,d437f175-a0d2-4d3c-af17-a738eefdf72b,-6220.52,debit,bank-fee,AU00000,2023-07-05T10:51:49Z
transaction,f6c3310d-9c65-46b1-830d-f554c8d28b19,posted,Non Hooli ATM Withdrawal Fee,-3094.7,072617b7-db69-419a-835c-76f98c5cf062,-9315.22,debit,cash-withdrawal,AU00000,2024-03-24T14:16:37Z
transaction,318231b1-a0d1-4c5f-8c6c-1ae8e37c0623,posted,Travel Agency Booking,-1240.98,7ef4334d-9df7-4bf0-8457-ce0f9de5c84d,-10556.2,debit,cash-withdrawal,AU00000,2023-05-27T07:30:01Z
transaction,b7e82c48-27fb-4c16-a711-7c119cab6c59,posted,Wdl ATM WESTPAC IGA BALGOWLAH BALGOWL AU,-3306.0,f6934ded-98df-4123-841f-deb2567c146d,-13862.2,debit,cash-withdrawal,AU00000,2024-03-03T20:03:47Z
transaction,fcdffa00-ef69-4c84-9967-63e96b0280ef,posted,Car Maintenance Expense,-935.36,de6b5dec-8e8e-44ff-b4f5-97414381f3f2,-14797.56,debit,bank-fee,AU00000,2024-02-04T23:37:15Z
transaction,90759d11-b15c-4a31-a132-6626ebb4d685,posted,Hair Salon Appointment,-1499.54,23e07fc1-e00e-44c4-a80a-8d73ef51256a,-16297.1,debit,cash-withdrawal,AU00000,2023-09-16T10:09:21Z
transaction,c3e9639a-3430-4648-aca7-b80cabcd7b68,posted,Movie Ticket Purchase,-4558.51,f1faf71b-fc4b-4337-9878-41e1665bf77f,7314.83,debit,bank-fee,AU00000,2023-08-24T00:19:28Z
transaction,740d1f30-3093-4288-9739-c1ab30771e86,posted,Manly Maths Tutor Wages,-3947.45,e0f0630b-3019-4e28-a355-6a5e1e8a15b9,3367.38,debit,cash-withdrawal,AU00000,2024-04-01T16:11:27Z
transaction,c683d02d-96f3-4fd2-ae46-67a44b3161a6,posted,Online Gaming Purchase,-1655.77,aba123d9-939a-4cce-9947-ba62937a47f5,1711.61,debit,bank-fee,AU00000,2023-12-05T09:04:38Z
transaction,b5589b3d-bbdc-4ee5-b664-0524f68bf013,posted,Pharmacy Purchase,-284.34,595f04e9-fcac-4a86-8d05-f0b59331b89e,1427.27,debit,cash-withdrawal,AU00000,2023-12-03T08:33:05Z
transaction,78f42bf1-756b-45ef-a815-50715bc6308c,posted,Movie Ticket Purchase,-4687.32,05a304c1-0882-42a5-9f08-0a5c133e5eaf,-3260.05,debit,payment,AU00000,2023-10-22T16:32:15Z
transaction,a83af34e-2b26-4941-8868-6e2e8b49974f,posted,CTRLINK CARERS Ref: 998R6789201610974V,-1199.86,286865e0-01ab-44c1-b9ad-ca66608e2f6e,-4459.91,debit,bank-fee,AU00000,2023-08-28T09:08:22Z
transaction,8c76d444-c35d-4d25-9ff0-999b07264c35,posted,Non Hooli ATM Withdrawal Fee,-2571.03,ecf002ba-47df-413a-8f94-d57b9d4b2919,-7030.94,debit,cash-withdrawal,AU00000,2023-08-11T15:39:38Z
transaction,3511f727-3bc8-443f-9ab6-ce6d3d9426a1,posted,Bookstore Purchase,-2411.22,4c03f238-0285-4d6a-9699-20ed2f02afd8,-9442.16,debit,bank-fee,AU00000,2023-07-12T14:34:01Z
transaction,e91f5ca3-cdfc-4b32-98e0-a286e0981e91,posted,Online Gaming Purchase,-4093.36,1c49133f-bb8d-4877-b481-7bc2ca029be5,-13535.52,debit,cash-withdrawal,AU00000,2024-03-05T17:30:01Z
transaction,75bd9235-1efd-49f5-86ca-832e86207a27,posted,Amazon Online Shopping,-2107.66,302234ac-8b90-45a3-80d0-71e0a824b914,-15643.18,debit,cash-withdrawal,AU00000,2023-11-04T11:46:08Z
transaction,ef6a7fb0-27c5-4045-894c-c572c41dd9f8,posted,Travel Agency Booking,-2687.25,8e25be96-5de0-4d18-b15c-b1fc47d20f26,8962.02,debit,payment,AU00000,2023-06-12T17:55:15Z
transaction,99cede81-d3de-4ab6-8111-691a77506b63,posted,Restaurant Dinner,-4981.95,9919f834-97c0-40a7-ac6e-459da1459645,3980.07,debit,bank-fee,AU00000,2023-11-21T12:29:18Z
transaction,c0198897-d402-4b89-9d60-864ed75f8781,posted,Payroll WFRMS 15439393,10130.2,01934fe1-acf4-410f-895d-bcbe5729649b,14110.27,credit,transfer,AU00000,2023-10-26T12:38:28Z
transaction,ea1a90cb-96af-4514-ba6a-8a1436e96585,posted,AGL RETAIL ENERGY LTD (GAS),-776.61,6e553986-60b1-4893-8d6e-95651a42740f,13333.66,debit,cash-withdrawal,AU00000,2023-07-20T19:32:06Z
transaction,bf76a4e2-54cb-4e75-9a18-b1d4ce801de0,posted,Netflix Subscription,-4851.98,5767f237-fee4-45c7-8b38-4eeff1ae3732,8481.68,debit,bank-fee,AU00000,2023-11-02T13:19:28Z
transaction,c0b2f31d-f4e2-4dec-8fcc-17af2082315f,posted,Bookstore Purchase,-4757.07,f3e4019c-0243-4fb2-bae0-2af83bf67d5c,3724.61,debit,payment,AU00000,2023-12-26T15:14:27Z
transaction,819c6034-98b9-497c-8e0a-627494f4f34d,posted,Home Improvement Store Purchase,-4369.53,3f18d86f-3864-4356-bb49-007a36ca0202,-644.92,debit,cash-withdrawal,AU00000,2024-04-23T08:49:49Z
transaction,2ef6847d-d5b2-4d6c-940e-5ad9f9a75580,posted,Home Improvement Store Purchase,-71.23,1fd22992-f6fa-4a93-bba4-713c70e3beea,-716.15,debit,payment,AU00000,2023-07-06T00:40:35Z
transaction,22d9a477-0509-4f95-9382-923768c2fca5,posted,Public Transport Fare,-1287.59,677e1aa2-cb86-47f2-a3cb-b8c30d972025,-2003.74,debit,bank-fee,AU00000,2024-03-19T17:11:44Z
transaction,005aac51-367c-4268-b544-fee04ec4d05c,posted,Electricity Bill Payment,-4236.27,0d105041-8c9b-489f-a2b2-407d4f3994dd,-6240.01,debit,cash-withdrawal,AU00000,2023-09-29T05:23:49Z
transaction,161af258-7c80-4a9d-a64e-3375fba6b072,posted,Car Maintenance Expense,-474.59,f069c3f7-4dae-45d6-9e0f-f00d75430e78,13605.68,debit,bank-fee,AU00000,2024-01-11T23:52:39Z
transaction,d992515f-cb58-43dc-a9cc-f85aae99a8e9,posted,Mobile Phone Bill Payment,-476.78,f646e62a-2bf0-41c6-925d-abb62a5773dc,13128.9,debit,payment,AU00000,2023-09-05T15:32:56Z
transaction,feaa6b64-9238-48fd-8e1d-c2620134c3b9,posted,Restaurant Dinner,-3897.72,f9d3fa98-cb53-4850-b5eb-4ae28cb1bc82,9231.18,debit,bank-fee,AU00000,2024-01-29T23:01:37Z
transaction,04e6a35d-9f65-4fd6-bac7-aedfecac39d0,posted,Manly Maths Tutor Wages,-3913.78,804f51f1-2a07-4d4e-8be9-57e19b810f01,5317.4,debit,bank-fee,AU00000,2023-05-31T16:15:56Z
transaction,5bc26b28-abdd-42bd-bdee-781069662a07,posted,Hair Salon Appointment,-4870.44,013eb0d4-71b5-4e6d-bafa-1f6fb5395099,446.96,debit,bank-fee,AU00000,2023-06-21T09:23:05Z
transaction,7d8409cb-3c51-425f-92b9-7f48691709ed,posted,Transfer Platnm Homeloan 346454,-3992.19,739fcd18-0dae-4c16-9b24-3b28b87e5868,-3545.23,debit,cash-withdrawal,AU00000,2023-07-21T00:33:30Z
transaction,bc51db96-90a1-45da-97a7-70470925e928,posted,Netflix Subscription,-720.92,07603f5c-9249-4782-a9a6-a631385d303f,-4266.15,debit,cash-withdrawal,AU00000,2023-06-24T02:41:42Z
transaction,f58ca1d6-02d9-4840-bba7-356d379dedbd,posted,TFR Acc14000 TO 12389,-263.84,69d61d24-ec6e-4b1b-b64d-eecd65ecb676,-4529.99,debit,bank-fee,AU00000,2024-04-04T23:19:47Z
transaction,a9190e2c-1106-484a-a057-11c2b99ac252,posted,Restaurant Dinner,-2845.59,7747d9b7-5bbf-4c41-b0f7-a356eb5f00ec,-7375.58,debit,payment,AU00000,2023-06-18T15:37:16Z
transaction,a943cf28-679d-41e6-b0db-279efbeab8b8,posted,Uber Ride,-3591.25,2acd48b0-fe19-4bbc-8ac1-942d4002088f,-10966.83,debit,bank-fee,AU00000,2023-11-18T08:23:21Z
transaction,d0e42b66-0658-402b-aa7c-e9c1a08e758e,posted,Mobile Phone Bill Payment,-3409.79,fda0eed1-bdd2-4679-91d7-0f695c52cb3c,10735.25,debit,cash-withdrawal,AU00000,2024-01-09T17:28:59Z
transaction,254e5dfb-1cb9-4faf-9918-d6f0d4e78a59,posted,Gasoline Purchase,-2730.03,21754557-876a-40fb-9b4b-31ab81663edb,8005.22,debit,bank-fee,AU00000,2023-11-18T02:12:16Z
transaction,9216e2b5-0614-4168-ab04-20bcbc50da04,posted,Travel Agency Booking,-1354.98,131c92d6-25b2-42d4-aea5-1c43d009ff1a,6650.24,debit,cash-withdrawal,AU00000,2023-05-22T03:19:46Z
transaction,f2758598-e82b-4ef6-a1f0-475c1647eded,posted,Restaurant Dinner,-4482.02,04e75a76-468a-4ac1-938e-c2dc8d600393,2168.22,debit,bank-fee,AU00000,2023-12-17T00:23:20Z
transaction,76ec93f8-55de-4de4-a839-c2ddfdbe474f,posted,Online Gaming Purchase,-73.39,f88c51eb-f1f8-4a28-929e-8e70138712ec,2094.83,debit,payment,AU00000,2023-07-09T13:39:00Z
transaction,520f67fd-4e28-48aa-a6ed-4290e768d210,posted,Amazon Online Shopping,-4113.87,99deb7d8-2e56-42a5-ad87-4d601e212530,-2019.04,debit,payment,AU00000,2023-09-15T10:49:27Z
transaction,6b52549c-460b-450c-8150-908fe2e15898,posted,AGL RETAIL ENERGY LTD (GAS),-334.12,0a2dee8e-d740-4acf-b78f-a512633a359d,-2353.16,debit,bank-fee,AU00000,2023-12-18T13:03:14Z
transaction,47fb111d-1e17-4d1f-8e7d-7aa3f07cf64d,posted,Music Streaming Subscription,-4524.29,995880cf-561a-4c44-ad49-a6dd8ae3be5e,-6877.45,debit,payment,AU00000,2024-01-15T18:41:25Z
transaction,c1694448-8a5e-4626-b07b-c40394a702c3,posted,Amazon Online Shopping,-2799.81,3ff825ad-ead2-4c36-982c-cda28ed83986,-9677.26,debit,bank-fee,AU00000,2024-04-30T11:43:45Z
transaction,e37544ed-2159-46ed-a06d-54399b55b5bb,posted,Movie Ticket Purchase,-2061.0,8daf493c-d58c-465f-93fc-819f81fdbd5a,-11738.26,debit,payment,AU00000,2024-04-25T13:28:21Z
transaction,0d174256-5297-4d7b-bb68-547a66f06d82,posted,Non Hooli ATM Withdrawal Fee,-3536.78,159588a7-4245-420c-85ee-3dc3c3c26770,4612.67,debit,bank-fee,AU00000,2024-01-14T14:32:27Z
transaction,ad8fe72c-ec6a-4d3b-8bfa-335a3cbb7ff4,posted,Mobile Phone Bill Payment,-4709.74,34090cd3-4575-4f00-800e-d6e9ac14bd18,-97.07,debit,bank-fee,AU00000,2024-02-16T11:07:35Z
transaction,8951c165-b4b8-4cb4-97c9-817d11f4e1fa,posted,Coffee Shop Purchase,-147.63,f115596d-378b-479a-bb66-2f18cac86afc,-244.7,debit,cash-withdrawal,AU00000,2023-07-16T08:58:15Z
transaction,0e4fc179-fac4-4037-a424-200acdde4561,posted,Movie Ticket Purchase,-1941.74,c1641bc6-fe64-4167-be12-16951afd693a,-2186.44,debit,payment,AU00000,2023-06-05T23:04:39Z
transaction,22df5485-99f0-4a98-9141-cf03ec60e77c,posted,Electricity Bill Payment,-2340.77,cc34ead4-a5ae-42c9-9a7e-9535b72fcc4f,-4527.21,debit,cash-withdrawal,AU00000,2024-01-26T12:28:42Z
transaction,97d9181e-5ced-4e02-8ecf-e3593758ec2f,posted,Gym Membership Fee,-551.11,f22ff11c-8a88-4bf6-8129-93d543b5d2b6,-5078.32,debit,bank-fee,AU00000,2024-04-20T07:25:44Z
transaction,dd1c4425-b017-4f02-8563-cbd7191466c9,posted,Payroll WFRMS 15439393,10603.68,a554966c-8f15-42fa-9f21-483d3f415dbc,5525.36,credit,transfer,AU00000,2023-07-17T15:56:43Z
transaction,df719f64-c53b-4e81-b22c-58ab6ce70c1e,posted,Travel Agency Booking,-3054.48,038b57e4-18a4-401d-9449-f6a6d2b212bd,2470.88,debit,bank-fee,AU00000,2023-08-28T08:37:23Z
transaction,c773afbb-d7d3-4a7e-b4e7-02f4f1eea83f,posted,Home Improvement Store Purchase,-3829.24,0d5f5bea-bac9-400a-bbfc-4cadeeb3377b,-1358.36,debit,cash-withdrawal,AU00000,2024-02-03T18:03:44Z
transaction,97d03053-1fa0-4720-82a9-bab58375af78,posted,Bookstore Purchase,-1657.89,8c685ec5-a12f-4065-bec5-3d77f07aa763,-3016.25,debit,payment,AU00000,2024-03-13T12:32:08Z
transaction,eaa3feef-71f3-466a-9b02-230661ee8eb2,posted,Transfer Platnm Homeloan 346454,-3966.34,d5d24fc3-f644-4fc6-b374-53f91a1bf826,14858.36,debit,cash-withdrawal,AU00000,2024-04-12T16:29:38Z
transaction,e48193ae-28a6-4cf5-83d3-01f323cf53c9,posted,Amazon Online Shopping,-2185.9,d20d9f51-b920-4800-99de-fb5cd12bddf2,12672.46,debit,bank-fee,AU00000,2024-01-09T04:54:42Z
transaction,03fafc38-98f5-4692-83f0-a41ea1cc9618,posted,Home Improvement Store Purchase,-1813.6,8c55e35c-8f89-4120-a1a1-e60904d3d5fc,10858.86,debit,payment,AU00000,2023-08-28T16:22:43Z
transaction,4d97648b-8938-4470-a56a-28c791dea104,posted,Clothing Store Purchase,-4309.44,76a4b783-cb33-4477-8b33-934e42034df6,6549.42,debit,bank-fee,AU00000,2023-11-20T12:37:50Z
transaction,9f8fb152-3396-4760-a128-c2e4ee7bc552,posted,Movie Ticket Purchase,-3109.33,e032ca73-0b57-42b1-96c6-fef5d710a0e2,3440.09,debit,cash-withdrawal,AU00000,2023-07-24T05:34:31Z
transaction,b1da29b3-e561-4a90-94cb-513035b75b21,posted,Car Maintenance Expense,-2286.8,a26b1eb1-f499-42a9-a131-cb9c1b982981,1153.29,debit,cash-withdrawal,AU00000,2023-10-20T14:11:18Z
transaction,da68cddc-4542-430b-8e58-b45f5219e13c,posted,Public Transport Fare,-2896.98,ca4b68db-8780-46b8-aea0-e7adb13d049c,-1743.69,debit,payment,AU00000,2024-01-24T14:42:02Z
transaction,faf0d5a4-0d17-42a4-b722-f216b71f67ce,posted,Payroll WFRMS 15439393,11010.54,5ebf99c0-d723-4c36-aa8f-ae37207aeeaa,9266.85,credit,transfer,AU00000,2024-02-25T06:14:06Z
transaction,9e10ae67-0b8f-459a-93f6-8dfbaa8f11a0,posted,Clothing Store Purchase,-3181.13,43ba487b-9472-462c-a648-c60a550da7f5,6085.72,debit,payment,AU00000,2023-09-30T10:29:10Z
transaction,11f3b576-eeed-4f08-b37f-96c39d8c53c5,posted,Mobile Phone Bill Payment,-3240.85,fd13fc53-9899-42d2-8cf7-3c29d54ab0b6,2844.87,debit,payment,AU00000,2024-01-04T18:28:52Z
transaction,d8b1fac5-18d8-4726-ba99-4dada92c1c44,posted,Music Streaming Subscription,-43.8,5df2f274-c71e-410f-b251-6252ae528074,9757.47,debit,cash-withdrawal,AU00000,2024-04-20T10:47:37Z
transaction,7838f67a-d808-44d9-a37b-56ed00465b3d,posted,Pharmacy Purchase,-2048.82,ef4f49ab-c02a-4c50-b205-8810c90b12d9,7708.65,debit,cash-withdrawal,AU00000,2023-09-01T02:21:27Z
transaction,41b7d988-e343-403a-bb30-0185ac703630,posted,Movie Ticket Purchase,-4611.67,df966ea1-e938-411d-9dd7-0c69a81279de,3096.98,debit,bank-fee,AU00000,2024-02-18T04:43:11Z
transaction,89a1bb7f-a756-4727-b82a-b6d516576061,posted,Travel Agency Booking,-3725.43,eac82380-2745-4897-9db9-399b7c2f2012,-628.45,debit,cash-withdrawal,AU00000,2023-08-08T22:01:39Z
transaction,a1a5a7af-4253-4eaa-b916-9fd522525930,posted,AGL RETAIL ENERGY LTD (GAS),-874.58,0150c204-f0ac-48a6-9c87-e7b1ceda4a05,-1503.03,debit,bank-fee,AU00000,2024-04-11T10:27:52Z
transaction,8b471556-586f-4b7c-ac4c-19636f431bed,posted,Gasoline Purchase,-3485.12,aa01c9a2-d4ad-47ff-a3e9-67c70746d701,-4988.15,debit,cash-withdrawal,AU00000,2024-04-18T15:14:01Z
transaction,41572806-f171-41a9-a21f-7f2ec8b13cb7,posted,Transfer Platnm Homeloan 346454,-1382.99,a72234ba-ce6e-4f14-8968-249fe09a9124,-6371.14,debit,bank-fee,AU00000,2023-06-15T03:38:17Z
transaction,23a783f3-6cae-4b2e-859a-bed30e6a0e5e,posted,Uber Ride,-2195.43,2b633437-caa9-4e70-82e3-3e4f8e8c8a6f,-8566.57,debit,payment,AU00000,2023-08-03T00:35:17Z
transaction,04af398d-959b-421e-bbdc-232bb381ef7f,posted,TRANSFER TO JOANNA SMITH CAMPING,-2918.71,881ca61c-3af0-4e73-8143-ac93eb105c72,-11485.28,debit,bank-fee,AU00000,2023-10-19T15:56:25Z
transaction,01a8f6c4-9fb1-473b-adc1-2d5e52c0b0e7,posted,Home Improvement Store Purchase,-1131.05,ca5b5925-38bc-4e2a-9321-649adf07d2f4,-12616.33,debit,bank-fee,AU00000,2023-09-17T01:39:12Z
transaction,bc6dd7ff-9af3-4c94-99b9-824c2368f26d,posted,Coffee Shop Purchase,-1335.47,d61f5f15-67db-48ba-865a-0b58eb4437ba,15810.42,debit,cash-withdrawal,AU00000,2023-12-19T14:09:58Z
transaction,b304308f-35ad-488f-b288-6334dcc17547,posted,Travel Agency Booking,-1131.41,f2010a93-d4dc-4836-81e8-77fd70e6ddd0,14679.01,debit,cash-withdrawal,AU00000,2023-10-15T13:28:42Z
transaction,7343d051-fd91-42af-b14c-6dd0fa0514e1,posted,Netflix Subscription,-785.65,aa7ea9b1-477e-45f5-bb62-7ab6bf292ef6,13893.36,debit,cash-withdrawal,AU00000,2023-07-19T13:54:55Z
transaction,bbd25a56-a8d5-4f33-a358-2e52ddd76be1,posted,Online Gaming Purchase,-4151.89,762159f3-7ac7-4fcf-9340-26eda9cf2205,9741.47,debit,payment,AU00000,2023-06-16T12:17:26Z
transaction,ae58fa09-cd63-4454-96f8-2280d3262c8e,posted,Music Streaming Subscription,-2041.83,433e50f6-2abb-4d55-bd1b-65e9c88bf2af,7699.64,debit,bank-fee,AU00000,2023-09-10T23:16:52Z
transaction,77503f4c-90e5-470d-a606-c09e1393d168,posted,Wdl ATM WESTPAC IGA BALGOWLAH BALGOWL AU,-3041.81,9f9d17fb-eca8-4087-a228-564c841d654a,4657.83,debit,payment,AU00000,2023-08-09T10:24:30Z
transaction,96b2724b-61ca-431f-a8d5-ac2bf27cd8ac,posted,Coffee Shop Purchase,-4112.92,1e8b1799-845e-461e-94cd-f2f7999deaec,544.91,debit,bank-fee,AU00000,2023-06-01T10:09:12Z
transaction,39d6df80-70ab-45b8-b10f-92079c8e3f37,posted,Online Gaming Purchase,-1041.19,b8cc180b-2d37-4cb0-984c-ca5ce0948557,-496.28,debit,payment,AU00000,2024-04-11T01:35:05Z
transaction,5398fc0b-413d-4f77-aa9e-4092b61b2f34,posted,Gasoline Purchase,-2327.45,1ccb9ea1-ddb2-47dd-9b40-bb7a8e92f04f,-2823.73,debit,cash-withdrawal,AU00000,2024-02-01T20:29:45Z
transaction,41169a3f-8cbc-4977-a2f9-101f48f2b1fb,posted,TRANSFER TO JOANNA SMITH CAMPING,-3780.88,08f53d20-68b2-44d7-a3e8-e1103cc3fc97,-6604.61,debit,cash-withdrawal,AU00000,2023-10-07T23:40:51Z
transaction,5f70fdd6-db31-4514-b9a7-d6953f5c8a80,posted,Non Hooli ATM Withdrawal Fee,-2941.96,8eff2cdb-a9c2-4220-a9b7-950c46bbe8dc,15247.17,debit,cash-withdrawal,AU00000,2024-02-12T07:06:53Z
transaction,828754c0-1d3a-4a12-934d-a30440b999e6,posted,Clothing Store Purchase,-4459.42,e8c79fee-2661-47dd-bd94-8ddf1e16ae22,10787.75,debit,payment,AU00000,2024-02-19T10:33:16Z
transaction,4a5ed21a-b075-4a0b-bd8f-0071f3ec696e,posted,TRANSFER TO JOANNA SMITH CAMPING,-4005.67,0f9bf79c-7541-41a6-9c4d-489b7570dc0e,6782.08,debit,payment,AU00000,2024-02-13T20:41:39Z
transaction,92f7e1a6-7e74-42ab-b0bd-b0927a1f48d3,posted,Movie Ticket Purchase,-3155.94,587863f1-0ea6-4c7e-ac3c-240ecca90b7d,3626.14,debit,bank-fee,AU00000,2023-10-05T17:19:24Z
transaction,fd2f01d9-579d-49f7-8f7b-4a6f815ef170,posted,Coffee Shop Purchase,-220.54,3badc6c6-3f90-430e-a0b9-2c681758b25b,3405.6,debit,bank-fee,AU00000,2024-01-22T08:01:44Z
transaction,f9d5a8b3-6a28-442f-ba6b-85fd9e6818f1,posted,Public Transport Fare,-122.5,0be79226-480b-4101-831b-c523a638d35a,3283.1,debit,bank-fee,AU00000,2023-05-27T08:46:16Z
transaction,c41c39fc-cc79-4837-a084-1dac5a146f78,posted,Coffee Shop Purchase,-4641.95,2516884e-605d-4c6e-b3ed-0d19ad7c5475,-1358.85,debit,cash-withdrawal,AU00000,2024-05-03T21:40:24Z
transaction,5f4c953b-a1ce-4342-affe-bc6275281322,posted,Restaurant Dinner,-3187.44,517a33c4-28e8-47fd-801b-7bf1ae133a49,-4546.29,debit,payment,AU00000,2024-04-04T21:50:58Z
transaction,c184f088-6ef7-475d-b460-eb9bffc8c5a0,posted,Uber Ride,-984.25,6f54748e-6214-489e-bb5e-a88a6fa75fd6,-5530.54,debit,cash-withdrawal,AU00000,2023-06-05T06:46:53Z
transaction,a71e9924-1153-4817-916d-989c3e9597ef,posted,Bookstore Purchase,-3292.23,9e9cd14c-df52-4f0e-9aba-953799beb42e,-8822.77,debit,cash-withdrawal,AU00000,2023-06-17T23:08:47Z
transaction,499e8fe0-ae0d-4f0b-8afa-c4eeaa76ca95,posted,Manly Maths Tutor Wages,-3570.75,0d21a141-a84c-4867-aa27-bf2cfb20b1c0,3415.9,debit,bank-fee,AU00000,2023-05-18T01:42:27Z
transaction,62b829f7-2636-42c6-9937-a8f5d2e5c485,posted,Mobile Phone Bill Payment,-592.58,7355b08f-8652-4d4d-9147-9a129849378c,2823.32,debit,bank-fee,AU00000,2024-01-14T08:53:55Z
transaction,1a6202ef-6bb7-4b5b-90ef-9ba09056926b,posted,Travel Agency Booking,-19.71,487ac715-83f6-48b7-8a7f-33f1f6f976b4,2803.61,debit,bank-fee,AU00000,2023-11-17T19:34:25Z
transaction,4a7b0ba7-c0d3-4746-a259-f7c5151201d2,posted,Bookstore Purchase,-2972.14,cc111f2c-b95a-4959-8c98-9b1067ddb532,-168.53,debit,cash-withdrawal,AU00000,2024-02-16T07:59:23Z
transaction,1421b61c-abe3-40dc-abc8-b151286fc515,posted,Public Transport Fare,-3549.54,f75fcfb3-a156-4181-b933-95ce95c2de1e,-3718.07,debit,payment,AU00000,2024-04-13T07:00:20Z
transaction,149f0e62-70ba-4e5d-b2d2-e7b4846dc4a2,posted,Bookstore Purchase,-4538.76,bcbe4c45-95da-4fe6-bd09-dc749df72256,-8256.83,debit,payment,AU00000,2024-05-08T19:34:27Z
transaction,a5ee1ce1-ac0c-407f-9526-af37c730b453,posted,Transfer Platnm Homeloan 346454,-4271.72,81cd48c7-43de-4a82-9a58-98c1e5da2991,-12528.55,debit,bank-fee,AU00000,2023-06-17T10:57:41Z
transaction,8e8e7090-c0a9-4d88-a00b-b7117b9795b5,posted,Hair Salon Appointment,-3748.25,4435a1f7-554e-4f8d-971c-e7088cc3a51f,-16276.8,debit,cash-withdrawal,AU00000,2023-05-14T04:00:59Z
transaction,3f2fca0d-7208-4b54-9841-89b7a264acd6,posted,Uber Ride,-667.82,dc43bc6f-afb0-4b9f-a3f0-e5a9e6ef0d6b,-16944.62,debit,bank-fee,AU00000,2023-12-24T17:08:59Z
transaction,0ab8556c-304a-4f4a-a361-316f0ebce9f9,posted,Hair Salon Appointment,-4080.25,cab3ffda-3458-4b7f-928e-60a1cdf69e12,-21024.87,debit,cash-withdrawal,AU00000,2023-08-07T08:28:20Z
transaction,3d630e97-2c5d-4546-8460-f5190f95ab43,posted,Coffee Shop Purchase,-3206.71,3372c9fd-2937-41bb-ac82-b753a11b07cd,3950.18,debit,cash-withdrawal,AU00000,2023-06-14T23:15:06Z
transaction,cc2869e5-1140-4942-b3c0-46bd8199b72a,posted,Home Improvement Store Purchase,-2417.57,62aeace9-7b60-4546-a817-aa86843c7aee,1532.61,debit,cash-withdrawal,AU00000,2023-08-13T09:14:54Z
transaction,6ae2a8f1-2e65-40c9-af4f-477525bbb003,posted,Movie Ticket Purchase,-2891.21,382210ce-27bc-43e5-b12d-d6b3ba5daf44,-1358.6,debit,bank-fee,AU00000,2023-09-19T16:04:03Z
transaction,ea502e1e-6030-4049-839a-e79120f58fbd,posted,Music Streaming Subscription,-2935.5,e7df60ea-fb07-4f79-a0af-bba19d1210f6,-4294.1,debit,payment,AU00000,2024-02-09T04:40:32Z
transaction,d22ed2ab-8913-44a1-a95e-ea5c2a924069,posted,Manly Maths Tutor Wages,-1400.35,d6fb192f-6c5e-4de0-b4b3-979da36f4056,-5694.45,debit,cash-withdrawal,AU00000,2024-03-31T10:20:23Z
transaction,65d0f274-4b3f-402a-b01c-30dfd28fd6fb,posted,Coffee Shop Purchase,-3452.88,15659bba-6804-4050-9ee1-8d4d236a1eaa,-9147.33,debit,cash-withdrawal,AU00000,2024-01-04T22:52:52Z
transaction,b7d7b295-cb6a-48e4-b563-2b5fdbbc84b1,posted,Home Improvement Store Purchase,-1775.41,6124dd49-312b-4039-9e4d-1fce6fd7c678,-10922.74,debit,bank-fee,AU00000,2023-09-09T13:46:14Z
transaction,1714428b-00f6-4356-bc32-ad126388147d,posted,Manly Maths Tutor Wages,-4273.61,2b464ddd-6c63-4a7f-8dab-2edb99eae4bc,-15196.35,debit,cash-withdrawal,AU00000,2024-01-18T02:00:05Z
transaction,b76256c2-4a5f-4b7e-8a24-6fc0bc7076d9,posted,Pharmacy Purchase,-283.55,2b33bfa3-2024-4719-97d8-614f2ec808d6,-15479.9,debit,bank-fee,AU00000,2023-07-01T10:01:07Z
transaction,61cad651-461a-41ea-bfe2-115e78bf77aa,posted,AGL RETAIL ENERGY LTD (GAS),-3292.47,c5e0c96d-354e-475f-8268-8612f8b4262e,-18772.37,debit,payment,AU00000,2023-06-12T10:56:23Z
transaction,3c0afa43-b16c-488a-92f5-69c4b31cb3f5,posted,Travel Agency Booking,-4138.76,1e6b188c-ca41-4508-8d1f-ed60eff19648,6244.86,debit,payment,AU00000,2024-03-26T10:52:34Z
transaction,73200c12-6829-4828-acc0-cfcb7f8cf56d,posted,Transfer Platnm Homeloan 346454,-2005.23,e1529fae-7343-448b-8ee6-428d169beab4,4239.63,debit,cash-withdrawal,AU00000,2023-09-06T12:35:45Z
transaction,3f84d0a0-c625-4d82-812d-2563dbea5b86,posted,Electricity Bill Payment,-3410.39,66ce39d4-35d6-4683-b4d0-a3688dd3852e,829.24,debit,cash-withdrawal,AU00000,2023-08-25T10:09:20Z
transaction,6628cc1c-a28c-4bc2-8a76-e9dbf1c30e40,posted,TFR Acc14000 TO 12389,-3614.26,d7ed0cc2-95fa-4acd-a39b-847bf8b4ec2f,-2785.02,debit,payment,AU00000,2024-03-06T09:16:46Z
transaction,0e37030b-aee3-4ceb-88a8-b6d6bb1c0983,posted,CTRLINK CARERS Ref: 998R6789201610974V,-1016.56,f45ae4da-9cf6-44ec-9d1d-7fc8678b448e,-3801.58,debit,payment,AU00000,2023-06-06T01:51:57Z
transaction,6e405f7e-d744-4d31-9e4d-1755d89ac2a2,posted,TRANSFER TO JOANNA SMITH CAMPING,-196.58,bb35e7e8-3383-4df4-9d53-48cf92ba1db9,-3998.16,debit,payment,AU00000,2023-06-22T01:47:38Z
transaction,db5d04e3-80ab-4b60-8339-2c5b3fb54c57,posted,Movie Ticket Purchase,-2995.17,14ae8571-2189-4056-a58b-a60e1d283890,-6993.33,debit,bank-fee,AU00000,2024-03-28T09:47:13Z
transaction,c9ebf23f-a862-4834-ad8f-fe19d4b7b42d,posted,AGL RETAIL ENERGY LTD (GAS),-305.61,b2303d3f-bf97-4183-9e34-42b0f670d17f,-7298.94,debit,cash-withdrawal,AU00000,2023-07-07T18:07:41Z
transaction,1f296aba-00ec-4828-af51-7dd757561c30,posted,Bookstore Purchase,-1027.0,bfcd1360-044e-4417-aa42-9c02ceaa6a4b,-8325.94,debit,bank-fee,AU00000,2023-10-12T08:02:36Z
transaction,48788a29-bae6-41dc-b4d7-9bba0a6252c9,posted,Online Gaming Purchase,-3727.18,54c38249-8ff3-43de-b575-fd7207b895a3,-12053.12,debit,bank-fee,AU00000,2024-02-25T13:36:00Z
transaction,541913a0-f214-4135-9e8a-ab2a1f97f1c0,posted,Movie Ticket Purchase,-825.79,57653cd3-4978-42ac-a14c-49bf3008d41e,16273.0,debit,cash-withdrawal,AU00000,2023-07-21T12:26:56Z
transaction,f97f57e9-1969-4642-8ab0-5a0caf703e1f,posted,Manly Maths Tutor Wages,-2001.27,6381d06b-53f9-4b5b-9378-4c9f3c84c3c7,14271.73,debit,bank-fee,AU00000,2023-11-08T05:59:04Z
transaction,65f24d9f-0b2e-4937-b859-5a7e0d743a5f,posted,Non Hooli ATM Withdrawal Fee,-1019.03,566048a7-e841-4b13-8f54-a1001b95958d,13252.7,debit,cash-withdrawal,AU00000,2024-02-27T17:08:49Z
transaction,2694db01-27be-4ef6-b8ad-1a258352a009,posted,AGL RETAIL ENERGY LTD (GAS),-1050.9,b2b57047-982d-411f-912a-bbb057e703e1,12201.8,debit,payment,AU00000,2024-04-29T07:44:59Z
transaction,e810c00d-d857-4ba0-a159-da06eb4e1876,posted,Manly Maths Tutor Wages,-1733.69,9665f2ef-a1e3-4ddd-9a87-fc2bac5ddf26,10468.11,debit,payment,AU00000,2024-02-22T09:02:50Z
transaction,5a36ec9f-724d-40d1-bf38-38471ec460f6,posted,AGL RETAIL ENERGY LTD (GAS),-2567.56,e18162f0-59f2-4114-b1a7-c74cf539fe97,7900.55,debit,bank-fee,AU00000,2024-02-25T10:58:53Z
transaction,3b5ac985-0834-4227-9246-3980696a6972,posted,Public Transport Fare,-2435.21,9792fe2f-a53a-4ef7-b5f2-15c492587efb,5465.34,debit,payment,AU00000,2024-04-01T15:45:36Z
transaction,cdbe0007-beb5-46dc-bb4a-37f47759142b,posted,Travel Agency Booking,-3659.4,1a12e672-31ce-4395-8b96-5bf7b53ee2d6,1805.94,debit,cash-withdrawal,AU00000,2023-08-09T06:48:54Z
transaction,0f2924c3-0165-4252-90db-4e6b27059e15,posted,Amazon Online Shopping,-2704.28,2ba0912d-1f06-401d-986a-46a039c7a78d,-898.34,debit,bank-fee,AU00000,2023-11-30T19:36:42Z
transaction,5e7c8772-879d-4c47-8721-e3e86d6376f3,posted,Coffee Shop Purchase,-183.14,10a3ef62-8e95-47e5-8cb3-0a38f4e609fc,-1081.48,debit,payment,AU00000,2024-01-11T00:07:44Z
transaction,0756fdd2-1d34-4a0b-849f-e2f6f23e2c4a,posted,Gym Membership Fee,-2117.22,1e1c4b7c-7e38-4126-bf65-14b961057e6d,3247.91,debit,cash-withdrawal,AU00000,2023-06-30T15:18:52Z
transaction,81ab57ed-e276-4fcb-b7ca-9e493ffd0e37,posted,Coffee Shop Purchase,-2133.94,a4b790a5-ac37-4900-acd7-006810b82fed,1113.97,debit,payment,AU00000,2023-08-06T05:27:28Z
transaction,7ad64218-a416-41b6-8d57-d2a39e552733,posted,Bookstore Purchase,-388.21,3c844871-1575-4981-bbc6-efad5853426c,725.76,debit,bank-fee,AU00000,2023-12-21T01:02:26Z
transaction,c7a48be6-d51b-4fbe-bb19-d8045c82ee63,posted,Public Transport Fare,-3769.02,025aa7f1-c1b7-4632-8917-03fe26c17343,-3043.26,debit,bank-fee,AU00000,2023-10-14T07:18:00Z
transaction,c09c9071-8295-458d-8ebb-139fa548bbc4,posted,Payroll WFRMS 15439393,11658.28,ef5b168c-1891-4fed-a1f0-5f060ea7f95c,8615.02,credit,transfer,AU00000,2024-04-19T09:31:00Z
transaction,3a93caed-2952-4f0f-a782-ea9c47fc567c,posted,TFR Acc14000 TO 12389,-3950.71,e7dcaf93-8f0c-4e06-a465-d354c2820975,4664.31,debit,cash-withdrawal,AU00000,2023-09-30T03:34:45Z
transaction,aeeeec3f-e6a9-4b38-b80f-35e7cd672e35,posted,Bookstore Purchase,-501.58,499ed7fc-0d72-4ee6-b140-d167d619223c,4162.73,debit,bank-fee,AU00000,2024-04-23T19:33:48Z
transaction,1153cf6d-9332-475b-b3f3-6e85bc75905d,posted,Electricity Bill Payment,-1632.99,5c9ebc8f-caf6-46b9-9384-3175069cc9ff,2529.74,debit,cash-withdrawal,AU00000,2023-11-11T02:14:30Z
transaction,5281f281-348e-45db-a32a-984c803754ab,posted,Restaurant Dinner,-559.62,6e9138b5-05d1-4576-84a4-feeef4351367,1970.12,debit,cash-withdrawal,AU00000,2023-07-12T05:53:19Z
transaction,1b9eadf6-36f0-4cc3-889f-5bac59cd5537,posted,Manly Maths Tutor Wages,-3255.21,d8f2d7a7-00cb-4b43-96b4-32c13b78f6d0,-1285.09,debit,bank-fee,AU00000,2023-07-20T04:53:36Z
transaction,73d0901c-72ab-4660-8362-cc3b3bbfaf2a,posted,Hair Salon Appointment,-2306.27,a0cf0d03-13c5-4b48-95f7-83f322bb014f,5446.16,debit,payment,AU00000,2023-10-23T07:06:31Z
transaction,5cca8d8d-de59-4f35-b97f-c39e26cd2462,posted,Movie Ticket Purchase,-4059.75,a94301fa-419b-4267-8926-1c85dd8a4f5d,1386.41,debit,payment,AU00000,2023-05-16T01:25:09Z
transaction,935aac33-993d-4133-84ea-b37c528d5859,posted,Bookstore Purchase,-3033.64,c39f1a2e-4dfb-46ad-b5eb-614d4ffc5531,-1647.23,debit,bank-fee,AU00000,2023-05-17T01:25:11Z
transaction,d8924dd8-6974-404f-b462-e0471a377488,posted,Movie Ticket Purchase,-3967.69,c3620580-8a36-4f8b-9df1-d319d2a74128,-5614.92,debit,payment,AU00000,2023-10-18T05:22:56Z
transaction,494a98b7-bce6-46f4-91d3-e843350ac298,posted,Clothing Store Purchase,-591.87,6ba2ab85-8e87-43cf-bb75-311a26e9aa36,-6206.79,debit,cash-withdrawal,AU00000,2023-08-14T05:00:41Z
transaction,a339bab6-b1e4-46cd-8970-cbeac88405b2,posted,Gym Membership Fee,-747.37,07ca3dc0-b5b8-4050-b0e2-7afc78a017dc,-6954.16,debit,cash-withdrawal,AU00000,2023-12-13T08:29:41Z
transaction,d7eb5291-87e7-405d-97b1-1bdbe5cb3aaf,posted,Non Hooli ATM Withdrawal Fee,-1849.29,5ed04586-30a0-428d-ad48-28376e846500,-8803.45,debit,cash-withdrawal,AU00000,2023-09-30T16:22:14Z
transaction,5a4bdd3c-45bb-4b08-be9d-1ab42f0e6d3c,posted,Non Hooli ATM Withdrawal Fee,-3738.65,80919893-2e0e-40f8-a1a9-bff0382d580b,-12542.1,debit,payment,AU00000,2023-06-19T20:55:00Z
transaction,e4387dce-ef82-4b8f-9d40-d4b29245b7e7,posted,Non Hooli ATM Withdrawal Fee,-1473.19,d4852279-bf3d-4ab8-a8e7-8c0c2e8cf830,-14015.29,debit,cash-withdrawal,AU00000,2024-01-21T20:38:05Z
transaction,90a67c23-78e4-473c-b12a-02cd6769a151,posted,Pharmacy Purchase,-400.6,1bb5961d-5287-45a0-8a2d-11c0dc37328d,-14415.89,debit,cash-withdrawal,AU00000,2024-03-20T13:26:39Z
transaction,b022df91-ce46-4f16-afb8-b21217bc5154,posted,TFR Acc14000 TO 12389,-3032.87,760af493-c667-48b3-af30-27e03c117bb5,12919.33,debit,payment,AU00000,2023-06-13T13:21:55Z
transaction,6f9dca34-7716-4202-8238-e2a9afa10c38,posted,TRANSFER TO JOANNA SMITH CAMPING,-1035.25,340b5b72-5dee-401a-b943-8ab10535ae16,11884.08,debit,bank-fee,AU00000,2023-07-27T07:22:43Z
transaction,ef16ebf4-2dcf-4728-80b0-25b9d146a11d,posted,Hair Salon Appointment,-3378.27,60233019-ed8a-444e-9ff2-1fb03395ae12,8505.81,debit,payment,AU00000,2023-08-01T09:48:47Z
transaction,7a2d99e8-34e8-47b9-9023-fce7e9245f53,posted,Uber Ride,-4142.91,10476473-27d4-4fc9-89d2-b4abc27c094e,4362.9,debit,bank-fee,AU00000,2024-02-06T17:18:12Z
transaction,4f7d3fad-3a7c-4cfc-8a1f-2374b2886fbf,posted,Amazon Online Shopping,-2481.3,e0d86add-75a6-4e41-a11e-b3686135053b,1881.6,debit,payment,AU00000,2023-12-31T01:04:45Z
transaction,685e6c9b-2a74-4bac-b77f-a316568002e0,posted,Non Hooli ATM Withdrawal Fee,-1448.77,afb9ed11-9fd5-4eb3-a159-ea35290a77be,432.83,debit,payment,AU00000,2023-10-12T13:42:53Z
transaction,40afbd28-8112-4342-964a-e3d533789dfd,posted,Non Hooli ATM Withdrawal Fee,-2760.7,0ab4228c-7d6a-45fc-8d09-311284d6be7f,-2327.87,debit,payment,AU00000,2023-10-07T03:44:29Z
transaction,33655e88-f8a8-4568-b7db-9413918ec2df,posted,AGL RETAIL ENERGY LTD (GAS),-1230.07,fb5fc892-ca61-4c55-b87b-203bdc3db2da,-3557.94,debit,payment,AU00000,2023-11-17T21:44:03Z
transaction,67a82f2c-5009-444e-aa02-37d06952e6c4,posted,Gasoline Purchase,-3440.85,f9e403e0-3358-4f99-810a-79c9eb5b5665,-6998.79,debit,payment,AU00000,2024-01-02T19:13:38Z
transaction,c31070a0-5784-460c-9de8-aa3b5bb70960,posted,Gym Membership Fee,-458.25,1651e5f5-ee4f-4f14-bcf9-6c57682ed26c,-7457.04,debit,bank-fee,AU00000,2023-06-05T04:36:31Z
transaction,adb5ac87-dd35-44a1-89e4-719fbf61c35a,posted,Restaurant Dinner,-883.32,012259b8-d556-4458-b62c-4a3642d24564,5433.98,debit,cash-withdrawal,AU00000,2023-05-19T02:07:41Z
transaction,4c5ac63f-dc79-40d4-8a91-79f2d246e625,posted,Wdl ATM WESTPAC IGA BALGOWLAH BALGOWL AU,-1135.98,ce603be3-a4ce-4e17-86f0-f7fdd30dbb9e,4298.0,debit,cash-withdrawal,AU00000,2023-09-15T19:32:35Z
transaction,10beec23-7b87-447c-88ec-6205e0ca44fc,posted,Coffee Shop Purchase,-565.23,47e1593f-1810-4938-bbdf-3bad682ebb1f,3732.77,debit,bank-fee,AU00000,2024-02-18T18:04:11Z
transaction,230f6a4c-a667-4883-961c-9863456d1e5d,posted,Movie Ticket Purchase,-852.72,3a9f7a11-d675-4993-b9f7-7729acad6599,2880.05,debit,payment,AU00000,2024-03-23T05:02:56Z
transaction,da12124c-2b20-4194-97d6-73b87b503798,posted,Travel Agency Booking,-2077.01,0a940e50-dfc6-47ca-bae3-620cea8ce6bb,803.04,debit,cash-withdrawal,AU00000,2023-09-07T23:27:39Z
transaction,3f728d63-2172-408c-ae5f-ceb16d12ee8f,posted,Manly Maths Tutor Wages,-1911.53,8d48ef5d-98ab-4c95-bd6e-a526daac48a0,-1108.49,debit,payment,AU00000,2023-10-26T01:16:39Z
transaction,72367e51-720b-4f45-8f5d-72b61f41e6fc,posted,Restaurant Dinner,-1891.15,ffc33ee9-329e-42fb-88d9-0fb0c77e03b1,-2999.64,debit,bank-fee,AU00000,2024-02-08T20:21:47Z
transaction,07e4e319-473c-4c7c-885e-229d417fc261,posted,AGL RETAIL ENERGY LTD (GAS),-4081.88,d896c2a5-4b9f-4c6d-b0c7-453ad35be6eb,-7081.52,debit,payment,AU00000,2023-12-16T00:52:19Z
transaction,2544d033-721f-427a-a297-8965aabaf980,posted,Non Hooli ATM Withdrawal Fee,-1936.36,5f181bd9-d090-47c5-ad90-32de5b781715,-9017.88,debit,payment,AU00000,2024-04-18T09:45:06Z
transaction,b95e96a5-aaff-4067-b986-9f927133251e,posted,Public Transport Fare,-1768.29,0a7f3aca-a236-44e2-937b-4bc90ee7e250,-10786.17,debit,bank-fee,AU00000,2023-08-02T14:54:53Z
transaction,4f1cf8b7-5146-448d-9aa5-a4ea4ddb0f2a,posted,Restaurant Dinner,-4867.79,1f5a7229-fe96-40d3-b623-fcab552b7b32,7632.76,debit,cash-withdrawal,AU00000,2024-02-22T21:09:03Z
transaction,545afca8-2833-434e-804a-720f7af9cfe4,posted,Car Maintenance Expense,-3981.18,370be06d-0e4a-4652-a85d-ff67002b047a,3651.58,debit,payment,AU00000,2023-11-04T04:30:43Z
transaction,d23c9336-5dc4-4862-9ee5-789f2a9da599,posted,CTRLINK CARERS Ref: 998R6789201610974V,-4534.62,12c22fb1-69ab-48a0-9eaf-9276621a07c4,-883.04,debit,cash-withdrawal,AU00000,2023-06-27T21:45:26Z
transaction,dbb3c472-7c3a-4e30-ae42-7ea6e00f7ae4,posted,Manly Maths Tutor Wages,-3832.76,13bc3e4f-222e-474c-ab38-d7a47322e133,-4715.8,debit,bank-fee,AU00000,2024-04-14T09:03:54Z
transaction,530601ee-79f0-4b64-94a3-d2c2f73e04eb,posted,Netflix Subscription,-1130.33,cb5d8127-a8ab-4899-93c8-37dc063cc972,-5846.13,debit,payment,AU00000,2024-03-19T06:55:59Z
transaction,58a66e40-c8f4-412e-b98a-a646331ded6c,posted,Clothing Store Purchase,-642.99,7e785d5a-36d3-45ca-8cb1-dc3530da04e9,-6489.12,debit,bank-fee,AU00000,2024-01-26T17:09:17Z
transaction,b66cd6fe-1cfc-4fd3-9321-679f6251053a,posted,Gasoline Purchase,-2165.53,c84eb0f7-265b-43c2-b3ef-a4e4b191ebf4,-8654.65,debit,cash-withdrawal,AU00000,2024-04-03T14:18:30Z
transaction,9b35bbac-b9fe-4186-92de-f019888fb700,posted,Travel Agency Booking,-2748.85,639e9fbb-f698-4b17-a7b0-071b32bc86b6,-11403.5,debit,cash-withdrawal,AU00000,2024-04-09T09:48:34Z
transaction,4cfd6395-1f2b-400e-b8f7-4378ad5a331c,posted,Bookstore Purchase,-214.73,78ff09c9-86e9-4ac0-95c2-aeaa39e82aa6,-11618.23,debit,bank-fee,AU00000,2024-05-07T05:17:56Z
transaction,dae848fa-3b2f-4b25-85ae-4630a6e3ec11,posted,Gasoline Purchase,-1241.75,f5d2e1c9-92d7-4339-ad33-8ebab1d9b1bc,-12859.98,debit,payment,AU00000,2023-05-18T12:22:43Z
transaction,d4077b96-7a99-43b2-b8bc-50cebbd28a95,posted,Manly Maths Tutor Wages,-3475.1,570f27b9-6108-4b9d-bcc0-d3707e465a0c,12000.89,debit,bank-fee,AU00000,2024-01-15T19:57:45Z
transaction,68423535-bb47-426d-bad5-c94b6d7420dc,posted,Clothing Store Purchase,-2413.57,d31f4dbf-cfe5-4b85-a38d-c8c941f2c7f5,9587.32,debit,bank-fee,AU00000,2023-05-13T01:58:56Z
transaction,9d5b5199-b9e1-47fe-b27d-cc022d0260c0,posted,Amazon Online Shopping,-3273.62,a3e307d4-668b-4093-ade8-3aec73108cf0,6313.7,debit,bank-fee,AU00000,2024-02-14T08:24:10Z
transaction,e6ac669b-7fc1-403e-b982-0108b123f53e,posted,TFR Acc14000 TO 12389,-4892.33,b537eeb7-69a3-4f0c-908d-dc003169669b,1421.37,debit,bank-fee,AU00000,2023-09-09T23:35:42Z
transaction,f5fc739f-8b26-4e72-a351-f1ac20bf520b,posted,Car Maintenance Expense,-1135.58,91b95367-6acf-4d73-855a-2a2804a75def,285.79,debit,bank-fee,AU00000,2023-08-14T02:19:47Z
transaction,629cec08-a2f3-4c32-8592-39d05a32188d,posted,Mobile Phone Bill Payment,-2062.05,1c464393-8e68-4d93-a265-1baa59c9acc5,-1776.26,debit,payment,AU00000,2023-07-22T03:25:52Z
transaction,a0cc5bb5-a458-4798-a2e6-6eb2d5cee14f,posted,Uber Ride,-4862.18,ed42fab1-8c32-44d4-947d-158196a9cfdd,-6638.44,debit,cash-withdrawal,AU00000,2024-01-23T13:19:20Z
transaction,53fccf88-c82a-42ff-9db2-36af5a15516c,posted,Netflix Subscription,-4178.83,6b7d7341-9723-454b-a7e6-f0d41897444f,-10817.27,debit,bank-fee,AU00000,2024-04-14T15:27:01Z
transaction,c26c81bc-c379-41ee-ab0f-b81b8433ff9d,posted,Travel Agency Booking,-3923.34,e3f55bef-40f6-4be5-bbe8-0513b5e10047,-14740.61,debit,bank-fee,AU00000,2024-03-24T19:53:57Z
transaction,a23aacb3-c24a-42f1-9a36-fcfeb1ee5ef0,posted,Coffee Shop Purchase,-3814.32,e2bc1011-9851-42bf-86c0-db5530142b89,-18554.93,debit,payment,AU00000,2024-03-27T01:43:45Z
transaction,089dfcee-7f15-488c-b237-f4146e6aa4d0,posted,Uber Ride,-3729.28,04106ef9-b7e4-46c8-9473-5c0bc4982383,12257.44,debit,cash-withdrawal,AU00000,2023-10-07T03:11:59Z
transaction,d0cb6197-c1f1-4e48-8bd1-00db3f6e02df,posted,Transfer Platnm Homeloan 346454,-1549.33,76c72942-0acf-410d-bf0a-4ac382868ec7,10708.11,debit,bank-fee,AU00000,2023-06-11T05:01:21Z
transaction,3ac4d595-ed7c-49f3-b7ba-d131877410e0,posted,Gasoline Purchase,-833.48,67f1c8d7-850b-495c-91d1-4f9428a86711,9874.63,debit,bank-fee,AU00000,2023-08-12T18:15:02Z
transaction,01851b99-cc10-40ae-93be-22e7bf97e7d9,posted,Amazon Online Shopping,-4477.03,433811e7-0151-4b75-bc10-f056c83ea18b,5397.6,debit,cash-withdrawal,AU00000,2023-06-02T02:57:44Z
transaction,83a2cbb7-bfe1-442c-8479-eb7a9f97bc71,posted,Movie Ticket Purchase,-1155.42,d1d300b6-ddcd-485a-96fe-9436565de1c0,4242.18,debit,cash-withdrawal,AU00000,2023-05-26T02:54:48Z
transaction,1aa48765-d2ee-42e6-bf80-7505b98cf5ee,posted,TRANSFER TO JOANNA SMITH CAMPING,-1679.36,f85f9a0f-055c-40ea-b91c-c75412eb7042,2562.82,debit,payment,AU00000,2023-10-17T10:35:25Z
transaction,84d2e3e3-edc3-4cbd-aba1-9380db03b1c9,posted,AGL RETAIL ENERGY LTD (GAS),-3395.14,155d3c32-2cbc-44de-b53b-42d6a54efe3d,-832.32,debit,bank-fee,AU00000,2023-10-14T15:52:27Z
transaction,64f993cc-92be-466b-b408-c9c5a172dcd1,posted,CTRLINK CARERS Ref: 998R6789201610974V,-2287.0,ebb1c39a-721e-474f-a518-262e0721b521,-3119.32,debit,bank-fee,AU00000,2023-10-14T11:18:06Z
transaction,725c3b81-79db-4d2f-9d22-2c10166dc996,posted,Coffee Shop Purchase,-3377.29,6b0ff4f3-e97c-4499-97f0-f197507914a3,-6496.61,debit,payment,AU00000,2023-05-28T08:37:28Z
transaction,bc7ed276-ad2e-4c99-a22a-82ac15996121,posted,Clothing Store Purchase,-3703.93,e32811e9-3af4-4ae2-bde7-4d5d17b4bd23,-10200.54,debit,payment,AU00000,2023-09-02T19:06:27Z
transaction,e4ab38cf-9d11-4e5e-95c2-2632bb923b8d,posted,Online Gaming Purchase,-4474.85,eb0b5cd7-b1fb-4325-b541-752864c12228,9295.49,debit,payment,AU00000,2023-09-12T11:49:13Z
transaction,9334b9ac-e8f8-459f-8e53-9c2dd6df58f1,posted,Amazon Online Shopping,-3103.93,9255a7fa-e433-407f-9184-65a431b7d7e6,6191.56,debit,bank-fee,AU00000,2023-11-29T21:08:03Z
transaction,711a5f9a-fc70-4545-8486-304a8e45c2b6,posted,Home Improvement Store Purchase,-1421.34,3d01919a-9f41-4f53-8938-e205c6a6640f,4770.22,debit,cash-withdrawal,AU00000,2023-10-04T02:51:30Z
transaction,7d9955ff-0be8-43ee-b15e-506c547c0af8,posted,Amazon Online Shopping,-516.09,d3db4287-05ed-4e50-bc11-7b4466e1f819,4254.13,debit,cash-withdrawal,AU00000,2023-07-27T21:23:09Z
transaction,be24ab48-87d8-4246-92ee-e761f1523597,posted,Coffee Shop Purchase,-1817.69,d089fd60-dace-4d80-8a6a-dba4cf6049e1,2436.44,debit,payment,AU00000,2024-01-06T05:04:20Z
transaction,6158e352-a6f7-44e9-87e0-3f01533b074a,posted,Coffee Shop Purchase,-4203.84,0cb8b71f-2b26-4028-a1ed-b70c31e35e08,-1767.4,debit,bank-fee,AU00000,2023-06-08T11:14:16Z
transaction,d81159d7-b422-4772-87bf-548691f99a7d,posted,Gasoline Purchase,-1389.34,ed201fdb-e89f-4fc7-ba8b-6be6fb627b9e,-3156.74,debit,bank-fee,AU00000,2023-06-03T07:56:00Z
transaction,d558f8cb-2660-4a07-8357-3511308b9a36,posted,Non Hooli ATM Withdrawal Fee,-1260.48,4cb28c6e-3e9d-4015-8de6-16725bab8be4,-4417.22,debit,cash-withdrawal,AU00000,2023-07-11T12:00:12Z
transaction,a0a887ed-4d27-496e-a453-704398ec5dc9,posted,Clothing Store Purchase,-1056.28,c1cb55ba-d5eb-49c0-9753-5fd630765176,-5473.5,debit,cash-withdrawal,AU00000,2023-06-21T03:26:18Z
transaction,6f895ef9-dec7-45ca-afdf-79498e9cd25d,posted,Home Improvement Store Purchase,-4344.44,dd156360-8117-4c7c-aede-8723af0e3a91,-9817.94,debit,payment,AU00000,2024-02-08T11:24:06Z
transaction,0be711db-c508-43d5-8335-3ff8271fa2fd,posted,Gasoline Purchase,-4716.65,b7d365be-126a-44e7-9947-de85ecda6b18,9378.16,debit,bank-fee,AU00000,2024-02-16T20:04:44Z
transaction,2804c8a8-4723-44b6-8e05-874f455497d1,posted,Clothing Store Purchase,-1095.63,a804787d-7f7e-4be1-8791-d579a5225224,8282.53,debit,payment,AU00000,2023-10-20T21:33:35Z
transaction,b62f18aa-8474-4967-8eed-5c9456711055,posted,Public Transport Fare,-315.49,c2851a4b-08a2-4762-9710-ac025ed158ef,7967.04,debit,payment,AU00000,2024-01-22T20:48:38Z
transaction,848149c6-3e78-4ab4-b2a6-dec76ae4649b,posted,Online Gaming Purchase,-3385.38,45e4d37b-5250-4735-ac35-bb8750be149b,4581.66,debit,cash-withdrawal,AU00000,2023-10-03T14:01:20Z
transaction,eeb907ca-2c01-4ba9-b5f1-9c047c7cdb3d,posted,Uber Ride,-1724.62,156db287-1496-47da-93ef-56349f011d89,2857.04,debit,cash-withdrawal,AU00000,2024-02-15T10:29:59Z
transaction,f5f80009-764f-4d79-aa9d-240ca253e781,posted,CTRLINK CARERS Ref: 998R6789201610974V,-2118.62,57fcb9f1-9e82-4727-969d-46d21ddb0536,738.42,debit,payment,AU00000,2024-05-06T18:46:13Z
transaction,c7a70566-1a0c-438c-ac62-e9b801467a45,posted,Pharmacy Purchase,-4772.78,c32fb7fa-bc3e-4b72-9dae-ad1c0475e864,-4034.36,debit,cash-withdrawal,AU00000,2024-03-19T21:38:38Z
transaction,cef64a21-99ae-4d84-be5b-0bfa3058468b,posted,Payroll WFRMS 15439393,10492.63,d74a42e2-7ad3-433b-a971-10916ebac02a,6458.27,credit,transfer,AU00000,2024-04-10T20:39:41Z
transaction,4c1ebaa5-4939-476c-a819-c265f0d3462f,posted,Music Streaming Subscription,-4860.52,d501ddee-0989-413a-8c26-489fa250147f,1597.75,debit,bank-fee,AU00000,2024-01-03T12:32:37Z
transaction,a3240168-43cc-49dc-8e4f-6d9f361c7b4c,posted,Public Transport Fare,-435.65,8ea2f227-5cb5-4616-a61f-efa2043535fb,1162.1,debit,cash-withdrawal,AU00000,2023-10-22T20:51:35Z
transaction,bcd66bb8-de9e-4f11-9fd5-4799d7e1ed93,posted,AGL RETAIL ENERGY LTD (GAS),-4180.99,1f7ab727-5722-453d-96e3-4bca6b209199,1850.38,debit,bank-fee,AU00000,2023-12-05T13:15:23Z
transaction,97e483e8-c16d-459d-9b63-bc169a4b18ff,posted,Gasoline Purchase,-4188.97,5d004041-d584-427d-a0e4-16b73de2defd,-2338.59,debit,cash-withdrawal,AU00000,2023-08-10T03:29:51Z
transaction,3f4d2600-298d-4b2d-adfe-c2ae3468248c,posted,Payroll WFRMS 15439393,10666.57,2ee8ce11-42e4-40d6-a3ba-f22c474d197d,8327.98,credit,transfer,AU00000,2023-10-21T10:07:16Z
transaction,d33ed4ab-f3a0-4fc6-be4c-42654257112f,posted,Clothing Store Purchase,-4216.57,88c0922c-c295-4012-9ac5-f8fd2d0ce26c,4111.41,debit,bank-fee,AU00000,2023-10-25T08:55:36Z
transaction,d84be549-a3d1-42c2-84b7-ab7c40914c43,posted,Amazon Online Shopping,-4142.85,6fc184ba-37de-45ca-bc4b-7cc25adb748a,-31.44,debit,bank-fee,AU00000,2024-01-13T05:05:47Z
transaction,a4a87784-10b6-4b0e-bd63-f2b9dda98b85,posted,Restaurant Dinner,-199.53,74d8b97e-b673-48c9-addb-1d8bf4b3465a,-230.97,debit,cash-withdrawal,AU00000,2024-02-28T10:22:10Z
transaction,130ddfe1-ab02-4a30-86a4-90b8fbbc2cb7,posted,Netflix Subscription,-3309.01,ab14b9ad-1b32-4437-b82a-bbae421503c0,-3539.98,debit,bank-fee,AU00000,2024-02-11T21:46:46Z
transaction,8037daec-5c33-4833-ada9-61127eb9bbe3,posted,Public Transport Fare,-1396.94,81e1a2de-8d81-479b-abcd-db8f4dbe0492,-4936.92,debit,cash-withdrawal,AU00000,2024-04-10T16:07:23Z
transaction,97eabdc2-a5cb-4bce-9a19-7c68b7b9cc50,posted,Bookstore Purchase,-4081.34,554bd2b0-aada-4f88-ae8b-4f64fe0c46c4,-9018.26,debit,cash-withdrawal,AU00000,2023-08-10T15:43:47Z
transaction,5d59dd41-804e-4572-8ca0-4fd385be0ba0,posted,Netflix Subscription,-3169.23,cc7ffc49-a24e-439f-919e-677d8a911e24,-12187.49,debit,payment,AU00000,2023-11-11T14:42:57Z
transaction,886917c7-b58b-48ea-b095-b3c774fe1f35,posted,CTRLINK CARERS Ref: 998R6789201610974V,-3264.87,536d0107-6129-49b9-b1d3-b2ffa284e1e9,11709.06,debit,cash-withdrawal,AU00000,2024-01-06T17:22:01Z
transaction,097ba70a-8773-4f1e-bebd-0939f8efe293,posted,Clothing Store Purchase,-3493.37,4fc26683-9cd4-4798-9454-545306f7df38,8215.69,debit,cash-withdrawal,AU00000,2024-04-25T18:57:48Z
transaction,f5e8a6ca-bf95-48d3-b0f9-d7b3d6465f22,posted,Online Gaming Purchase,-117.85,212d869b-6e2c-4929-84dc-2e59dcf8102c,8097.84,debit,bank-fee,AU00000,2023-10-06T06:26:11Z
transaction,01757f4e-c098-4e28-a9f3-7885b761b85c,posted,Mobile Phone Bill Payment,-2247.45,1272c4df-63ba-474d-8ffc-0cc4bab88e09,5850.39,debit,cash-withdrawal,AU00000,2023-12-28T16:21:42Z
transaction,663ad5a4-b453-4913-993a-09594bbdc530,posted,Gasoline Purchase,-4325.32,2ade1255-2d22-48e8-8ce5-a45202adb44e,1525.07,debit,bank-fee,AU00000,2023-08-21T01:29:15Z
transaction,37a463cb-c30d-4d3d-91b0-5abc776e6ef6,posted,Hair Salon Appointment,-2548.95,31861eee-03a5-4749-bee9-fae73e3e3a69,-1023.88,debit,cash-withdrawal,AU00000,2023-11-26T13:15:57Z
transaction,52045fe4-0323-44dd-a934-d25f00359636,posted,Electricity Bill Payment,-3700.58,1e855277-bea2-4d8f-bd8b-77cd3631398c,-4724.46,debit,bank-fee,AU00000,2023-12-04T16:37:42Z
transaction,a9205f30-1d81-4e4f-adef-c2b43740d689,posted,Movie Ticket Purchase,-1950.16,aa970ff7-c69f-4547-ab86-89cf7ce9e098,-6674.62,debit,bank-fee,AU00000,2024-03-15T14:09:06Z
transaction,b614abfb-f3e5-4380-a368-c56de5b52b58,posted,TFR Acc14000 TO 12389,-1749.93,f90bbbb5-c41f-4c32-8b85-666e9147017e,-8424.55,debit,payment,AU00000,2023-08-11T22:13:37Z
transaction,039d2cab-0501-460f-b0b5-3da5f710dc5d,posted,AGL RETAIL ENERGY LTD (GAS),-1799.02,2b2f71c4-5e9c-4707-80fc-30794cba84e5,-10223.57,debit,payment,AU00000,2024-02-02T12:56:24Z
transaction,5b087d00-eb73-4854-8ca5-4ebb263d5a97,posted,Coffee Shop Purchase,-3023.77,e9ca4013-e89e-4986-ba6e-42ef25bea29f,9002.14,debit,payment,AU00000,2024-01-25T09:18:54Z
transaction,2eba6b06-8603-4c50-b8ee-4bf01df6f3af,posted,Travel Agency Booking,-2182.18,5d7ca0da-4648-407f-9729-f391a2e482db,6819.96,debit,payment,AU00000,2024-03-29T13:28:33Z
transaction,18d7308b-52cd-4beb-8df4-9ac995918167,posted,TRANSFER TO JOANNA SMITH CAMPING,-4472.28,0886b26d-689e-403b-ae0a-05efd3192f35,2347.68,debit,payment,AU00000,2023-10-28T11:30:08Z
transaction,055c6ef5-cdc5-4075-bea1-3fd8c60864e0,posted,CTRLINK CARERS Ref: 998R6789201610974V,-4155.21,6cc676bb-fd83-4198-a5d1-09dbf1ddcd97,-1807.53,debit,payment,AU00000,2023-09-10T15:15:17Z
transaction,57db6663-b7d1-4cb2-88e5-ad05e0584ec3,posted,CTRLINK CARERS Ref: 998R6789201610974V,-3613.14,5365b395-f16a-4d78-bf25-d279d6e15a15,-5420.67,debit,payment,AU00000,2024-01-06T10:02:22Z
transaction,58575c67-3921-4d69-89e1-8d23430b7b00,posted,AGL RETAIL ENERGY LTD (GAS),-4828.4,586c2963-3c94-40d7-a9b5-f924251056d0,-10249.07,debit,bank-fee,AU00000,2023-11-17T18:54:34Z
transaction,cd4f6eae-c142-4d2d-8e06-e4d9dd328241,posted,Bookstore Purchase,-1701.24,9426d6d2-2bb7-49db-93de-4f421cb44f36,-11950.31,debit,bank-fee,AU00000,2023-10-17T17:13:05Z
transaction,a5baf8c2-4168-4528-9f41-179270a91dd2,posted,Manly Maths Tutor Wages,-3491.83,7c628ad1-d198-4de3-aa45-483851168f6d,-15442.14,debit,bank-fee,AU00000,2023-06-30T00:06:30Z
transaction,17fcc709-3c4c-4397-8d49-59400e8c4403,posted,Home Improvement Store Purchase,-2051.25,ab808a8b-540a-410a-92a5-b726279ab627,-17493.39,debit,cash-withdrawal,AU00000,2024-03-18T19:34:38Z
transaction,f4413fec-4105-4789-aa8d-9f295ee4c381,posted,AGL RETAIL ENERGY LTD (GAS),-2473.33,6c7e5074-4fce-4155-8c4f-c7630778c2c1,-19966.72,debit,bank-fee,AU00000,2023-12-03T18:38:30Z
transaction,da97e1c3-7aa7-45d9-8008-0be19f971c36,posted,TRANSFER TO JOANNA SMITH CAMPING,-2272.7,52abc762-31bc-481f-88d9-73f5f462fd21,10741.92,debit,bank-fee,AU00000,2024-04-29T05:07:53Z
transaction,e20195df-1add-4f34-ace2-514be7595a57,posted,Restaurant Dinner,-1225.79,5fb254f9-ef2c-42fe-a834-ddde57be466c,9516.13,debit,cash-withdrawal,AU00000,2023-12-20T03:11:37Z
transaction,ba30ef86-809c-41e6-8c7e-17ce8795f64f,posted,Gym Membership Fee,-4425.02,00f7f46c-30c9-44c5-a811-86c35e0624b6,5091.11,debit,payment,AU00000,2023-08-06T20:49:52Z
transaction,e8fd1bb5-6720-4ba9-89f1-da6c9777e51c,posted,Hair Salon Appointment,-1826.0,cdf07c6c-a6df-4cde-9b08-1e6ead50efa2,3265.11,debit,bank-fee,AU00000,2024-02-08T19:11:23Z
transaction,1b8377d1-c139-4b01-a684-82e61c564cbd,posted,TFR Acc14000 TO 12389,-4672.69,79a98435-4915-4123-875d-d5faab5ce2cb,-1407.58,debit,cash-withdrawal,AU00000,2024-01-15T11:31:25Z
transaction,fc0428e8-1d99-4282-989c-ea9443c02397,posted,Netflix Subscription,-2668.26,20c721d3-aa89-402a-999e-bbf181f1fd05,-4075.84,debit,cash-withdrawal,AU00000,2023-10-13T00:02:28Z
transaction,e3d3fbaa-6e63-4fcc-b52c-488c65ff8e34,posted,Wdl ATM WESTPAC IGA BALGOWLAH BALGOWL AU,-2355.86,08b4f330-48d3-443b-b2a3-4249af0d7ab0,-6431.7,debit,bank-fee,AU00000,2023-07-01T11:56:36Z
transaction,08e59d73-0430-449c-a5d3-d2ddfe57838c,posted,Non Hooli ATM Withdrawal Fee,-967.92,03a4b7b0-bf65-4aa5-ab83-ebd89ea78344,-7399.62,debit,bank-fee,AU00000,2023-08-19T07:57:03Z
transaction,d6ce45ec-3ad0-465e-b757-0987d86545a4,posted,Pharmacy Purchase,-2606.38,ed5f701e-ac34-40f4-991c-5e4b87c70516,-10006.0,debit,cash-withdrawal,AU00000,2024-02-13T06:51:20Z
transaction,ce691bb2-519d-45a9-bb5b-30266debbd6c,posted,TFR Acc14000 TO 12389,-3453.34,37533bd6-cc3b-44e7-a097-d79eaddcdb7b,-13459.34,debit,payment,AU00000,2023-09-06T22:12:14Z
transaction,dff9e320-546f-4e6a-83cb-6e01092080c3,posted,Hair Salon Appointment,-375.59,83507629-24c8-435b-b3f4-d35f5904f24d,10447.89,debit,bank-fee,AU00000,2023-12-23T12:08:41Z
transaction,3a7d9925-5380-44d3-b8d6-314024d87efc,posted,Gym Membership Fee,-1655.21,e0800435-31dd-4c79-82b7-96f85ee75ffe,8792.68,debit,cash-withdrawal,AU00000,2023-11-09T13:19:53Z
transaction,ef94da41-a8f1-47e7-b12d-eaf83460894c,posted,Coffee Shop Purchase,-3138.03,4897c632-f78c-4054-be58-3d4da2ee483b,5654.65,debit,cash-withdrawal,AU00000,2023-09-10T13:28:36Z
transaction,0fcc9b9b-2a6f-478d-9ffc-68ebb7e07715,posted,Mobile Phone Bill Payment,-3497.21,0f76dffc-ab4c-4417-9d5a-a71e6a333d63,2157.44,debit,payment,AU00000,2024-02-04T14:49:41Z
transaction,4ccf0fa1-6aaf-4542-b22e-21a1a10c58e1,posted,Manly Maths Tutor Wages,-2870.92,761a2a0e-8572-48ef-939f-1d2dbd57d791,-713.48,debit,cash-withdrawal,AU00000,2023-05-28T19:18:12Z
transaction,4994377b-f557-4f04-adf1-77b9f862b470,posted,Manly Maths Tutor Wages,-733.2,87ef9441-f729-4bf6-8178-c3a137ff5e9a,-1446.68,debit,bank-fee,AU00000,2023-08-10T02:34:25Z
transaction,98c4db7e-83c1-4379-9e4b-7381996f3e6b,posted,Hair Salon Appointment,-4211.46,a30c6cae-0cc5-49c6-8f34-0e0b14388dfc,-5658.14,debit,cash-withdrawal,AU00000,2024-04-02T04:58:52Z
transaction,a8271094-a4d0-4a31-a462-6bf010b85392,posted,Music Streaming Subscription,-2133.48,8b06a036-d118-4478-923d-365a55f27dbe,-7791.62,debit,payment,AU00000,2023-10-16T07:28:17Z
transaction,992bc512-8b3e-4a6a-a39c-d6d913d16de1,posted,Pharmacy Purchase,-4245.98,a7da3157-f33d-4352-badc-58b175772f06,-12037.6,debit,bank-fee,AU00000,2023-11-24T12:23:54Z
transaction,08815771-a94e-4097-a479-7e8bc61ca9e7,posted,Coffee Shop Purchase,-3830.39,b319752e-a999-4ece-ab79-3c66385e516c,-15867.99,debit,payment,AU00000,2023-08-15T08:56:03Z
transaction,d2282b57-8da2-4a5f-a45f-e79d8cd32d67,posted,Music Streaming Subscription,-2913.72,4d656771-f02e-4880-b5f0-bdc5a8695467,16978.87,debit,payment,AU00000,2023-12-28T20:18:26Z
transaction,0467f06a-5db0-4107-b16d-2080f00798b7,posted,Music Streaming Subscription,-2819.93,f5a711fa-c207-4060-97ca-dbeeca757410,14158.94,debit,bank-fee,AU00000,2024-01-30T10:15:50Z
transaction,e2a14fb8-c401-4a31-8bf1-4d50e16b2bb3,posted,Amazon Online Shopping,-1552.35,c133febe-35a3-41e0-bcf8-6ddae4fb5a3f,12606.59,debit,bank-fee,AU00000,2023-11-13T23:55:01Z
transaction,6771344a-ca8b-4899-ba87-39e330cdaba1,posted,Car Maintenance Expense,-2050.27,73a7785e-ac5d-45b8-8d79-5a883eaa0f6b,10556.32,debit,cash-withdrawal,AU00000,2024-04-24T22:31:49Z
transaction,dd7b2c6b-6a3d-4993-8d5b-753710d1b2ca,posted,Gasoline Purchase,-4480.42,ecb2b9a2-381c-4f36-bda3-9185275ad5af,6075.9,debit,payment,AU00000,2023-09-24T17:49:01Z
transaction,dc0873c7-323c-4983-93dd-a618eb6790e7,posted,Netflix Subscription,-834.72,97fdb968-5d55-4791-93ad-3c7b1ed0d8ce,5241.18,debit,payment,AU00000,2023-10-16T18:27:31Z
transaction,1238bc42-3575-4ace-ad46-946d76c265b8,posted,CTRLINK CARERS Ref: 998R6789201610974V,-4319.9,31674093-7a92-4ebf-a07f-189f780a8b88,921.28,debit,payment,AU00000,2023-12-30T00:50:42Z
transaction,8f2403af-194b-4785-9760-f71041cfa191,posted,Music Streaming Subscription,-1296.84,c22e2756-d983-4b60-9b1f-0b5c9d3f14b7,-375.56,debit,bank-fee,AU00000,2024-04-25T14:35:08Z
transaction,2c772465-cc55-4793-b199-76247091dc80,posted,TRANSFER TO JOANNA SMITH CAMPING,-2005.19,46e9a51d-e998-4b19-b111-d856f0b02135,-2380.75,debit,cash-withdrawal,AU00000,2024-05-06T03:14:32Z
transaction,99b9f320-a7e0-4c99-bc98-30b5a8faa659,posted,Clothing Store Purchase,-781.87,04f20e49-5fe2-4962-8517-43fd38633296,-3162.62,debit,cash-withdrawal,AU00000,2024-01-17T20:42:01Z
transaction,16de8140-efb5-42ad-a2cc-5ddaaeee197f,posted,Restaurant Dinner,-684.75,905440dc-84ba-4d2b-a9f4-87e8b194f94b,10309.62,debit,bank-fee,AU00000,2023-12-10T07:51:19Z
transaction,1c2e8972-8f5d-4de7-a0dc-ba473d6edcf4,posted,Hair Salon Appointment,-4933.64,b2ed5758-20b5-43dd-9b64-8af4c9d1356d,5375.98,debit,bank-fee,AU00000,2023-12-11T09:36:53Z
transaction,06a8ec7e-fab7-479a-853f-460dbb1106bf,posted,Public Transport Fare,-3395.93,071aa3d0-f921-4b14-bdb5-1e09100af48d,1980.05,debit,payment,AU00000,2023-07-30T07:33:48Z
transaction,0e4aa606-88ea-4e27-ae74-94bf4326b0d0,posted,Amazon Online Shopping,-1220.89,3e3708f3-d3b5-46bf-acde-8833bd29b00c,759.16,debit,payment,AU00000,2023-08-05T20:52:19Z
transaction,9fc305ca-1c45-4458-8ceb-2b243f5d5d0b,posted,Amazon Online Shopping,-3454.31,b2c42484-78b5-457c-ac5d-819582ffeeee,-2695.15,debit,payment,AU00000,2023-09-07T04:09:35Z
transaction,0f312057-0e06-4184-9473-1a5c61a6e48f,posted,Clothing Store Purchase,-4782.91,b03eea26-7cbe-4cc0-bb02-645c052613da,-7478.06,debit,cash-withdrawal,AU00000,2024-01-05T23:41:27Z
transaction,51ab98fa-588e-4477-83c2-e7aa9d0ae6ef,posted,Music Streaming Subscription,-3380.76,dda2c919-15ef-41cb-9f6d-3c437c4a5027,-10858.82,debit,bank-fee,AU00000,2023-11-10T10:36:41Z
transaction,da2c9571-8860-455c-9b5c-a4c42ed63157,posted,Gasoline Purchase,-3221.77,d4153415-9238-45b2-a3b3-64ab8cc50912,-14080.59,debit,bank-fee,AU00000,2024-03-19T15:10:12Z
transaction,8f17b51b-cf39-4e3c-90c2-82a300efb096,posted,Online Gaming Purchase,-4396.7,9f5b21ca-6943-4bb7-b3aa-b4ef2983a0c9,-18477.29,debit,cash-withdrawal,AU00000,2023-07-11T03:18:14Z
transaction,d9105bfd-18f3-4a01-8dda-beb6e9becb3e,posted,Mobile Phone Bill Payment,-1343.08,2f363404-c9ab-4e1e-b308-83232fc125cc,-19820.37,debit,bank-fee,AU00000,2024-01-07T02:40:49Z
transaction,186265c5-f4bd-4199-9528-adb4b1cef43a,posted,Hair Salon Appointment,-458.99,d5785e31-39b4-4b12-be06-ad5c1f01a76d,15074.28,debit,bank-fee,AU00000,2023-09-16T03:51:00Z
transaction,1885a673-c4cb-4e79-bb0c-d38bfc59f1d1,posted,Amazon Online Shopping,-4712.17,86ce5f34-2788-46e9-b834-0d955c9ff5bd,10362.11,debit,cash-withdrawal,AU00000,2024-02-02T21:58:11Z
transaction,779dcdf5-227e-4d8f-9129-5180dd08b884,posted,Bookstore Purchase,-4438.8,8a050fcb-773b-4681-96f9-42778e573aa6,5923.31,debit,cash-withdrawal,AU00000,2023-08-27T00:08:54Z
transaction,407dfb60-e2e7-4e87-a4f0-d439de2c4c4c,posted,Home Improvement Store Purchase,-2026.11,e7357b38-3cf7-4305-9fce-cb3f3bc6a9cf,3897.2,debit,bank-fee,AU00000,2024-01-10T17:59:01Z
transaction,bf1cd5fc-357a-4b05-8a9e-fc294b83fdde,posted,Car Maintenance Expense,-1360.99,86c04cb6-649d-4393-92ad-1aa843b14966,2536.21,debit,payment,AU00000,2024-02-28T14:06:39Z
transaction,b8f0a4da-5816-4616-a5e8-1054e5c7bac8,posted,Travel Agency Booking,-853.29,a0315f7f-8dc5-4c34-b70d-8a85f3277829,1682.92,debit,cash-withdrawal,AU00000,2023-12-09T22:32:17Z
transaction,405aacf6-b3aa-4650-96a3-9df8a248ae06,posted,Public Transport Fare,-1369.16,dbf01c38-f585-4c85-bb80-d95665fcebe6,313.76,debit,payment,AU00000,2023-06-01T11:28:43Z
transaction,d314e9d1-b46e-4eeb-bb2d-d624492dffb3,posted,Clothing Store Purchase,-4060.51,fb2c92dd-6837-4076-aa4e-e47f3b5e98e0,-3746.75,debit,bank-fee,AU00000,2023-09-14T22:52:29Z
transaction,3b4bf0b3-54e2-4a6e-94bd-c1fa3ec8d656,posted,Public Transport Fare,-4264.8,ad7e5d5d-516c-4c22-bf66-131f1878db69,-8011.55,debit,cash-withdrawal,AU00000,2023-09-28T04:18:05Z
transaction,6da8841b-65c8-4392-a201-ed25e76478cb,posted,Gym Membership Fee,-732.55,47da45a5-0840-4fc5-902f-50fd6243fb6a,-8744.1,debit,payment,AU00000,2024-02-17T08:42:30Z
transaction,fd7e0de4-c765-4f06-aacb-f46ab4190fbf,posted,Bookstore Purchase,-3933.27,55c702a1-5ca7-4eb5-8853-b438b788f450,12691.07,debit,payment,AU00000,2023-11-01T09:45:58Z
transaction,c8bfc351-00c9-46fd-8aa5-a292854d04fa,posted,Movie Ticket Purchase,-3791.85,c9a530e4-e7f9-4eca-856d-01c7faa6e856,8899.22,debit,bank-fee,AU00000,2023-10-28T10:28:14Z
transaction,19f46890-d899-4b05-8da6-ac7194a4a224,posted,Pharmacy Purchase,-1573.85,d8f48a1f-c709-44da-886b-dd5a55a3af8f,7325.37,debit,payment,AU00000,2023-10-19T18:11:39Z
transaction,7158abc8-a21e-4295-ae75-55532ce20900,posted,Coffee Shop Purchase,-4634.93,939b01bf-213c-43cf-94bf-c71564cde209,2690.44,debit,payment,AU00000,2023-06-21T19:08:07Z
transaction,a03a5747-e0b0-4dce-a584-5ba6ed4a8b07,posted,Coffee Shop Purchase,-3759.37,9f10c6f5-08b2-4f90-80c9-ed6e9e600015,-1068.93,debit,cash-withdrawal,AU00000,2023-07-20T19:21:26Z
transaction,1c39b438-15a3-4f1b-9f73-4ea2af44097f,posted,Movie Ticket Purchase,-4806.43,db7c893d-a83f-473c-99f1-f7e54c23b062,-5875.36,debit,cash-withdrawal,AU00000,2023-10-19T22:08:18Z
transaction,d4b13bea-8fdf-431f-902a-671c159a8a03,posted,CTRLINK CARERS Ref: 998R6789201610974V,-3718.81,de623bbd-da5b-4af5-b72d-3f1a3ca9eb09,-9594.17,debit,payment,AU00000,2023-06-08T03:38:06Z
transaction,c3d0be31-b011-45bf-95f0-8f1074d8d9e7,posted,Hair Salon Appointment,-3671.68,679bcc6a-8820-4964-be76-60ef29682e4a,-13265.85,debit,bank-fee,AU00000,2023-05-18T11:15:04Z
transaction,e59964fd-a48a-4d54-acc6-7249effd7174,posted,Music Streaming Subscription,-2631.68,54ca3780-5933-41de-b922-0ff4f4ef4741,-15897.53,debit,bank-fee,AU00000,2023-09-08T17:11:25Z
transaction,05d74895-f3ff-4616-815e-624855d66694,posted,Bookstore Purchase,-3387.83,203d8120-ac49-4bcd-8a26-8657bc214fdc,-19285.36,debit,payment,AU00000,2023-10-12T15:21:06Z
transaction,e28d7193-62d6-4fba-816e-4ff1d9674126,posted,CTRLINK CARERS Ref: 998R6789201610974V,-1636.0,2c63ad67-1742-4ccb-95ed-f172546c3d78,6506.37,debit,cash-withdrawal,AU00000,2023-11-23T20:20:37Z
transaction,26635450-635d-4293-8de0-e1d88be8a63f,posted,Non Hooli ATM Withdrawal Fee,-4599.67,80ca1bda-40d9-4987-a0f5-78eb99406e5e,1906.7,debit,cash-withdrawal,AU00000,2024-03-30T15:49:42Z
transaction,63cc1b71-c350-4389-9791-5c65cbaf7cbe,posted,Online Gaming Purchase,-4.69,257fe68c-672d-4b3d-b483-701d3062a9c0,1902.01,debit,bank-fee,AU00000,2023-12-01T13:02:40Z
transaction,bdeb2e25-8cc6-4d21-86bb-12ab584623e3,posted,Restaurant Dinner,-3765.99,c7b2ffc6-690e-467d-887b-32ebed6697ec,-1863.98,debit,cash-withdrawal,AU00000,2023-11-01T17:12:56Z
transaction,d792448f-e29b-42b7-9623-aa1685ff2f1b,posted,Manly Maths Tutor Wages,-4625.35,036ab2fc-6df1-4d12-99d3-3695d57cab67,-6489.33,debit,bank-fee,AU00000,2023-09-04T20:19:16Z
transaction,beee2303-cb7a-46b2-b972-8bc36abeaa40,posted,Amazon Online Shopping,-4935.6,9ee5cad7-15dc-4d4f-ab18-6d083c3a1f91,-11424.93,debit,bank-fee,AU00000,2024-02-20T04:51:57Z
transaction,baa68f8b-a7cc-4d67-8ee0-3e209a9d150c,posted,AGL RETAIL ENERGY LTD (GAS),-4613.23,8b845476-89cc-49c6-96e5-5c70b98fa79c,-16038.16,debit,cash-withdrawal,AU00000,2023-06-28T07:12:26Z
transaction,3523b083-0f9b-4731-9bbf-aab2c6f37f1b,posted,Amazon Online Shopping,-3005.7,5f2ec3b0-a6ab-439d-8a3b-2e1f801baf48,-19043.86,debit,bank-fee,AU00000,2023-09-14T09:49:28Z
transaction,e59daabf-8989-4238-9daf-13b194790ce5,posted,Mobile Phone Bill Payment,-895.56,1a0c0343-966e-47bb-8b00-d8c8538a522d,-19939.42,debit,payment,AU00000,2024-05-05T22:39:55Z
transaction,4d27cdc0-4c1d-4904-af76-7b0a3204d22b,posted,Pharmacy Purchase,-2784.59,d004c7f3-6825-4171-86a1-019f4bd7155d,-22724.01,debit,bank-fee,AU00000,2023-07-19T05:29:18Z
transaction,d5b19e37-1662-492d-aa0c-d24be12c083b,posted,Uber Ride,-1734.82,8081a3a2-ecf5-401a-97e0-db18b8529a00,5411.6,debit,payment,AU00000,2023-10-03T19:21:59Z
transaction,55e40e7f-d072-4b0d-951a-c2acdab6d71e,posted,Pharmacy Purchase,-4606.07,c21a7d0e-c717-4f7f-a350-a7fd3a171206,805.53,debit,payment,AU00000,2023-10-08T05:50:07Z
transaction,8b2e1969-3e2c-4798-bb47-ccbfff00fc20,posted,Manly Maths Tutor Wages,-4043.89,2cc39332-991b-4e0a-b626-f4d01a0c6ba2,-3238.36,debit,payment,AU00000,2023-08-05T07:00:11Z
transaction,cdecf9f4-b08d-45f4-b8ba-f06058e4567d,posted,CTRLINK CARERS Ref: 998R6789201610974V,-1488.36,9bc025a0-bfb2-4e4c-a6b2-0b5a43eb0a79,-4726.72,debit,bank-fee,AU00000,2023-12-09T09:09:57Z
transaction,6b8e5d53-f1a2-4403-a1a7-630c27e9ff3b,posted,Bookstore Purchase,-4019.08,6c5bd6b9-5970-48a1-8c1f-d6eae144d1ff,-8745.8,debit,payment,AU00000,2024-05-10T15:15:29Z
transaction,e770f325-318d-4d5a-8478-2ee12e92a57d,posted,Coffee Shop Purchase,-1890.64,1e22b2fa-de57-4873-8711-803346a939a7,-10636.44,debit,bank-fee,AU00000,2023-09-08T09:22:04Z
transaction,b7dcc7f9-1ed8-451b-8644-9db7f506e989,posted,Gym Membership Fee,-3408.28,c875d101-5104-4393-90f9-1902bc415959,-14044.72,debit,payment,AU00000,2024-04-18T12:41:04Z
transaction,ca85f460-5a67-4e48-aa64-79a9968de0c5,posted,Non Hooli ATM Withdrawal Fee,-3419.11,f3017ec1-41c9-49cb-aa71-deb1c2b5bede,-17463.83,debit,payment,AU00000,2024-04-28T10:56:24Z
transaction,a85e5170-d4f7-456a-a07e-d9f9e97430c0,posted,Gasoline Purchase,-4632.15,3b905185-af51-4bad-a14d-b7760e9ac0e1,-22095.98,debit,cash-withdrawal,AU00000,2023-10-10T22:59:38Z
transaction,1d35e2cb-972e-4676-acbc-bb49e86f58b7,posted,Travel Agency Booking,-2728.41,bc6c4aee-4b96-4ca1-b483-6e6b08ef5f99,-24824.39,debit,payment,AU00000,2023-10-05T16:52:01Z
transaction,83558dc3-084a-42d4-8ee3-7e0d2fe98633,posted,Restaurant Dinner,-4012.62,965f14da-4d8c-4d12-a085-0d73d980e998,3889.41,debit,payment,AU00000,2023-05-16T17:04:24Z
transaction,585d733d-9f9f-489c-b81d-8a629eecfa56,posted,Pharmacy Purchase,-4725.38,f6de6996-f98d-418d-b3a1-54821db5eb8f,-835.97,debit,bank-fee,AU00000,2024-04-06T17:27:57Z
transaction,7821310b-8741-4467-b280-2e08ee6fbbf1,posted,Manly Maths Tutor Wages,-1779.93,f639ced1-a5d0-48b6-98d1-b45817e2e448,-2615.9,debit,cash-withdrawal,AU00000,2023-06-30T14:55:17Z
transaction,17e1551c-cf87-4dd2-b5fa-34a079eb488b,posted,Non Hooli ATM Withdrawal Fee,-3295.85,3776de67-3c48-4e4e-a37e-c9d123bfdb71,-5911.75,debit,bank-fee,AU00000,2023-06-06T13:44:09Z
transaction,b6274481-0afb-4fb4-8ca6-d3eef55de3c9,posted,Public Transport Fare,-4909.72,d5f92fa0-fe04-4e95-8ab4-af133a46f916,-10821.47,debit,cash-withdrawal,AU00000,2024-04-20T01:38:44Z
transaction,991c9e65-3c5c-41b0-a3d8-192f7ccb8c34,posted,Hair Salon Appointment,-3452.12,689da92e-7dc0-4f95-898b-e894866fa6c4,-14273.59,debit,bank-fee,AU00000,2023-06-24T16:44:47Z
transaction,5678b288-43d0-4669-ac79-38125a5b37c9,posted,TFR Acc14000 TO 12389,-3914.63,23986fff-05d4-4a7a-bf45-37d26c8d8011,-18188.22,debit,cash-withdrawal,AU00000,2023-10-28T17:06:47Z
transaction,5dfb5cde-2315-46af-8102-8495cf83cd4b,posted,Manly Maths Tutor Wages,-1584.23,50fdcd19-cf1f-4812-8c30-e8c1b185b302,-19772.45,debit,cash-withdrawal,AU00000,2024-03-17T19:34:21Z
transaction,291902a0-3993-4d4a-8407-522e4595527f,posted,Wdl ATM WESTPAC IGA BALGOWLAH BALGOWL AU,-1682.42,45ba7bf6-b781-4d69-8161-a717bd204296,-21454.87,debit,payment,AU00000,2023-07-24T07:34:11Z
transaction,a2169ea5-df10-4b94-a6d7-7057d7292482,posted,Car Maintenance Expense,-4842.66,1dab1d24-5e14-4c01-af88-fc82f5b62c62,-26297.53,debit,payment,AU00000,2023-05-19T18:09:22Z
transaction,3716e38c-53bd-4c16-a7c9-cc5c3f8f7973,posted,Electricity Bill Payment,-14.66,9a4186b9-6329-4a8e-950f-ff24d9ef8d7d,13977.81,debit,payment,AU00000,2024-03-20T04:54:39Z
transaction,19e77786-a9c6-4803-89d9-850bc81d5930,posted,Transfer Platnm Homeloan 346454,-662.52,e7878a94-012a-48ef-ad74-decab6bb5353,13315.29,debit,payment,AU00000,2024-02-10T03:01:21Z
transaction,5de38029-d085-4c3e-8987-90eab0632774,posted,CTRLINK CARERS Ref: 998R6789201610974V,-1362.78,b76894d9-1f57-46a2-a41a-053202cd011c,11952.51,debit,payment,AU00000,2023-12-29T22:27:30Z
transaction,e2ba607f-adad-4115-a6b0-51461c544ea5,posted,Restaurant Dinner,-3009.64,645e3bb2-9470-4633-907f-9c7fb960d8d5,8942.87,debit,cash-withdrawal,AU00000,2023-11-29T06:57:16Z
transaction,e82751cf-eb53-4f40-bc7e-7a04792934e4,posted,Coffee Shop Purchase,-4503.8,50aaa701-5e2b-4fde-97d2-22909c9122b4,4439.07,debit,cash-withdrawal,AU00000,2024-03-03T19:28:25Z
transaction,d2b6a5b1-e1b1-4eaf-b09e-9d8a35623f73,posted,Movie Ticket Purchase,-1881.65,df47dd41-4388-47d5-a1a0-bdd58e4cad47,2557.42,debit,bank-fee,AU00000,2023-10-18T16:25:58Z
transaction,78f3af0e-184f-454a-b608-60c7e4444283,posted,CTRLINK CARERS Ref: 998R6789201610974V,-2547.54,a40370a6-7ab0-4671-b645-241400ab94f1,9.88,debit,cash-withdrawal,AU00000,2023-08-30T02:46:25Z
transaction,8deaac91-f515-49b6-87a6-2c3e8f74178c,posted,Coffee Shop Purchase,-4110.68,0ca41439-30b3-4ae4-afca-44b9ad979ce7,-4100.8,debit,bank-fee,AU00000,2023-10-17T10:27:32Z
transaction,5fa8d76d-6ae2-40e0-8969-14935d9c190a,posted,Amazon Online Shopping,-1833.45,f26fccad-64a2-4949-bfe2-a28eaee9812e,-5934.25,debit,payment,AU00000,2023-12-01T07:37:45Z
transaction,fb0cb03c-0eab-4f80-8239-489bf752a8f6,posted,Gasoline Purchase,-1325.31,4db546c1-6a60-46e5-83a2-7e850305d052,-7259.56,debit,bank-fee,AU00000,2024-02-13T06:55:22Z
transaction,5dbfb26d-3771-4e9b-82f0-a33643a8104f,posted,Online Gaming Purchase,-2034.47,4c9eb0b0-3db1-4b25-a4bf-c94d2fd97304,5897.94,debit,cash-withdrawal,AU00000,2023-12-19T10:34:39Z
transaction,75b68dec-1d9d-4f8f-821b-8b39dbe30d3d,posted,Gym Membership Fee,-2242.11,a1734935-5b02-4b1d-a89f-81e1c24424d7,3655.83,debit,bank-fee,AU00000,2024-03-20T06:55:14Z
transaction,51f1fe94-1cf7-4453-93db-2101e8752113,posted,Gym Membership Fee,-133.05,3a2f199d-3b90-41e0-972a-262cc5d3d721,3522.78,debit,cash-withdrawal,AU00000,2023-12-17T17:05:06Z
transaction,d292c970-ae6c-4d11-a25d-fefb58814461,posted,Music Streaming Subscription,-1457.81,8a20122c-8cae-4465-909f-5170b9ebe60b,2064.97,debit,cash-withdrawal,AU00000,2024-03-08T18:38:51Z
transaction,79bba066-33d1-43e7-a4aa-3c2811e552e5,posted,Hair Salon Appointment,-3279.97,abb8ff24-90f6-41fa-8d5a-fd3f8abdc2a1,-1215.0,debit,payment,AU00000,2023-08-23T05:59:41Z
transaction,21e4157c-29c5-4e1b-a465-a11e5b1a82e5,posted,TFR Acc14000 TO 12389,-2174.86,a9b3db4e-87b5-49e8-9ba7-a9ba8149a51d,-3389.86,debit,cash-withdrawal,AU00000,2024-04-11T13:33:31Z
transaction,81c3d5f9-258f-417e-9c2b-d9bb30a3571d,posted,TFR Acc14000 TO 12389,-1240.92,ada37c60-f4c0-4977-a651-fdd0d105c8b6,-4630.78,debit,bank-fee,AU00000,2024-04-05T02:49:50Z
transaction,2be4e89c-d20e-4424-9eb9-62e91e87a90a,posted,Bookstore Purchase,-4411.18,6ef99609-5dd3-43f5-b3e3-0be248af26ae,-9041.96,debit,payment,AU00000,2023-05-15T01:50:10Z
transaction,24f162de-9f40-4e74-87f8-aba15a52f8b4,posted,Public Transport Fare,-2698.77,dd2a457c-274e-44f5-b170-689aa6b3e748,-11740.73,debit,cash-withdrawal,AU00000,2024-03-17T17:04:46Z
transaction,ba6fa09d-5c0f-4830-8323-6c4e79132c28,posted,Public Transport Fare,-2400.03,f4b84cac-ad9c-4894-9864-952f9b79b18e,-14140.76,debit,bank-fee,AU00000,2024-02-25T21:18:09Z
transaction,6bd5234f-3181-4e92-92e6-4778e4fa8926,posted,Bookstore Purchase,-3358.21,7c1609d8-1225-4096-92d1-1f44c0fd45ae,8696.45,debit,payment,AU00000,2023-06-03T23:49:34Z
transaction,95ce0be5-4017-4749-8e0f-776c0d1c0db2,posted,Hair Salon Appointment,-3311.62,7d949bf6-1526-4ed8-a1d3-2a180996dbe6,5384.83,debit,cash-withdrawal,AU00000,2024-05-03T10:12:33Z
transaction,98e52524-69c9-44a1-9cc5-52f259ed4656,posted,Bookstore Purchase,-852.47,140013c9-2ed1-4d7b-ad63-18d7d1c8823f,4532.36,debit,cash-withdrawal,AU00000,2023-06-20T18:41:44Z
transaction,c1bc0b5c-5fc5-4a49-96f3-f66029744873,posted,Uber Ride,-4412.49,9bcd6e58-f21b-4e9b-a0a4-be0d010869af,119.87,debit,payment,AU00000,2023-05-14T03:45:15Z
transaction,04b1bae6-5494-4571-8f2f-ee1a349d0f8f,posted,Pharmacy Purchase,-835.48,7fd36d59-4329-4248-9461-c1155bbbe904,-715.61,debit,bank-fee,AU00000,2023-07-08T03:12:36Z
transaction,eeab0972-6e17-40da-b354-77ca99b10c39,posted,Wdl ATM WESTPAC IGA BALGOWLAH BALGOWL AU,-2489.42,4a6f4fe4-0dca-4e80-ba11-1fe3bfb04b4b,-3205.03,debit,bank-fee,AU00000,2024-01-14T20:37:22Z
transaction,9e491805-2819-4abc-9f30-2bcd5ed66a8b,posted,Public Transport Fare,-2718.46,934e70a3-c976-4a05-a37d-523b5063a0f1,-5923.49,debit,cash-withdrawal,AU00000,2024-04-03T20:09:51Z
transaction,90210579-8a1b-47ea-b4e4-1d75b1fb45fa,posted,Uber Ride,-1478.1,70de6a30-07f7-4866-a085-4c8dc3d16261,-7401.59,debit,cash-withdrawal,AU00000,2023-05-13T00:33:05Z
transaction,ed28d5f5-d170-448a-a27b-612d08cd5706,posted,Public Transport Fare,-3162.43,70e67f47-77d5-4824-96eb-91a71715df39,-10564.02,debit,bank-fee,AU00000,2023-08-01T02:07:49Z
transaction,e82a694d-0d92-4a00-baed-714a5b1491e8,posted,Home Improvement Store Purchase,-2937.19,f630dbdb-5c97-4bcc-a4ec-96b30d358883,-13501.21,debit,bank-fee,AU00000,2023-11-24T15:03:11Z
transaction,45627465-cbb0-4c50-ba31-05b069f930a1,posted,Clothing Store Purchase,-2263.63,f5c8027b-e04f-4d94-afb6-0bc0bb2312db,3798.23,debit,bank-fee,AU00000,2023-06-24T17:23:43Z
transaction,c05cb4c0-3e9e-47e7-ba6c-caaa99948d3e,posted,Mobile Phone Bill Payment,-553.73,14d87be5-95d8-4a8a-afd7-6c00778a5c27,3244.5,debit,payment,AU00000,2023-07-08T04:23:02Z
transaction,6fb90c56-f8c4-42cc-9b90-3ddda5f530f3,posted,Travel Agency Booking,-327.26,a62a54c0-96b6-409c-9c79-1550d2b5f534,2917.24,debit,payment,AU00000,2023-08-19T22:37:50Z
transaction,0865e055-10d3-477a-83b8-9c5ea60ac5cc,posted,Electricity Bill Payment,-3811.45,25096ac1-55f0-41d6-a069-b049fb612523,-894.21,debit,payment,AU00000,2023-08-21T13:05:33Z
transaction,21e4105b-1211-4bbf-827d-6dc672a75ded,posted,Home Improvement Store Purchase,-4234.3,5629e071-e02f-4fc5-9a1f-14b82995b798,-5128.51,debit,payment,AU00000,2023-11-03T12:14:07Z
transaction,fdc96ff6-7861-4ed9-868e-ed78177d5aa8,posted,Music Streaming Subscription,-2081.17,1bbe366e-7c56-47e6-8519-742c1e5922af,-7209.68,debit,cash-withdrawal,AU00000,2023-10-05T11:03:12Z
transaction,c58cfe26-1314-4cd2-ad21-5e52113f67a2,posted,Travel Agency Booking,-669.25,ee24ff3d-fa78-4dbd-9380-36e3e6547f4a,-7878.93,debit,payment,AU00000,2024-03-02T06:40:52Z
transaction,ba47df48-4733-437e-8d38-92947e0ee858,posted,Wdl ATM WESTPAC IGA BALGOWLAH BALGOWL AU,-1025.68,138f0b96-3de1-42c1-9e6f-015c24c1bb24,-8904.61,debit,payment,AU00000,2023-10-17T22:07:52Z
transaction,fce5535c-01a9-46a6-b788-797f8b857418,posted,Online Gaming Purchase,-4481.32,9065dbdc-a325-4a5b-a64c-c42845315c3d,-13385.93,debit,payment,AU00000,2024-01-23T23:17:22Z
transaction,8dd32685-42e8-4081-9618-37cf36a67e2f,posted,Movie Ticket Purchase,-2547.29,f35bb809-d871-49b0-85fd-f56f1e237958,-15933.22,debit,bank-fee,AU00000,2024-04-17T16:49:13Z
transaction,9cf3541b-5101-4082-ab48-f3e0113ec6d1,posted,Online Gaming Purchase,-670.91,03e2d604-7512-415a-9c1c-3b64c8e4560b,4997.36,debit,cash-withdrawal,AU00000,2023-11-09T06:51:30Z
transaction,84481b9f-a207-4e46-9e2c-9bd6e6ddefb2,posted,Pharmacy Purchase,-3756.4,81192898-8526-47c6-b81c-61f6c7490595,1240.96,debit,bank-fee,AU00000,2024-02-15T12:26:37Z
transaction,5e8369b7-6170-469f-b7c6-e3643338d1c4,posted,Gym Membership Fee,-2780.23,d44d515d-7312-45ab-98e8-3cda315d2b6d,-1539.27,debit,cash-withdrawal,AU00000,2023-11-17T13:33:09Z
transaction,a6d880de-5816-4124-bba8-e56066db4d39,posted,Public Transport Fare,-1964.77,09249040-23e6-4283-9269-9cae0087aa9b,-3504.04,debit,cash-withdrawal,AU00000,2023-10-14T04:54:04Z
transaction,33ad8f2f-09af-4a1e-b429-f6b0619f8b52,posted,CTRLINK CARERS Ref: 998R6789201610974V,-749.35,ae64c6ad-5695-4643-b7ca-372a4ad11026,-4253.39,debit,cash-withdrawal,AU00000,2024-03-27T06:43:27Z
transaction,70d5cbbd-c10a-43d5-9995-357508ffe577,posted,TRANSFER TO JOANNA SMITH CAMPING,-4676.56,016fe966-f4fb-4ed6-8156-b8f3d7ede8b2,-8929.95,debit,bank-fee,AU00000,2023-08-29T15:51:34Z
transaction,a31dd1e2-b6e9-4ffc-9652-4dcbd720c069,posted,Non Hooli ATM Withdrawal Fee,-2104.21,a7c161f6-9185-4d38-b165-0d06418918dd,-11034.16,debit,payment,AU00000,2024-03-20T19:48:42Z
transaction,3526c47e-211b-40ef-b6f5-28a7213ed843,posted,Mobile Phone Bill Payment,-1841.69,0d6c8267-bc3b-4ee4-ac5d-fe108be89cf7,-12875.85,debit,bank-fee,AU00000,2023-07-15T17:51:27Z
transaction,72049fd7-4be6-4d26-b031-ab9a01533ece,posted,Uber Ride,-932.79,0254c12a-4d2d-49d4-91bb-872ab4015fa3,-13808.64,debit,payment,AU00000,2023-10-18T21:33:45Z
transaction,c7ca50cb-7764-426e-b467-4402c2397e0a,posted,Uber Ride,-4763.22,3fded7c8-ada1-4eab-9b20-e3954bcb70f1,-18571.86,debit,bank-fee,AU00000,2023-08-08T23:53:24Z
transaction,f8ccd4ed-5c0b-45a3-9eb7-0c8bdfc908aa,posted,Payroll WFRMS 15439393,10695.34,ed4b0bba-be5a-4fe9-b9ab-e71e55cccc33,18236.07,credit,transfer,AU00000,2024-04-19T22:53:03Z
transaction,b17e4f70-8971-4370-bd2f-a6f0afdcafd1,posted,Restaurant Dinner,-3751.65,540728b9-a93f-4fd4-9ff2-6008686f53d3,14484.42,debit,payment,AU00000,2023-06-03T07:19:47Z
transaction,565c7dfd-26ab-44cc-a29e-a7c03a536859,posted,Coffee Shop Purchase,-4599.37,39067aec-8997-4480-b6ca-f420a2549507,9885.05,debit,cash-withdrawal,AU00000,2023-07-17T09:37:25Z
transaction,03434dbd-b1fd-421e-8e4c-aa76753ac49b,posted,Clothing Store Purchase,-4007.67,a654df19-7e3a-4e49-bab0-953aab034d96,5877.38,debit,payment,AU00000,2023-12-21T11:27:06Z
transaction,717b250d-56ce-461c-82af-5f89380a02b3,posted,Payroll WFRMS 15439393,11731.01,bfa0ef82-f247-4b14-aec4-a7a83483f445,17608.39,credit,transfer,AU00000,2023-05-29T16:40:55Z
transaction,2bff52c1-a7cc-4744-b3fa-7215a110efda,posted,Travel Agency Booking,-591.3,0489e33b-1161-4710-9cac-37c5c757d383,17017.09,debit,bank-fee,AU00000,2024-02-12T00:09:33Z
transaction,76dce49b-6d11-4468-8da0-7cb834ce3f05,posted,Online Gaming Purchase,-1920.92,a993b9ea-4082-418f-bac0-d64d40371daf,15096.17,debit,bank-fee,AU00000,2024-03-22T11:25:47Z
transaction,60861b1c-fef4-4eb5-a28f-7b752ea5945e,posted,Clothing Store Purchase,-582.16,2edb33f0-1dea-44c8-8a57-cf39f05a7848,14514.01,debit,bank-fee,AU00000,2023-10-30T23:08:20Z
transaction,289548be-eb10-4bec-975f-05e4bf9824a3,posted,Mobile Phone Bill Payment,-3212.54,adb18d4e-f80e-4a45-83ed-87f53340b836,11301.47,debit,payment,AU00000,2023-10-17T00:07:26Z
transaction,c50e3b08-b0de-4f2d-9bb8-7f100b3ba76e,posted,Music Streaming Subscription,-1615.98,ac60fd42-8cae-48cb-b3e1-cb63a0afb61c,9685.49,debit,payment,AU00000,2024-04-19T15:43:48Z
transaction,45370138-f73f-4dc1-9fa3-9969d26cf105,posted,Non Hooli ATM Withdrawal Fee,-4084.94,fed86fdb-cbdb-4c09-9f8c-8751077b7666,5198.3,debit,cash-withdrawal,AU00000,2024-04-26T13:57:57Z
transaction,979fde7c-de62-444f-9eaf-8c306403a3ac,posted,Gym Membership Fee,-1069.11,c9cd175a-f398-431f-b515-df1206d4230e,4129.19,debit,payment,AU00000,2023-10-24T21:33:37Z
transaction,2fbd08a7-e8ff-493e-bad1-67fe126c2b3f,posted,TRANSFER TO JOANNA SMITH CAMPING,-1283.72,ac6e18d4-f483-4fa3-9f50-dee33b3a0bb3,2845.47,debit,payment,AU00000,2024-04-12T23:09:20Z
transaction,4295cf90-0a90-4e99-a8cb-711ec82764b0,posted,Public Transport Fare,-2365.97,8932454a-e97b-4c18-98f7-ee4efb1ed827,479.5,debit,cash-withdrawal,AU00000,2023-09-21T14:37:31Z
transaction,c5fb14bc-7dec-4e16-bbe7-0f4e4d7d3a1e,posted,Clothing Store Purchase,-435.7,e04055f9-ba85-46b6-bbfc-73789879f04b,43.8,debit,payment,AU00000,2023-10-04T08:52:50Z
transaction,80eadeeb-ada9-4811-b409-37aee21f510e,posted,Car Maintenance Expense,-4466.99,247475b4-43a9-4e0b-b81d-789ccff8f32c,-4423.19,debit,cash-withdrawal,AU00000,2024-05-05T18:07:38Z
transaction,f404cd8b-f5ec-4ffa-afb1-3362f92d7332,posted,Non Hooli ATM Withdrawal Fee,-462.07,b9b4e7fa-0ed7-4b38-95f6-cb556fc4c80d,-4885.26,debit,cash-withdrawal,AU00000,2023-11-27T08:31:16Z
transaction,f5d9fed9-b492-40ad-8510-dfb3a5c29ae5,posted,Restaurant Dinner,-1944.84,27d1a977-98da-4cf8-ae2f-884a010a3181,-6830.1,debit,cash-withdrawal,AU00000,2024-01-27T13:06:00Z
transaction,0ff1701e-1b7e-45de-88af-4581046e2b22,posted,Amazon Online Shopping,-63.37,484b3715-5bd8-4b5c-974b-59666ba051b2,-6893.47,debit,cash-withdrawal,AU00000,2023-05-18T05:31:49Z
transaction,d91cbe5a-01f7-4b6b-8787-4407b9c92aac,posted,Gym Membership Fee,-3709.33,83903136-9971-476c-9729-94627a1922c3,-10602.8,debit,payment,AU00000,2023-09-01T20:53:56Z
transaction,7f829b12-f336-4aa0-85c6-661f186f09e6,posted,Pharmacy Purchase,-2482.76,02e016a9-29a6-4f9d-a536-2404e35ce24c,13832.01,debit,cash-withdrawal,AU00000,2023-07-22T11:21:35Z
transaction,d7f8a952-ad6f-4916-bad7-28682b79d330,posted,Public Transport Fare,-879.87,63607778-a80c-4a22-89bd-b105f12d4a46,12952.14,debit,cash-withdrawal,AU00000,2023-06-03T04:50:20Z
transaction,75f6fd71-4137-47ba-aff9-487c2888853e,posted,Clothing Store Purchase,-236.92,8c0f98c1-9f56-45b1-a850-84a2f0845b04,12715.22,debit,cash-withdrawal,AU00000,2024-01-05T09:32:32Z
transaction,ce26c64b-b092-4544-9574-fff0c30d6f3b,posted,Restaurant Dinner,-195.92,a1ab72a9-8345-4702-a984-0542f52e0e97,12519.3,debit,payment,AU00000,2023-06-14T18:22:30Z
transaction,98e25b6e-b348-4317-a13f-512417a652da,posted,Bookstore Purchase,-4132.13,76c526ff-4ac4-4687-851d-bec809d33cb3,8387.17,debit,cash-withdrawal,AU00000,2023-06-17T15:52:17Z
transaction,3adccc78-90f1-448d-8851-345468375897,posted,Mobile Phone Bill Payment,-1550.46,81f17c12-43bf-4c03-9d6d-3ba1bb9c5e06,6836.71,debit,bank-fee,AU00000,2023-12-29T18:14:54Z
transaction,9120b793-5fd8-4126-bd6c-3254a3b41554,posted,Transfer Platnm Homeloan 346454,-1107.96,e1313a31-ed65-468f-b9f0-0cd980d33771,5728.75,debit,bank-fee,AU00000,2023-05-27T11:08:50Z
transaction,44726a2b-fffd-43f9-81f3-fbca0dc5b91c,posted,Netflix Subscription,-3351.49,72f27ba5-f908-4419-8da4-2206e0ee92ba,2377.26,debit,cash-withdrawal,AU00000,2023-05-12T14:22:29Z
transaction,019ae591-ea42-4c15-815d-9efd651a413d,posted,Manly Maths Tutor Wages,-1448.94,b2c3c01b-3565-4941-aed8-432082872513,928.32,debit,bank-fee,AU00000,2023-11-05T17:17:45Z
transaction,a3d24bc7-1b9e-417c-af61-23c61723dfb0,posted,Gasoline Purchase,-2189.27,ff6270e7-6263-4b80-919e-71cd9fb37ae7,-1260.95,debit,payment,AU00000,2024-04-28T20:42:27Z
transaction,a30065b4-6572-41f3-bb75-6da4b2751d88,posted,CTRLINK CARERS Ref: 998R6789201610974V,-158.36,67c01013-f294-452f-980b-edb200e9dbc5,12375.55,debit,payment,AU00000,2024-04-07T10:13:50Z
transaction,43d8a884-c3ce-490d-94e7-a1e6b09e8103,posted,Car Maintenance Expense,-1872.47,4e5c9813-814b-45a8-a27c-b84a7406be39,10503.08,debit,payment,AU00000,2023-10-21T22:15:33Z
transaction,4b4b6a89-97d1-46cd-b400-5278b1a0ed26,posted,Gasoline Purchase,-2956.82,c1fcfda5-29cb-4683-ab8f-d823a1c3a5ac,7546.26,debit,cash-withdrawal,AU00000,2023-07-16T22:59:35Z
transaction,04848c9f-aa42-4965-a688-a54f3a109038,posted,Public Transport Fare,-597.23,525dfd26-49dd-45de-aa70-bd9594fb2416,6949.03,debit,payment,AU00000,2023-09-27T13:51:53Z
transaction,4a3ae78d-e1c4-4395-acf5-2b2218679d1a,posted,TRANSFER TO JOANNA SMITH CAMPING,-4992.48,5674a8ba-caf9-41b8-a575-4148fd54a89d,1956.55,debit,bank-fee,AU00000,2024-04-18T15:19:27Z
transaction,cae3f911-afb6-4ebf-8d7e-ca51bfe933ae,posted,Gasoline Purchase,-804.3,5007cb1e-ec3d-44b6-9d8f-a2ce4f3893fd,1152.25,debit,bank-fee,AU00000,2023-06-18T08:38:45Z
transaction,db7912f1-f43e-403d-9828-a86530c6abb7,posted,Electricity Bill Payment,-2489.35,40664cfe-f9bc-4a11-a7c7-fbe1065c9244,-1337.1,debit,cash-withdrawal,AU00000,2023-10-15T02:02:43Z
transaction,0cd2d8e4-3412-42a8-b140-da9e64ad74e3,posted,Electricity Bill Payment,-703.75,34b58e0d-cd76-4bf7-9afc-f626070afc53,-2040.85,debit,cash-withdrawal,AU00000,2024-02-26T16:05:30Z
transaction,2f7fb51b-2d77-4b2c-a393-4e80dc688705,posted,Home Improvement Store Purchase,-2158.2,0f0de104-82bb-4917-a920-ae5e8feebee8,-4199.05,debit,payment,AU00000,2024-01-02T08:00:27Z
transaction,7029cf7a-9554-477c-b107-3041fc9f4ae0,posted,Car Maintenance Expense,-4388.38,9e133b01-50f9-4316-8680-db0570dae037,-8587.43,debit,payment,AU00000,2024-04-29T21:49:19Z
transaction,9277b69a-6221-4d55-8f23-5c5e1b634004,posted,Car Maintenance Expense,-4905.05,96aa7cdd-30c3-4173-b659-c9cdeed571bd,11522.79,debit,bank-fee,AU00000,2023-09-03T15:32:28Z
transaction,ce090e9f-53b9-4286-9e95-49f8bde3b44f,posted,Bookstore Purchase,-4118.97,71c0a69e-3847-4a2a-a948-7f0323157b5d,7403.82,debit,payment,AU00000,2023-12-27T05:48:24Z
transaction,b6eac9dd-9fb6-423c-bc1a-959b950d9db2,posted,Hair Salon Appointment,-405.72,a2e56af3-0507-45be-8409-c3054c554221,6998.1,debit,bank-fee,AU00000,2024-02-20T01:53:47Z
transaction,9d7d3957-5791-421c-a5d5-11a445cba26a,posted,TFR Acc14000 TO 12389,-3632.87,ce22113a-f186-462b-9d39-4ee2b0bbfa1d,3365.23,debit,payment,AU00000,2023-07-07T19:17:25Z
transaction,2eb89818-ceab-44fd-9ccc-8f3da68a9a94,posted,Home Improvement Store Purchase,-131.79,0596808e-03c0-47d0-af70-9d4a64e0c6af,3233.44,debit,payment,AU00000,2023-10-26T04:17:03Z
transaction,adfd7ed4-56cd-4222-b299-7093dcc42180,posted,Uber Ride,-1184.44,0d2c5aae-028e-428b-b296-7f95925e4296,2049.0,debit,bank-fee,AU00000,2024-01-22T15:30:12Z
transaction,cf2ac402-9643-4fba-8c8f-2191b9951f04,posted,Movie Ticket Purchase,-3834.12,750bcbb9-d8dd-4fa2-8b16-ac2a7de12ae6,-1785.12,debit,bank-fee,AU00000,2024-02-15T05:42:31Z
transaction,71f047c6-3271-4b18-a4c3-f4034be2ac90,posted,Non Hooli ATM Withdrawal Fee,-868.94,72a54c1f-661f-444b-a2f8-8fcacc5389b8,-2654.06,debit,bank-fee,AU00000,2024-04-20T12:26:05Z
transaction,57256566-b949-4ca2-94db-7a2f4fd1797a,posted,Manly Maths Tutor Wages,-3695.04,a5d01c66-cc7a-415a-b253-ee13be2c9d12,-6349.1,debit,bank-fee,AU00000,2024-01-06T00:38:46Z
transaction,b9d2e3c4-060f-4acb-b817-fd712e8652b8,posted,Restaurant Dinner,-4802.65,a6a1da0a-60a8-4925-aba8-20ab35765db2,-11151.75,debit,cash-withdrawal,AU00000,2024-01-06T02:53:04Z
transaction,b1fa9390-d117-4d42-b5d1-f86b2b9e1aa9,posted,Transfer Platnm Homeloan 346454,-4599.63,55dd8675-4af4-44d7-828c-45f6456549e9,14317.1,debit,cash-withdrawal,AU00000,2023-10-12T15:03:35Z
transaction,8510baca-4c25-4e52-bcb8-17e12cc35be1,posted,Travel Agency Booking,-2586.63,84c85f4e-575d-43c5-ae8b-1c816d6d87a7,11730.47,debit,cash-withdrawal,AU00000,2024-04-17T14:06:05Z
transaction,50100af2-1c01-4884-8016-e09a04ef99dd,posted,Hair Salon Appointment,-813.41,30765f6b-7a65-443f-8df7-e91330678ee9,10917.06,debit,cash-withdrawal,AU00000,2024-03-25T14:45:12Z
transaction,7ee798a5-2246-4742-aaec-5c248c37a2c3,posted,Amazon Online Shopping,-1718.11,6b4f4e5d-f3fd-480e-8c85-53dbeb0a0b60,9198.95,debit,payment,AU00000,2023-08-03T11:38:13Z
transaction,f556e599-4ba4-4bab-9b8c-62fd461e8136,posted,TRANSFER TO JOANNA SMITH CAMPING,-3956.59,f9761062-daa3-49c5-90a1-616c25af04c6,5242.36,debit,payment,AU00000,2023-07-02T19:50:25Z
transaction,4fbab452-565d-43c1-afbf-be791a9584f8,posted,Transfer Platnm Homeloan 346454,-3403.29,371857ad-26a4-46fa-a9d5-0587a227f203,1839.07,debit,payment,AU00000,2023-05-18T22:40:30Z
transaction,145bdfc1-82ae-452c-a3d5-936538e31b99,posted,Amazon Online Shopping,-3412.68,8c4df5a5-5604-4a54-ab06-eeb0adea7bad,-1573.61,debit,payment,AU00000,2023-11-13T06:28:55Z
transaction,bc16c110-0a4e-49a5-b51e-6a600cf0b550,posted,AGL RETAIL ENERGY LTD (GAS),-3636.85,5d1be5a8-11bf-4ad0-b225-2da84b7efefd,-5210.46,debit,bank-fee,AU00000,2023-10-04T10:01:01Z
transaction,05818388-68b5-4302-8010-e917c96dbdf4,posted,Amazon Online Shopping,-1898.55,88ca0a00-51bd-473c-918b-dbfb63687b0d,-7109.01,debit,payment,AU00000,2023-12-14T18:00:48Z
transaction,a2d82b1a-88c8-4198-9e39-d0b92608be99,posted,Online Gaming Purchase,-1329.15,edac56fe-7223-4a72-abb0-a15977f1ff04,-8438.16,debit,payment,AU00000,2024-01-13T22:40:18Z
transaction,54e73f43-3219-4118-82cd-ae2c11e11986,posted,Non Hooli ATM Withdrawal Fee,-3245.8,19a2b3b3-d99e-4d18-8fa1-91e7e72a908f,15832.95,debit,payment,AU00000,2023-09-05T20:48:50Z
transaction,488f0bc2-4fe4-4210-a4a4-214ddb0e9554,posted,Amazon Online Shopping,-1214.45,51542d68-88e9-4af6-81cf-9c6c4a346dc6,14618.5,debit,cash-withdrawal,AU00000,2023-12-28T05:30:09Z
transaction,f8daeb68-aa51-49aa-a390-7e1d76c4ab45,posted,Amazon Online Shopping,-3351.61,66e90d69-07ba-4782-93a1-d296bdb3fb5f,11266.89,debit,cash-withdrawal,AU00000,2023-06-30T13:00:00Z
transaction,b8174d9e-10a2-4be7-b699-27b1f417c18a,posted,Public Transport Fare,-687.49,a47550ec-5b05-4fc8-ac46-ee7763810c61,10579.4,debit,bank-fee,AU00000,2023-09-19T03:28:36Z
transaction,886ff034-ccf7-4b09-8b21-92bd5abb621e,posted,Restaurant Dinner,-4610.11,95ae600d-4fb2-4737-9f9f-2ec558637d3c,5969.29,debit,bank-fee,AU00000,2024-02-01T18:29:57Z
transaction,7be5021c-6245-49c6-b95f-1cc08d4948d8,posted,Public Transport Fare,-186.33,38fa9511-7060-4b47-875c-f692febec4bf,5782.96,debit,bank-fee,AU00000,2024-01-08T15:37:25Z
transaction,e31794cb-574f-4386-957a-09195c597453,posted,Travel Agency Booking,-2684.43,752cf843-163f-4b70-a95f-0b409df585fb,3098.53,debit,payment,AU00000,2024-04-15T06:13:06Z
transaction,c9456ea0-bdda-4c5c-a3e6-d46434f19402,posted,Uber Ride,-4843.04,f9299dc9-b91a-40ce-b2eb-7a4ec0d2b0ab,-1744.51,debit,payment,AU00000,2023-05-12T16:24:53Z
transaction,889ffd27-1aa9-4426-a9ef-e2434e3b7c23,posted,Amazon Online Shopping,-4071.64,1991f673-75ef-4547-96d0-500a83d60924,-5816.15,debit,bank-fee,AU00000,2024-04-07T23:36:20Z
transaction,4d878c81-69d7-4509-bfc1-3f2f2a4e2387,posted,Public Transport Fare,-2109.73,34c63f48-4050-4c8d-bd5f-6a78a4f1a957,-7925.88,debit,cash-withdrawal,AU00000,2023-08-29T18:45:14Z
transaction,5b57af8c-00cd-4434-893d-c1a8523fe0af,posted,Online Gaming Purchase,-618.89,3443eae3-62b3-400d-bd3d-ec6690483587,6819.97,debit,bank-fee,AU00000,2023-10-31T00:14:43Z
transaction,fd198819-ee0e-4545-8a96-ecf47e463675,posted,Bookstore Purchase,-391.21,1e216002-bb9a-4c62-9e49-f9882ad32dc7,6428.76,debit,cash-withdrawal,AU00000,2023-12-16T19:55:58Z
transaction,3e505472-af0f-4c73-8033-c6b990b36461,posted,Travel Agency Booking,-1561.08,8fa9720d-547e-4884-a1fa-b4c8e0fa0584,4867.68,debit,payment,AU00000,2023-12-28T08:06:58Z
transaction,b6f205da-7bb4-4688-9de8-0c736a09c512,posted,CTRLINK CARERS Ref: 998R6789201610974V,-1734.44,45f86f43-33fe-4e47-8a4a-27393625cfdc,3133.24,debit,bank-fee,AU00000,2023-07-11T03:04:50Z
transaction,2f3008f3-f791-4bb4-bc26-106002951db9,posted,Mobile Phone Bill Payment,-1567.25,e0897852-6386-47b5-b247-a511a48fa7fb,1565.99,debit,payment,AU00000,2023-05-12T11:24:41Z
transaction,380636fa-97a8-48f7-99c3-6a73e7d109c5,posted,Restaurant Dinner,-1079.78,f23417c8-8849-4111-977b-fdfc4420ae88,486.21,debit,bank-fee,AU00000,2024-02-20T00:19:21Z
transaction,286e78f2-ff63-4900-804e-4384dad469de,posted,Online Gaming Purchase,-3182.93,acde2583-308b-4cc6-8b6e-f61695964bef,-2696.72,debit,payment,AU00000,2023-08-22T17:27:17Z
transaction,3f7e09bb-8666-4914-99ae-e4b95e189599,posted,AGL RETAIL ENERGY LTD (GAS),-3692.02,c4f59982-95ba-461f-a7ee-add2ed680cb7,-6388.74,debit,cash-withdrawal,AU00000,2023-10-22T21:11:55Z
transaction,17275b60-20d4-4896-a2d3-12038d4a3fec,posted,Clothing Store Purchase,-4529.96,f5a9cf06-91a8-4ee8-b747-678a2d0924fa,-10918.7,debit,bank-fee,AU00000,2024-02-16T14:10:42Z
transaction,f1a44df8-c83e-43b6-a8df-05fe6d7555db,posted,Travel Agency Booking,-4738.46,1b26551a-d720-4687-ba4b-645a94f4094f,-15657.16,debit,payment,AU00000,2023-06-13T00:59:02Z
transaction,9b163578-4eb6-4db5-b42d-206e40676bb1,posted,Wdl ATM WESTPAC IGA BALGOWLAH BALGOWL AU,-2055.83,3d4501b3-d288-44e6-a815-852f480a6526,4242.02,debit,bank-fee,AU00000,2023-11-13T23:31:31Z
transaction,38b475aa-2d70-4005-8a47-743f26f4372d,posted,TRANSFER TO JOANNA SMITH CAMPING,-4832.65,22ab803a-7b04-4c36-a4da-ef8ea16c3d1f,-590.63,debit,cash-withdrawal,AU00000,2023-07-02T19:13:03Z
transaction,a281d44a-8a99-4ee2-ab1c-b0ccd20f3368,posted,Music Streaming Subscription,-2055.8,4f01eb6e-be94-4d09-96e9-d6d22531ea31,-2646.43,debit,cash-withdrawal,AU00000,2024-03-29T07:50:19Z
transaction,89d3e2a8-06ca-4337-8443-f5e11dc94d80,posted,Pharmacy Purchase,-3385.21,d7033b9b-d2c6-4a8c-a5a5-7cbff6044293,-6031.64,debit,bank-fee,AU00000,2024-02-05T13:26:07Z
transaction,1134bf00-6ac7-49d2-8d8c-bca70805fd39,posted,Payroll WFRMS 15439393,10798.92,ab07c559-30e6-4303-b74d-13b24eab8410,4767.28,credit,transfer,AU00000,2023-11-14T02:02:43Z
transaction,49058afc-dce5-45be-998d-7c50bca0a1f5,posted,AGL RETAIL ENERGY LTD (GAS),-2072.25,b159fc9d-f44a-4d6d-90d7-6a729f3628b8,2695.03,debit,cash-withdrawal,AU00000,2023-05-27T07:18:21Z
transaction,23c271ec-d5b1-4744-a994-e6c297927642,posted,Uber Ride,-2410.88,1c9378e3-81df-44e4-9339-2562bd11106c,284.15,debit,payment,AU00000,2023-09-20T13:12:28Z
transaction,6f667e18-47bf-4ab8-8c18-eca37c68f924,posted,Music Streaming Subscription,-3595.14,6ab74415-89a7-4c07-8852-d5ec2374452f,-3310.99,debit,payment,AU00000,2023-12-31T07:12:34Z
transaction,63280148-f1d9-443b-8b46-378896995831,posted,Uber Ride,-1136.86,6960096d-b68d-4c61-977d-828b377b0699,-4447.85,debit,bank-fee,AU00000,2023-07-18T07:07:54Z
transaction,b6bcaccb-6416-4510-82a9-2caec078ea9d,posted,Gasoline Purchase,-1344.13,b3e681c9-4467-4f17-b14e-f802a8687cb6,-5791.98,debit,cash-withdrawal,AU00000,2023-10-01T08:39:17Z
transaction,2ca753c5-df2b-42cd-b24d-5aff70e1cc8b,posted,Manly Maths Tutor Wages,-4207.14,87409524-ca1f-46d8-98dc-74985b2ad939,4098.16,debit,bank-fee,AU00000,2024-01-01T18:52:50Z
transaction,725c0c79-ab55-4c42-b745-9f5695651c7a,posted,CTRLINK CARERS Ref: 998R6789201610974V,-393.15,6d95d29b-999f-4ee5-9e0e-de218111f247,3705.01,debit,payment,AU00000,2023-09-24T19:43:48Z
transaction,cd4eec95-9a67-4901-8f66-6626af677029,posted,Music Streaming Subscription,-333.7,6d927941-a0de-4ea1-8a7d-1d5edbde6630,3371.31,debit,bank-fee,AU00000,2023-07-05T15:40:45Z
transaction,9b7edbd8-2470-4b7b-8ee2-0c9f729ed2d8,posted,Clothing Store Purchase,-2965.05,e0e4be87-edd1-4ca2-815a-c10e5b50f5dd,406.26,debit,cash-withdrawal,AU00000,2024-04-28T00:50:29Z
transaction,1de6d450-5a9b-4603-a22e-a08eb4c9876e,posted,Bookstore Purchase,-3622.06,bcceead1-27c2-44af-8213-d6b4ac29dea3,-3215.8,debit,payment,AU00000,2023-06-11T15:39:36Z
transaction,d0d6c1c8-aacd-4d3b-b809-8dbf70d7fb62,posted,Non Hooli ATM Withdrawal Fee,-3164.54,46c64fac-2505-4dd8-950c-771dd40be3e2,-6380.34,debit,payment,AU00000,2023-08-13T14:24:49Z
transaction,bae083b8-b1c1-4ba3-9645-33ec6fa52c19,posted,Public Transport Fare,-1595.2,b005de88-d061-48b4-8a2b-a36e3b526a80,-7975.54,debit,bank-fee,AU00000,2023-10-19T10:04:50Z
transaction,aee1afb1-dfa0-4657-8fcb-1da9c9425891,posted,Music Streaming Subscription,-3313.16,e94ffddf-16a2-462c-adaf-6ba69a4d5a0a,-11288.7,debit,cash-withdrawal,AU00000,2024-01-16T18:40:14Z
transaction,0c1173cb-9861-4fef-bc8d-35157bf1354f,posted,Electricity Bill Payment,-387.16,58cf3528-1a9d-4c59-86c4-365e6c312802,-11675.86,debit,cash-withdrawal,AU00000,2023-06-04T00:23:17Z
transaction,3af426d3-905d-4fd5-8438-18dd0b6b8780,posted,Coffee Shop Purchase,-2192.82,53b4d1bb-704b-41dc-97d3-4855ecb51893,-13868.68,debit,bank-fee,AU00000,2023-12-05T06:12:27Z
transaction,45819563-157a-4982-b228-c69f07d13fba,posted,Public Transport Fare,-4045.61,b507ebec-3da2-45f0-922c-0fba79751ac1,5507.99,debit,bank-fee,AU00000,2023-06-20T17:46:08Z
transaction,ec3629df-68e1-4fc5-96a7-de477074d6d7,posted,Hair Salon Appointment,-2778.19,6f3cc37b-f9ac-4066-b299-56f706ac9dd3,2729.8,debit,payment,AU00000,2023-08-24T21:23:42Z
transaction,d834cafb-4206-4394-90b8-982b55ac7143,posted,CTRLINK CARERS Ref: 998R6789201610974V,-4522.75,50f9d044-bcd3-458b-8f2e-6f9c048c2525,-1792.95,debit,cash-withdrawal,AU00000,2023-12-21T00:27:43Z
transaction,d6073a26-4b8e-46e8-be29-480db6388378,posted,Bookstore Purchase,-422.39,177c921b-b36f-4152-8089-4374701f2376,-2215.34,debit,bank-fee,AU00000,2023-09-05T16:56:08Z
transaction,0fad1128-8dee-44b9-bae2-d220651bb370,posted,Gasoline Purchase,-3703.44,815cf330-b8fe-451c-8739-7b1b1caff0a9,-5918.78,debit,bank-fee,AU00000,2024-01-14T06:55:28Z
transaction,956f0cef-f995-4afc-a5f2-60b5f8915b76,posted,Non Hooli ATM Withdrawal Fee,-1645.34,15bf64ff-166a-4c37-ae51-231f361600b7,-7564.12,debit,bank-fee,AU00000,2023-11-10T23:22:34Z
transaction,b1338bc8-c1e4-4f25-a48a-599771c0d6b2,posted,Uber Ride,-2860.53,7c7e32ed-397b-49ef-9d17-52c911338dc8,-10424.65,debit,cash-withdrawal,AU00000,2024-01-11T03:06:33Z
transaction,07d0e209-3b4f-438e-910c-b86094f75184,posted,Music Streaming Subscription,-4790.33,3877c0f7-af81-412a-bc74-b0ffee2b355b,-15214.98,debit,cash-withdrawal,AU00000,2023-07-26T14:37:54Z
transaction,d1754e00-7834-48a9-ab5d-ec55cc899a7e,posted,Transfer Platnm Homeloan 346454,-4019.69,748bca5b-a1d1-48b0-b82e-49dfbe10957b,-19234.67,debit,cash-withdrawal,AU00000,2023-08-09T13:46:31Z
transaction,446e9d8e-93de-4bb1-abf8-edbe6f2f5e0d,posted,Car Maintenance Expense,-831.87,122aaefe-a73d-4675-8079-04beb01e76bb,-20066.54,debit,payment,AU00000,2023-06-14T11:46:30Z
transaction,75695968-e41e-4570-bad7-277938e6157e,posted,CTRLINK CARERS Ref: 998R6789201610974V,-3516.4,55d394e3-ce57-4d8f-a0fe-1342a68774e9,6332.31,debit,payment,AU00000,2023-10-19T11:59:24Z
transaction,b5fb9d09-bcb1-4c3a-b4c2-01da9f503a1b,posted,Bookstore Purchase,-4954.24,1f813bae-4908-483c-aeb7-b500d5e41ce1,1378.07,debit,cash-withdrawal,AU00000,2024-02-21T04:19:16Z
transaction,29c706bf-041e-4764-9a63-52adc30be18b,posted,TRANSFER TO JOANNA SMITH CAMPING,-4342.45,e6f0f3df-157a-4aa8-9228-96d2c70e50fc,-2964.38,debit,payment,AU00000,2024-03-02T21:58:30Z
transaction,f349581f-b6a0-467f-ba21-33c4b442b176,posted,Restaurant Dinner,-2232.6,3f946d54-0d33-47ee-98b2-c3c4c5226d1c,-5196.98,debit,cash-withdrawal,AU00000,2023-06-13T22:17:38Z
transaction,7caa82ca-fec8-4e59-95f3-1b6fc9914b9d,posted,Travel Agency Booking,-2029.83,c04cf468-3a85-4e83-8a2d-62c5076dd215,-7226.81,debit,bank-fee,AU00000,2023-11-13T21:34:41Z
transaction,938fef02-3f7d-4394-bccf-27aeeb451847,posted,Amazon Online Shopping,-2482.15,176bfc24-6794-4b04-96ab-097a5cfa49c4,-9708.96,debit,payment,AU00000,2023-06-17T05:14:27Z
transaction,981bdad3-347d-47ea-8530-7e6bc9776da2,posted,Coffee Shop Purchase,-2490.12,4dd0a6ba-479a-42e3-ab15-ae6f00355f71,-12199.08,debit,payment,AU00000,2023-09-12T05:02:36Z
transaction,3e785bde-bb4b-4d07-8962-fe7612cf109c,posted,Online Gaming Purchase,-1467.83,9b1ff93b-9548-47e0-9d70-fedb70cead2b,-13666.91,debit,payment,AU00000,2023-07-06T03:49:48Z
transaction,3e1bb1d2-ab74-4b0e-9e76-d6f528075122,posted,CTRLINK CARERS Ref: 998R6789201610974V,-1854.14,e9972cbe-c7dc-43d5-9083-c4f9328dedd6,-15521.05,debit,bank-fee,AU00000,2023-08-16T04:13:10Z
transaction,8fe4ef24-2daf-4a56-ac36-292af286ff3f,posted,Bookstore Purchase,-781.69,df17a9b3-6c6b-4b7e-b27d-6776ccd67f72,-16302.74,debit,payment,AU00000,2023-11-24T21:00:57Z
transaction,736a21e9-4592-45c5-9edb-84b6b92a5f07,posted,Uber Ride,-1891.08,024b18e8-0b8c-42ee-85db-2a0c9622250a,6911.95,debit,bank-fee,AU00000,2023-10-17T22:45:45Z
transaction,d9fc7613-ff8a-478c-82a0-8ee061ded8ed,posted,AGL RETAIL ENERGY LTD (GAS),-4721.35,066c485a-3f37-44ba-9612-e2623aa19435,2190.6,debit,cash-withdrawal,AU00000,2023-07-21T19:22:12Z
transaction,41185ca2-95e1-4d91-9b75-c5b74e732e60,posted,TRANSFER TO JOANNA SMITH CAMPING,-3062.42,65f4815d-6172-416b-98b2-cb18a5f826d3,-871.82,debit,cash-withdrawal,AU00000,2024-05-08T03:31:32Z
transaction,4fbfdf13-caf9-4a51-8c22-91de30872e82,posted,Restaurant Dinner,-3954.9,17d5613e-3b22-4185-b842-886fe9465873,-4826.72,debit,cash-withdrawal,AU00000,2023-06-14T08:38:15Z
transaction,59ecf4e1-b796-454e-afca-f9fc9b501c98,posted,Electricity Bill Payment,-4784.4,6e29aa84-9794-4d45-986e-b4410a9f0e59,-9611.12,debit,cash-withdrawal,AU00000,2023-08-30T18:57:15Z
transaction,56a9a9a2-c0b5-4233-aefb-e21712a0fa9f,posted,Transfer Platnm Homeloan 346454,-2394.71,fc40a4de-7876-41ad-beb0-caf65277fd00,-12005.83,debit,payment,AU00000,2023-10-08T22:35:30Z
transaction,421fcb60-428a-4345-b7a8-c83374481d25,posted,Payroll WFRMS 15439393,10254.25,9e5796f5-33ba-402e-b2ad-fe61ecaeb2ac,-1751.58,credit,transfer,AU00000,2023-11-05T13:52:36Z
transaction,ebe63933-c6c9-4888-8e71-70a035f6334e,posted,Payroll WFRMS 15439393,10885.27,3a4898e6-9778-4d18-9bc1-645ee6cd431c,9133.69,credit,transfer,AU00000,2023-09-06T15:29:59Z
transaction,975188d7-dc3e-476f-9dda-3ea74bd2f3fd,posted,Electricity Bill Payment,-4631.33,a79ca2d0-a559-4f81-a071-f8bade842d02,4502.36,debit,payment,AU00000,2024-02-12T06:50:45Z
transaction,024b6384-f451-47de-b57d-1cdfd268cd1b,posted,Clothing Store Purchase,-1023.16,6a70f03b-4fc3-4e85-af3d-3d0b726746c1,3479.2,debit,bank-fee,AU00000,2023-08-26T18:53:42Z
transaction,012d2a75-f532-4110-b00a-53a14dd9dc2d,posted,Netflix Subscription,-3699.37,c09ad4f6-e95c-44c3-8508-322ee7e39b88,10914.92,debit,payment,AU00000,2023-11-03T17:08:15Z
transaction,58bf2523-5ad6-4fb4-aca0-bcecec2bb5a2,posted,Bookstore Purchase,-1480.16,4e59a4a9-2260-4e29-af0f-12ba240f8977,9434.76,debit,cash-withdrawal,AU00000,2023-10-09T16:07:40Z
transaction,ab99c8aa-bdd4-496b-aeee-999971dae27d,posted,Non Hooli ATM Withdrawal Fee,-3157.87,98a3cf10-6c66-487b-995d-5131a390c9fa,6276.89,debit,payment,AU00000,2024-03-14T02:17:47Z
transaction,78c46aaf-f371-4f32-8094-a41faca9f863,posted,Non Hooli ATM Withdrawal Fee,-4587.42,ace55da3-8f85-42e9-abb2-3b7197d52e08,1689.47,debit,cash-withdrawal,AU00000,2024-01-25T18:11:29Z
transaction,695be6bd-e5b0-488d-944d-ff72719aa7da,posted,Transfer Platnm Homeloan 346454,-779.24,0e2ae0d0-f3a2-4dc5-b469-e68604a54092,910.23,debit,payment,AU00000,2023-12-04T05:18:06Z
transaction,11f0c17c-6335-4e67-a23a-64451b6b7ec7,posted,Gym Membership Fee,-4535.34,b6ef839a-c5c6-4781-bcb1-06df0ba75d72,-3625.11,debit,bank-fee,AU00000,2024-05-07T01:40:32Z
transaction,7e205231-57ee-48f5-89e1-81c46909bfbc,posted,Home Improvement Store Purchase,-4232.03,eba53acc-9b94-4fd9-89eb-a4162f219d47,-7857.14,debit,bank-fee,AU00000,2023-10-19T23:01:33Z
transaction,d3438622-8ef5-4f12-9e07-5add8cf975cc,posted,Pharmacy Purchase,-3727.07,ddd968d7-9ab1-434f-9b53-364c90d0e797,-11584.21,debit,bank-fee,AU00000,2024-04-04T08:53:22Z
transaction,7b3786e1-844c-4f4b-b8b7-af0cd432e84a,posted,Travel Agency Booking,-4909.81,f329045a-74e1-4e9f-9ebf-6d4e1dbba1b9,-16494.02,debit,bank-fee,AU00000,2023-05-29T07:30:36Z
transaction,3ec66d60-e017-4c39-a2b5-357682fa47bb,posted,Electricity Bill Payment,-4282.27,15a0ece4-b76e-4f4e-9bac-72a82db05560,-20776.29,debit,payment,AU00000,2024-01-26T04:10:48Z
transaction,68116516-2096-4bfd-b3c2-5555d0b4ecd1,posted,Wdl ATM WESTPAC IGA BALGOWLAH BALGOWL AU,-3670.62,8514f7f5-b87d-4140-9ccd-17d7afabd0fe,7892.41,debit,bank-fee,AU00000,2023-12-20T01:03:09Z
transaction,3565b5f0-4c5e-4e85-adff-9587ccd51aa2,posted,Music Streaming Subscription,-1652.08,4be91f1f-9ecb-4f80-9843-4eebb5f8b1da,6240.33,debit,cash-withdrawal,AU00000,2024-04-26T21:03:57Z
transaction,d9043ec0-0df5-48fe-85a4-2f4cb8bdf980,posted,Netflix Subscription,-236.83,d0761aa5-d0b0-49be-9b62-89e5403ea85b,6003.5,debit,cash-withdrawal,AU00000,2023-08-02T11:49:42Z
transaction,729c2c2d-9c0b-4927-9db3-081ad1935f19,posted,Pharmacy Purchase,-4927.88,b23962c6-0697-4be5-86b5-fc0d172f215a,1075.62,debit,bank-fee,AU00000,2024-02-25T08:41:34Z
transaction,e75ec520-159f-4b34-812e-4ffe154f243c,posted,Uber Ride,-3823.26,d646c6ff-c7ff-4d46-8948-294e6beaf6f7,-2747.64,debit,cash-withdrawal,AU00000,2023-11-28T18:53:24Z
transaction,7a1e0e5b-02eb-4e54-ac7c-0238b37c250f,posted,CTRLINK CARERS Ref: 998R6789201610974V,-2.07,fc9e3fce-3a9a-4ba1-8abc-1f9dde31c220,-2749.71,debit,cash-withdrawal,AU00000,2024-03-04T14:12:19Z
transaction,05c2fcf5-ccaa-42b8-9399-941e3c987ced,posted,Home Improvement Store Purchase,-2504.69,5427bc75-e4e7-41e4-86d7-b0c93cd213bc,-5254.4,debit,bank-fee,AU00000,2024-02-10T00:02:00Z
transaction,a20dfee7-bcc1-4d8e-87af-df966dff46ca,posted,Bookstore Purchase,-3605.86,cd929e4a-f18b-44e8-b2c7-1cf28fd7b9c8,-8860.26,debit,bank-fee,AU00000,2023-05-20T18:55:11Z
transaction,65f8b440-75b8-4117-9a97-01a7dfd79e7b,posted,Restaurant Dinner,-1024.82,5b7c86d6-2422-4938-b779-b9d1212caea0,-9885.08,debit,cash-withdrawal,AU00000,2024-01-17T01:33:38Z
transaction,ab42ae87-8cbd-4434-8dd6-0a78c7d81291,posted,Online Gaming Purchase,-2925.74,bf4cdbac-d253-4e73-8c89-3a2da3da296a,-12810.82,debit,payment,AU00000,2023-12-04T07:12:08Z
transaction,775b28f4-3ba2-4e67-8283-2a9d749e4b90,posted,Pharmacy Purchase,-3158.16,98539e10-042c-45c5-997a-6027a78156fa,15717.53,debit,payment,AU00000,2023-05-14T05:41:36Z
transaction,d6439feb-0301-45a0-9f8b-2c13733ca6b8,posted,Netflix Subscription,-352.32,8d2603b8-258b-49d0-a3b5-fce4dd20f227,15365.21,debit,bank-fee,AU00000,2023-12-11T08:09:48Z
transaction,0f8a3ae7-55ef-4894-9277-c2b3b55565c7,posted,Public Transport Fare,-2455.79,3ce0ddae-bc1d-401a-8e51-a444795b84b7,12909.42,debit,cash-withdrawal,AU00000,2023-10-25T17:58:37Z
transaction,cb208a1a-649a-4616-9208-4ca50ed36d86,posted,Car Maintenance Expense,-367.41,5eb84406-5104-435f-b514-2f06b424643a,12542.01,debit,payment,AU00000,2023-05-27T01:38:06Z
transaction,cf86afa2-b3d8-4d11-9418-63ddab4d8d00,posted,Non Hooli ATM Withdrawal Fee,-54.56,f7f8f9a5-c0ac-48f3-bcea-311a53680d48,12487.45,debit,bank-fee,AU00000,2023-09-19T13:38:54Z
transaction,f7b06b0f-c677-43ba-9fef-d570370391d4,posted,Non Hooli ATM Withdrawal Fee,-1722.56,edcd3a80-de57-4708-b045-dd9f1dfe7bd8,10764.89,debit,bank-fee,AU00000,2023-11-23T07:20:17Z
transaction,a2c341fb-d511-4421-8127-8621054b995b,posted,Manly Maths Tutor Wages,-2150.12,44409674-ec1d-4b3a-806a-548960f602c9,8614.77,debit,payment,AU00000,2023-12-23T03:56:13Z
transaction,a2289f29-03b0-4456-86c1-c8d46abe952a,posted,Travel Agency Booking,-2314.66,9aecf94b-b3e0-4330-80d5-09e053635493,6300.11,debit,payment,AU00000,2023-10-03T09:08:11Z
transaction,8e2857dc-3024-42c3-acb4-ffc3932bd5a2,posted,Amazon Online Shopping,-3282.25,8d188800-fa30-4cb6-be6e-4aac535989ae,3017.86,debit,payment,AU00000,2023-12-30T18:57:59Z
transaction,d806d978-a21c-477c-bfc1-5a110bb47382,posted,CTRLINK CARERS Ref: 998R6789201610974V,-862.47,d7e162f6-5cbb-4b01-aa63-8ab922872ab5,2155.39,debit,payment,AU00000,2024-04-18T04:48:24Z
transaction,ac33ec73-35fb-4d35-9783-e22dc498de93,posted,Pharmacy Purchase,-614.94,8dece92c-867e-4161-bda8-061bd541deff,14369.79,debit,cash-withdrawal,AU00000,2024-03-29T01:52:05Z
transaction,827999df-992c-43ad-91a0-46c63ef5dd7f,posted,TFR Acc14000 TO 12389,-240.84,250af862-bec8-4a1b-93ba-f88171ccd856,14128.95,debit,cash-withdrawal,AU00000,2024-01-03T01:22:28Z
transaction,4114d705-56b5-4025-b83e-1973e55df1f3,posted,Wdl ATM WESTPAC IGA BALGOWLAH BALGOWL AU,-402.62,49e43337-ea41-443e-8532-ed5f9690531b,13726.33,debit,payment,AU00000,2024-01-22T23:59:47Z
transaction,d0887598-b799-457a-a3e0-c7d222946d68,posted,Clothing Store Purchase,-48.97,ae7196c7-4cd1-4b30-9be7-e1d420650c77,13677.36,debit,cash-withdrawal,AU00000,2023-07-29T05:33:11Z
transaction,8d6392c5-35f8-4b95-957d-f419f188596e,posted,Gasoline Purchase,-2968.67,cae2b915-ee81-4d1d-a344-9ec041f6885e,10708.69,debit,cash-withdrawal,AU00000,2023-07-24T23:37:10Z
transaction,f846c2b9-824d-47d5-ab60-adc0492af490,posted,Manly Maths Tutor Wages,-3963.58,a643bb17-56ec-4402-9618-de1e41bbbb2b,6745.11,debit,cash-withdrawal,AU00000,2023-05-26T16:26:24Z
transaction,3247b788-4af5-4dd1-9264-c9ac4a6a894b,posted,Pharmacy Purchase,-1334.2,b03c8011-188a-48d0-8561-5fd44fda0d74,5410.91,debit,cash-withdrawal,AU00000,2023-12-06T11:55:30Z
transaction,a67c1f3d-afc4-449f-b7ab-47770df6eb7d,posted,Coffee Shop Purchase,-1613.32,ad6455e8-13f0-4e10-9485-c694441bc303,3797.59,debit,bank-fee,AU00000,2023-08-28T11:23:33Z
transaction,3fd02636-b540-4fe9-b014-c20da21b9d6a,posted,Clothing Store Purchase,-3284.09,8e6c2132-5b45-4466-9d7e-1acc41fcb0a4,513.5,debit,payment,AU00000,2023-12-11T10:03:09Z
transaction,e4e4ee41-3834-4924-8a0d-c7647c278a2c,posted,Mobile Phone Bill Payment,-2599.19,f4bb81ad-6c8c-4f1c-83be-37175d0bb874,-2085.69,debit,bank-fee,AU00000,2023-12-03T23:00:56Z
transaction,0bf5e8ff-003a-4ab5-8518-176efe0349c8,posted,Movie Ticket Purchase,-1572.36,53013de9-c1d1-4e8f-9219-5c361411258d,14404.24,debit,bank-fee,AU00000,2023-11-06T02:34:46Z
transaction,59a525d7-11f4-4550-b531-282f4f771991,posted,Gasoline Purchase,-3760.94,6e7995d2-7bb1-4686-b9bc-92a439a209d1,10643.3,debit,bank-fee,AU00000,2023-08-12T00:38:43Z
transaction,820211aa-385e-4b4e-abac-38ae8a8a42b3,posted,Clothing Store Purchase,-1904.91,6f1656ab-4a70-464d-bb8e-b64015b2f7c3,8738.39,debit,cash-withdrawal,AU00000,2023-09-20T15:36:44Z
transaction,673d8672-87e0-46d2-98d4-5f02dcaddb09,posted,Public Transport Fare,-2371.94,a779f1f7-30cf-4e75-a93e-1c1f7f21ca2d,6366.45,debit,bank-fee,AU00000,2023-06-17T19:35:23Z
transaction,57d71054-08d2-445e-94ed-e33bccb7177c,posted,Uber Ride,-1773.97,0d4b32ca-3705-4ad0-83c8-dd74163bf475,4592.48,debit,bank-fee,AU00000,2024-01-21T16:01:46Z
transaction,1d2a0a9b-f4ec-4429-bf19-1cc63416ed0e,posted,Music Streaming Subscription,-2551.36,24f73885-0620-4472-aa9c-0b62ec170f78,2041.12,debit,cash-withdrawal,AU00000,2023-09-16T17:41:42Z
transaction,5d45ac12-ba0e-4b4a-815b-9ed29a19603f,posted,Electricity Bill Payment,-3800.1,eb358fc4-a0c3-44d8-954c-f65ff73f934e,-1758.98,debit,bank-fee,AU00000,2023-10-22T03:51:23Z
transaction,ed6d8077-cec7-4171-bfd0-720a69c85a48,posted,Travel Agency Booking,-868.45,b7283c99-2cf3-4d39-9e22-8da6f7f989e1,-2627.43,debit,payment,AU00000,2023-08-09T16:52:10Z
transaction,f724a56a-8ccf-4806-be83-457b5628be84,posted,Car Maintenance Expense,-4576.28,90fe5283-d298-40fc-ae90-b033e52c4d95,-7203.71,debit,payment,AU00000,2023-08-23T18:16:40Z
transaction,086232bc-3e28-4709-bb57-ff996e9ab99a,posted,AGL RETAIL ENERGY LTD (GAS),-3383.81,81e39b4d-f839-4319-ba1c-57f06124a766,-10587.52,debit,bank-fee,AU00000,2023-11-24T21:31:58Z
transaction,28b87f50-0ff5-46cc-b6f6-3d691657b3c4,posted,Coffee Shop Purchase,-1439.07,d11bbcba-cfdf-4f91-b2a1-67f867cb0064,8553.32,debit,cash-withdrawal,AU00000,2023-06-07T04:30:22Z
transaction,13e6a5ec-ddad-4bd3-b9fc-093debf6ee89,posted,Gym Membership Fee,-2638.94,624ce145-3779-41fe-8f45-9e1ddb274b71,5914.38,debit,cash-withdrawal,AU00000,2023-10-18T23:05:33Z
transaction,98af7352-d65d-4995-942d-045a85ecaca6,posted,Online Gaming Purchase,-3692.8,052f5232-a1e0-4650-a7fa-d80c94765e09,2221.58,debit,bank-fee,AU00000,2024-01-29T09:36:01Z
transaction,e6e53afe-a4c3-446a-afdc-dc0ecd417fc8,posted,Coffee Shop Purchase,-3155.35,d874ebe1-e7eb-4560-b994-f593f0d18390,-933.77,debit,bank-fee,AU00000,2023-08-06T04:35:11Z
transaction,17b09451-9a34-4fc6-abb6-df1c92f50bf7,posted,Uber Ride,-3271.22,241183ff-979b-47fe-aaef-24722617bb11,-4204.99,debit,payment,AU00000,2023-12-15T11:28:59Z
transaction,2fd9b55a-06dd-45a4-8b10-ae2e3e18abc8,posted,Car Maintenance Expense,-4951.5,877f3224-c57e-4dbb-955e-1997408d3e67,-9156.49,debit,cash-withdrawal,AU00000,2023-08-14T04:44:50Z
transaction,4b1adf7e-7360-4dfd-887d-079a914582da,posted,Online Gaming Purchase,-2243.86,9416baa0-a3a8-4633-8bc7-ceb0f6f3f57e,-11400.35,debit,cash-withdrawal,AU00000,2023-07-03T15:21:31Z
transaction,d03f4287-4ce4-4f14-b1fe-e514b6e813e9,posted,TFR Acc14000 TO 12389,-3458.84,dd851e1e-cb06-4a65-98fd-b4ebcb44d623,-14859.19,debit,cash-withdrawal,AU00000,2023-09-10T01:25:37Z
transaction,e24e54e9-8eb5-487b-9d89-c276cab368a7,posted,TFR Acc14000 TO 12389,-1947.61,dc6572db-4856-4aeb-8631-305ce4bfd141,-16806.8,debit,bank-fee,AU00000,2023-07-08T22:58:36Z
transaction,8ffb4c2a-5d3a-424f-ab73-d658549dd190,posted,Car Maintenance Expense,-4537.33,5f67c901-40c7-43e5-8881-506c9ab2ce3b,-21344.13,debit,bank-fee,AU00000,2024-01-09T13:22:11Z
transaction,e566359a-1801-4d7a-8f2e-51c65d867592,posted,Wdl ATM WESTPAC IGA BALGOWLAH BALGOWL AU,-2185.27,2c4beceb-0078-4786-a763-165f229d3121,15754.8,debit,cash-withdrawal,AU00000,2023-05-19T05:31:54Z
transaction,e7d90e69-8010-4aed-9951-7c9ad36d080e,posted,Amazon Online Shopping,-2006.48,9c89ee9c-336e-4526-8520-e5817da7bea0,13748.32,debit,payment,AU00000,2023-07-06T14:47:40Z
transaction,ad5aacdc-d6aa-4387-91f8-5b8ba234b947,posted,CTRLINK CARERS Ref: 998R6789201610974V,-246.26,54872e62-e7ad-426d-9f52-2bd332f07a5c,13502.06,debit,cash-withdrawal,AU00000,2024-01-02T10:57:30Z
transaction,36367c10-bd5f-4289-ae64-04cdf904bb6f,posted,Amazon Online Shopping,-1908.31,4ddf5bdc-afbd-4d9a-a14f-bbd830b61691,11593.75,debit,payment,AU00000,2024-03-06T10:21:37Z
transaction,705d004b-521a-4a85-bf75-157ec0656ce3,posted,Bookstore Purchase,-2936.2,c7e1a86f-f293-456d-a089-90aa3f7c9c6c,8657.55,debit,payment,AU00000,2023-06-12T02:15:27Z
transaction,29e11da4-5237-44cb-86cb-5e0e8afe4ecf,posted,Uber Ride,-4973.17,1bf19df3-12c9-45eb-abf6-b13cfc49435c,3684.38,debit,payment,AU00000,2023-12-24T11:31:55Z
transaction,a171cde9-39c8-40a6-838c-dd3321226932,posted,AGL RETAIL ENERGY LTD (GAS),-4240.2,aaef0675-06fb-4861-bd9e-403c619f6adb,-555.82,debit,payment,AU00000,2023-12-14T13:12:12Z
transaction,e4844495-0a35-4895-b626-a099153c00b5,posted,CTRLINK CARERS Ref: 998R6789201610974V,-774.22,932092fb-c7df-4d88-9ca4-c4d21d945d5a,-1330.04,debit,cash-withdrawal,AU00000,2023-11-10T14:49:49Z
transaction,4b76ab14-31d5-48d0-b98a-12fc34203ac2,posted,AGL RETAIL ENERGY LTD (GAS),-4664.33,3f4a55d8-dcf2-4474-befa-fde2987055bb,-5994.37,debit,payment,AU00000,2024-04-29T18:30:53Z
transaction,b501e18c-1d0c-4b04-9b8b-bc1458e349cf,posted,Coffee Shop Purchase,-1593.28,6e4d791e-da9a-42fc-9167-f5b8dc700209,-7587.65,debit,payment,AU00000,2023-11-16T07:27:31Z
transaction,eefb0238-1ada-467e-a4df-2f098aa4ddd1,posted,Transfer Platnm Homeloan 346454,-4020.37,28799e87-5588-49ab-a84a-2a28d7a02d54,2578.73,debit,bank-fee,AU00000,2023-07-06T22:31:47Z
transaction,4d15cda6-817a-49bb-a71c-a2f72cf7e9e4,posted,Hair Salon Appointment,-1270.01,337d054e-716c-4d0a-88ec-f345eabb86bd,1308.72,debit,bank-fee,AU00000,2023-10-08T09:11:22Z
transaction,ca54faa1-7d61-4941-94c5-db79cccb3513,posted,TFR Acc14000 TO 12389,-4462.45,bdb97a2d-216a-492d-b81a-26996bf736a1,-3153.73,debit,payment,AU00000,2023-12-28T11:36:39Z
transaction,2c8382f8-8dbe-40e9-9ef7-8d26d94e1a5f,posted,Amazon Online Shopping,-2902.74,9c358e22-fde0-4e30-8890-e6dda7744281,-6056.47,debit,payment,AU00000,2024-04-25T01:16:40Z
transaction,4185c1a5-bd38-4995-a8b2-0f8e1e58ddca,posted,Gasoline Purchase,-4138.97,ec5be2a9-e249-4f2b-8579-a0a0926f01f0,-10195.44,debit,payment,AU00000,2024-04-24T18:19:56Z
transaction,162d8d92-743d-42f8-82a6-4091ac80c3e7,posted,Hair Salon Appointment,-3125.23,02b786d5-2716-4976-957d-a47d5560cce4,-13320.67,debit,bank-fee,AU00000,2023-12-05T13:34:49Z
transaction,15f20ef8-392f-40ff-9a28-1cb2e2f70f24,posted,Car Maintenance Expense,-3857.94,f9ca9cb9-13e3-4fea-b450-22c68501753b,-17178.61,debit,payment,AU00000,2024-02-02T17:34:00Z
transaction,41f0e626-f897-4e29-9dd5-436f9ccf6b27,posted,Manly Maths Tutor Wages,-807.34,754a7ace-5859-4cc5-ade8-1452af25b319,-17985.95,debit,payment,AU00000,2023-11-14T08:20:24Z
transaction,e43b9526-6155-4aec-8086-7d8650ed0723,posted,Manly Maths Tutor Wages,-2860.75,3d9928f6-94ce-4e1d-b9b7-fafd029fa254,-20846.7,debit,payment,AU00000,2024-03-17T13:03:47Z
transaction,09f93659-d3f6-439d-9f34-c14d38db3462,posted,Travel Agency Booking,-4618.71,99a5ec9a-83c5-4b5e-a5a0-c4c9e71dae91,-25465.41,debit,payment,AU00000,2024-01-26T14:46:10Z
transaction,8df87b83-b358-4d7d-a444-d2ee00369d11,posted,Home Improvement Store Purchase,-4706.86,e1d971c5-f519-4b90-ba1c-0ba15e0747e7,897.04,debit,cash-withdrawal,AU00000,2024-02-26T19:45:50Z
transaction,f10165c5-c3f3-432b-a941-900d04fe37f9,posted,Payroll WFRMS 15439393,11166.22,532a5e83-4186-401d-a0e4-d9b71fd3b154,12063.26,credit,transfer,AU00000,2024-04-19T21:05:08Z
transaction,82f2531d-a663-4df2-983a-5bc780b71147,posted,Travel Agency Booking,-3148.09,6313ba41-934f-4c14-a83b-03bee3e9fd0b,8915.17,debit,bank-fee,AU00000,2023-10-23T11:04:33Z
transaction,dd729e62-1fe5-469e-be4f-bb5c8d637155,posted,Travel Agency Booking,-3579.37,82e5e648-223c-478e-8133-a60851d1f2ef,5335.8,debit,payment,AU00000,2024-01-28T18:41:45Z
transaction,7bdc849b-fedf-40e2-af19-f649e3b84990,posted,Netflix Subscription,-1741.99,ad8abfac-bf50-419b-8ce8-2c005f3e6427,3593.81,debit,payment,AU00000,2024-01-07T05:43:09Z
transaction,5289a3b1-9083-4f86-9de8-34e616dd88be,posted,Online Gaming Purchase,-3634.09,ec6d1f5e-09e1-4ac4-af68-454b83c7955f,-40.28,debit,cash-withdrawal,AU00000,2024-01-05T17:32:06Z
transaction,01612909-957f-45a4-8cc2-c9cd6d133842,posted,Amazon Online Shopping,-1931.15,f2f2bf94-6e45-4ae8-a0b2-e553ceac9ccb,-1971.43,debit,bank-fee,AU00000,2023-08-06T22:11:39Z
transaction,2ec2ae9e-cea5-4c69-ab31-62eadca6900b,posted,Gym Membership Fee,-2182.01,df3905f2-5c6a-4363-aab6-db733e8b3054,-4153.44,debit,payment,AU00000,2023-10-12T15:09:24Z
transaction,e7599314-c7dc-4380-b938-a5ba0e7dfddb,posted,Coffee Shop Purchase,-2640.82,6c686e74-a13e-4f87-91a3-6308b6042df1,-6794.26,debit,bank-fee,AU00000,2024-01-07T08:23:06Z
transaction,f6360936-70b4-4019-a300-b13cdf2d3f4a,posted,Hair Salon Appointment,-939.41,48f183ce-5071-4b31-880e-c82196413eaf,-7733.67,debit,bank-fee,AU00000,2023-06-07T05:49:08Z
transaction,acc322f1-f907-460b-8bda-b7d136a35138,posted,Movie Ticket Purchase,-3887.46,93f80920-9533-403f-9965-6c0ce5ca91d2,14446.09,debit,bank-fee,AU00000,2024-04-16T07:37:54Z
transaction,9d815907-36f0-4030-9393-30c8732c01cd,posted,Travel Agency Booking,-3722.93,2ec4e271-68e5-4a18-bdd1-e3a34987ad14,10723.16,debit,cash-withdrawal,AU00000,2023-09-05T13:25:25Z
transaction,73f2cb6a-4608-479f-afa4-2e2134c39890,posted,Transfer Platnm Homeloan 346454,-4726.88,61baa86f-b5d8-437a-9360-dc9482e3e106,5996.28,debit,cash-withdrawal,AU00000,2023-07-09T14:31:13Z
transaction,d399795a-4c64-4ee2-a521-02be42a6a15e,posted,Gym Membership Fee,-1615.46,b3bb71a7-1d19-4211-ba65-df5e86e5ec11,4380.82,debit,payment,AU00000,2023-12-10T06:21:44Z
transaction,f237e8e0-b247-47db-a1f8-cee60166aaa0,posted,Payroll WFRMS 15439393,11978.09,73e583ec-e615-4d6a-8462-ac7f9ab45723,16358.91,credit,transfer,AU00000,2023-07-10T12:49:42Z
transaction,64429fda-1be3-4668-816c-ba738af7028d,posted,Hair Salon Appointment,-2164.0,e92ce8d5-7926-4018-8d10-f515b0e269a8,14194.91,debit,payment,AU00000,2023-12-15T17:36:01Z
transaction,b13a462e-c4b8-490c-be87-01d860c36f7f,posted,Payroll WFRMS 15439393,11826.48,3f532379-964b-457b-872d-bcd7a4139a4e,26021.39,credit,transfer,AU00000,2024-01-06T15:58:16Z
transaction,9ff05441-9d0b-468e-8f89-614ba182c7c2,posted,Mobile Phone Bill Payment,-1790.15,d8750428-bb35-470d-be09-6317f11c3613,24231.24,debit,bank-fee,AU00000,2024-04-20T03:25:46Z
transaction,c7040c91-4660-4834-b9aa-b6ef6e3da8ad,posted,Public Transport Fare,-2596.99,92d08c0d-99b7-46ec-9be0-ac4ff35d4a81,21634.25,debit,payment,AU00000,2023-08-20T20:38:46Z
transaction,bb0c2987-ae58-4b09-9f43-2c6927475f1f,posted,Clothing Store Purchase,-4565.7,d58b6327-16b0-42d2-8e5d-b0fb6170809e,17068.55,debit,bank-fee,AU00000,2023-07-04T13:23:08Z
transaction,153359d3-4ea6-488e-a087-b767c72f12f4,posted,Transfer Platnm Homeloan 346454,-2153.07,9306fdfc-de41-4ab6-89a2-2ea89efd703e,8279.63,debit,cash-withdrawal,AU00000,2023-09-25T22:26:34Z
transaction,2b7d3d20-e303-429a-a239-0d5e1e166d23,posted,Online Gaming Purchase,-4103.06,6c086589-5225-4778-a9b5-2a24b6e15c15,4176.57,debit,bank-fee,AU00000,2023-12-09T16:03:18Z
transaction,6a2b9823-7a21-4937-82b5-a50d954e061b,posted,Bookstore Purchase,-3407.56,74e42b65-99fa-45a0-a6a2-4ad86dc7c090,769.01,debit,cash-withdrawal,AU00000,2023-11-16T23:48:12Z
transaction,ae89c7aa-8016-4e4e-8b9c-5eb92d9491a2,posted,Hair Salon Appointment,-4518.39,8101e501-5c26-4193-bc3a-52b26f42fc50,-3749.38,debit,payment,AU00000,2024-01-09T13:48:06Z
transaction,31856ff9-5aa9-4ea7-a93e-449c9cf9ced1,posted,Home Improvement Store Purchase,-1536.88,ef883c55-d874-42a3-b565-16da08a5d631,-5286.26,debit,cash-withdrawal,AU00000,2023-10-30T22:43:15Z
transaction,d7612bd3-af8a-49f1-a7d6-df2405d4afca,posted,Music Streaming Subscription,-4515.37,3eebb291-af48-47f9-b9fa-9a24c472f243,-9801.63,debit,payment,AU00000,2023-09-15T15:39:17Z
transaction,bcecd00b-bda6-49df-8569-41f8b1183ed5,posted,Car Maintenance Expense,-4466.4,bcb0cf3a-9a04-4615-a809-e0c1fa460136,-14268.03,debit,payment,AU00000,2023-06-27T09:31:15Z
transaction,630c52ea-2e15-4e6a-8fa7-37abcb979f5e,posted,Uber Ride,-4655.01,3fcd7bcf-a70b-4624-8419-0245c7fd9b19,-18923.04,debit,bank-fee,AU00000,2024-04-11T14:54:54Z
transaction,e4e7203b-b6b9-4399-ac89-42d6dbe54866,posted,Music Streaming Subscription,-4357.01,2d0933c8-0e37-4902-95f8-bc2ba98af144,-23280.05,debit,cash-withdrawal,AU00000,2023-10-19T02:43:44Z
transaction,f41078aa-adda-431d-a7f3-30cc2a3f311e,posted,Gasoline Purchase,-2833.35,490e4993-d9b1-49d9-8748-b3ef634e1ec4,-26113.4,debit,bank-fee,AU00000,2023-06-01T05:20:00Z
transaction,d5029c69-892a-488c-bbc0-517e9fc01a71,posted,Gym Membership Fee,-2234.82,7b8839b9-5ee3-4de7-aad4-cc03285ec714,5092.23,debit,bank-fee,AU00000,2023-09-07T13:51:40Z
transaction,5f4b940f-a3f1-41e5-962c-33c4d9e15a70,posted,Clothing Store Purchase,-2392.49,8988f2ce-51d5-418e-8c11-f3f91d2f16e1,2699.74,debit,bank-fee,AU00000,2023-07-20T23:05:21Z
transaction,137381b1-d622-4808-acae-c91d8e945ba4,posted,Bookstore Purchase,-2407.8,7a09e7cc-fc9f-4d83-84a7-c2b649bd02ef,291.94,debit,cash-withdrawal,AU00000,2024-03-10T12:45:54Z
transaction,14c6a767-5b90-477a-8aca-c1645f1bf8ec,posted,CTRLINK CARERS Ref: 998R6789201610974V,-3957.87,f8fde713-3727-41a9-ab95-cca897ea7fdb,-3665.93,debit,bank-fee,AU00000,2023-07-24T04:00:49Z
transaction,30828d9a-18a8-4729-9c2f-578ec069d1d2,posted,Home Improvement Store Purchase,-2069.94,308965c3-da98-4c4f-aeab-21890c4e112e,-5735.87,debit,bank-fee,AU00000,2024-01-21T05:20:43Z
transaction,0fc4992b-a5bd-43ba-aa5c-9094d58814bf,posted,Netflix Subscription,-841.98,c4f3d394-c1c1-4780-ad40-13c29ec545ea,-6577.85,debit,cash-withdrawal,AU00000,2024-02-22T02:00:49Z
transaction,e427df9a-9f73-43b8-8cc0-533a8e097fcd,posted,CTRLINK CARERS Ref: 998R6789201610974V,-201.26,b0b45527-3967-4acc-bd7d-fe81c9df4d4e,-6779.11,debit,payment,AU00000,2023-09-14T01:38:49Z
transaction,65eca436-3d50-4800-abca-d1ff007e2d18,posted,TRANSFER TO JOANNA SMITH CAMPING,-3416.7,c0d271f3-cec0-45eb-bf0c-850b345842b6,-10195.81,debit,bank-fee,AU00000,2024-01-11T09:21:01Z
transaction,cbd22152-6f74-4f02-8389-c142e97345e4,posted,Coffee Shop Purchase,-3706.39,1c8f04bd-77cf-4082-9590-49f04a3458b3,-13902.2,debit,payment,AU00000,2023-07-22T22:45:43Z
transaction,035a0181-5a86-473f-9ea1-3efcb57abcca,posted,Uber Ride,-3778.47,3de32133-800d-43b5-b9ea-8deb91057e6c,-17680.67,debit,bank-fee,AU00000,2024-03-14T18:36:33Z
transaction,3a961f6a-2e87-4626-992c-1f0826d18ea3,posted,Bookstore Purchase,-3156.25,8963347b-2822-4d09-b12b-4a040ee9e1f7,12654.12,debit,payment,AU00000,2024-03-12T04:16:26Z
transaction,85a23aa4-d84a-4ece-8112-c410b3798ce6,posted,Restaurant Dinner,-102.34,e6110010-4aaf-4381-a0c2-8a645bff9c1e,12551.78,debit,cash-withdrawal,AU00000,2024-05-02T10:28:18Z
transaction,4ba46450-60a3-4293-8905-d7a551aee759,posted,Transfer Platnm Homeloan 346454,-604.44,42c35deb-1370-4d6e-b33f-f255666b2f64,11947.34,debit,payment,AU00000,2023-07-11T00:32:49Z
transaction,0d6fdea4-7d70-4ef9-9798-6cf8733ca6f2,posted,Bookstore Purchase,-1185.43,ca562e34-7b62-4957-bf63-06a40de4f8c4,10761.91,debit,payment,AU00000,2023-08-09T14:55:24Z
transaction,f6292079-d111-4b02-92cc-cd5c7d2b4dba,posted,Electricity Bill Payment,-3025.58,e2caf4c3-54b8-4b11-99ba-c24e52523c4a,7736.33,debit,cash-withdrawal,AU00000,2023-10-29T18:50:46Z
transaction,57af027c-20cb-4f1e-a855-b4179c61b683,posted,Public Transport Fare,-2800.33,491469e6-d709-43b4-ac7f-2220cb7ed4cb,4936.0,debit,payment,AU00000,2024-04-08T23:51:17Z
transaction,b85b0844-4de5-4e79-bb32-2623160f9523,posted,TFR Acc14000 TO 12389,-3970.69,73fdcb03-151a-4488-96ce-626115279500,965.31,debit,payment,AU00000,2024-03-31T03:07:22Z
transaction,c0694ba0-b311-4c57-b8ad-b83ec92a36b4,posted,Home Improvement Store Purchase,-19.08,94d26341-0a2d-48a1-8dca-7e1d684b22cb,946.23,debit,payment,AU00000,2023-09-28T03:07:02Z
transaction,7b27fc4a-254e-4650-b2f8-5144369bf7ae,posted,Gym Membership Fee,-265.2,2cfaf824-a8cf-4772-a0a1-0a132fd48b83,681.03,debit,cash-withdrawal,AU00000,2023-06-23T11:30:18Z
transaction,6ce9e2a4-1c4f-4d39-9d15-ccf20486679b,posted,Coffee Shop Purchase,-2590.21,acd78416-4146-4571-92ff-1d28f1214465,-1909.18,debit,cash-withdrawal,AU00000,2023-09-13T04:01:49Z
transaction,4061ee9a-6cb7-4e9e-bef4-8237221865d8,posted,TFR Acc14000 TO 12389,-1404.27,57b943b9-ebc3-4bc4-b7ab-0fbbd77642aa,6382.33,debit,payment,AU00000,2023-10-30T06:48:36Z
transaction,191ec016-574e-4d38-8823-9835f91f4c1f,posted,Car Maintenance Expense,-1924.54,7e6c6a64-aaaf-4923-a6d3-9ff53cf8df96,4457.79,debit,bank-fee,AU00000,2023-05-26T01:48:57Z
transaction,7a936da7-61aa-48ff-89f2-d44f37306bec,posted,Pharmacy Purchase,-2304.93,02792117-c259-45bf-b690-e7af768164c3,2152.86,debit,bank-fee,AU00000,2024-04-01T23:33:08Z
transaction,f675e6a6-46b7-4713-955b-f1df044611c6,posted,Online Gaming Purchase,-271.91,2031de13-9474-43a9-ab1a-be1c904a516c,1880.95,debit,bank-fee,AU00000,2024-05-02T23:31:58Z
transaction,15ac32c7-18e4-4a62-a8c1-643795e9725f,posted,Wdl ATM WESTPAC IGA BALGOWLAH BALGOWL AU,-1882.22,c5ff41a8-98d9-4d9e-af54-ca395471da4d,-1.27,debit,bank-fee,AU00000,2024-01-18T10:23:28Z
transaction,cfffa59c-18fb-4e4b-a715-c5c8fef9a3ae,posted,CTRLINK CARERS Ref: 998R6789201610974V,-4847.18,c5ea13cc-5045-4089-82e1-5e7134de7a1c,-4848.45,debit,bank-fee,AU00000,2023-11-01T13:18:24Z
transaction,a177b675-9dc5-486d-824e-ffa8bd0f9dff,posted,Pharmacy Purchase,-3356.19,40d75c4a-9979-4b4e-9e3c-5cb96356ffc2,-8204.64,debit,cash-withdrawal,AU00000,2023-05-24T06:37:08Z
transaction,7c5d2d89-efa9-405e-8453-5d39e41c8c55,posted,Bookstore Purchase,-2412.25,b86ae350-a748-4c7d-8f74-7ec69957751d,-10616.89,debit,cash-withdrawal,AU00000,2023-05-12T12:18:45Z
transaction,0b14e2d6-7492-48be-ad15-73af723b4f74,posted,Movie Ticket Purchase,-117.81,29c8e7af-68eb-4bda-a03c-60e59e9fe06b,-10734.7,debit,cash-withdrawal,AU00000,2023-08-19T07:58:32Z
transaction,43ac54fd-72a7-48e3-ae2d-6f980e3ff2c2,posted,Movie Ticket Purchase,-4949.04,b80d32b3-311d-48e6-9602-88fe77bfd8b3,-15683.74,debit,cash-withdrawal,AU00000,2023-09-30T02:37:26Z
transaction,3d66cc58-2808-4398-8c72-a7d74bb86876,posted,Coffee Shop Purchase,-4017.37,d67f6aed-1ce3-4e59-a2a0-e96a7311a327,1990.1,debit,cash-withdrawal,AU00000,2023-12-23T16:55:20Z
transaction,67d3e461-88f8-4ba2-8e8d-6ed36d0166c3,posted,Transfer Platnm Homeloan 346454,-1071.3,e500c730-a266-4e6f-b521-f01d1c6cf341,918.8,debit,cash-withdrawal,AU00000,2023-10-01T14:36:04Z
transaction,8ba41c31-ab52-47cf-beb6-4fd9be90d218,posted,Gasoline Purchase,-1867.63,2bfe4295-0806-4839-8f72-17ef4cfe041d,-948.83,debit,bank-fee,AU00000,2023-11-08T02:10:15Z
transaction,5ad0aecd-84c6-42df-9f7c-5c85e0a23fb9,posted,Gasoline Purchase,-3821.33,ee95c976-e234-4f2a-b231-65e5c38f16b5,-4770.16,debit,bank-fee,AU00000,2023-07-25T22:54:19Z
transaction,e7db954d-5c4a-436c-976f-9f25a30dc3ea,posted,Electricity Bill Payment,-3944.06,ac71b618-83d9-4f2e-bf2f-288cfb7276dc,-8714.22,debit,cash-withdrawal,AU00000,2023-11-19T10:23:47Z
transaction,16ecb671-9a86-46cf-ae0e-0202ac9b454c,posted,Online Gaming Purchase,-4427.6,cd8d50d8-59ac-4028-b209-dccefb77a6e2,-13141.82,debit,cash-withdrawal,AU00000,2024-02-03T18:25:27Z
transaction,574aa888-e7ba-4fda-9319-91d50d9c1d9d,posted,Non Hooli ATM Withdrawal Fee,-3630.24,2bf57430-c4ce-4fca-b5f3-3aea8f0c8d87,-16772.06,debit,payment,AU00000,2023-05-14T12:26:49Z
transaction,f7cf7a98-4685-4fdd-847c-bec4d6cacf23,posted,Electricity Bill Payment,-28.78,6162aefc-2129-4620-8065-14834e998b0d,-16800.84,debit,payment,AU00000,2023-07-24T15:08:25Z
transaction,93f98db2-4e98-4ca5-8686-6b8234e4dfb8,posted,Wdl ATM WESTPAC IGA BALGOWLAH BALGOWL AU,-1174.92,110471ed-1980-4149-bd78-49f5419f63de,-17975.76,debit,payment,AU00000,2023-11-25T06:48:09Z
transaction,caf5e90c-a8d6-4796-927a-380203841269,posted,AGL RETAIL ENERGY LTD (GAS),-4295.04,bdfa8324-52fe-4d07-8aff-6663238c6c28,-22270.8,debit,payment,AU00000,2023-06-17T22:36:35Z
transaction,0fef9930-4fab-452e-9236-20acf4d60e09,posted,Uber Ride,-3962.14,34accf99-a37e-41ee-8d69-7026eb30c021,11500.43,debit,cash-withdrawal,AU00000,2024-04-04T05:20:37Z
transaction,527c91f3-6e01-4c12-afdf-39e7d927d878,posted,Gym Membership Fee,-476.95,b40137c5-bea7-4a71-8b21-58d4d412421d,11023.48,debit,cash-withdrawal,AU00000,2023-11-19T09:34:31Z
transaction,2dd8ed3b-59b8-4dec-a3d5-56441c6d9629,posted,CTRLINK CARERS Ref: 998R6789201610974V,-1666.94,25592727-9ef4-4b4b-b308-c9e0e73a03c1,9356.54,debit,bank-fee,AU00000,2023-11-19T02:31:23Z
transaction,4a14d3bf-1d63-40e9-a91d-36e1ece140cb,posted,Clothing Store Purchase,-3131.67,6e83b062-03bc-45bd-87a3-c9b9e41b03b7,6224.87,debit,payment,AU00000,2023-12-20T15:39:15Z
transaction,c919114a-f0da-4930-9e03-fcf8da56f7ea,posted,Pharmacy Purchase,-26.9,7b0e76f2-ccdd-4e78-9d76-79bc14108e0d,6197.97,debit,payment,AU00000,2023-06-03T21:38:14Z
transaction,eead4ca9-5b47-448b-9095-a4353805cde4,posted,Netflix Subscription,-2714.27,a640b758-5116-466c-8d70-6102a2afcf81,3483.7,debit,cash-withdrawal,AU00000,2023-07-06T20:00:14Z
transaction,6454fef8-44e5-4422-87f0-9b5941736fee,posted,Movie Ticket Purchase,-616.57,7defd762-df01-4640-abfa-ca686bccbeb2,2867.13,debit,cash-withdrawal,AU00000,2023-07-13T01:24:28Z
transaction,d4bd6535-d522-4aaf-ad40-f39de5a62fdf,posted,TRANSFER TO JOANNA SMITH CAMPING,-1645.16,6f3dfa1e-ae03-49cc-b52e-1077d226b100,1221.97,debit,bank-fee,AU00000,2024-04-22T00:13:38Z
transaction,89ee70fc-bf69-4188-8a47-968d8c0830f7,posted,Hair Salon Appointment,-509.3,95555b7f-54ac-4734-aed0-38ace8790fc8,712.67,debit,bank-fee,AU00000,2023-09-23T12:23:07Z
transaction,000586bd-e34f-49f4-8339-fca686c792fe,posted,Wdl ATM WESTPAC IGA BALGOWLAH BALGOWL AU,-3581.18,e1867565-53d9-4ff1-bfe8-036563696e8d,-2868.51,debit,cash-withdrawal,AU00000,2023-12-13T12:59:35Z
transaction,d0552cc4-0419-4d40-89b8-7d0e4e3ba645,posted,Car Maintenance Expense,-2574.45,2bcd0960-bd7a-40f0-ab08-16533ef96c78,4466.67,debit,payment,AU00000,2024-02-28T21:02:38Z
transaction,96bc02cb-f127-4ce9-ad7d-49626060c025,posted,Uber Ride,-4250.29,318c2e9e-8d0e-4678-b71f-f806f540a6e1,216.38,debit,cash-withdrawal,AU00000,2023-10-28T02:08:51Z
transaction,4b1756d7-aea1-4527-880c-92b2a4b0a406,posted,Electricity Bill Payment,-60.8,28534b06-f8a2-4dbd-ad7c-e6c8138ff8c5,155.58,debit,cash-withdrawal,AU00000,2024-03-26T09:13:17Z
transaction,c2dcef8e-59e3-4ab7-9753-b4405506805b,posted,TRANSFER TO JOANNA SMITH CAMPING,-2006.23,4832ec6f-8c32-4171-beeb-2f3f4b9035a1,-1850.65,debit,bank-fee,AU00000,2024-02-04T02:48:35Z
transaction,5e46a27d-9c72-49e0-9092-9735cadf7cbb,posted,Manly Maths Tutor Wages,-2491.4,76e311cb-6878-4a6e-ad76-0416e7416c93,-4342.05,debit,cash-withdrawal,AU00000,2023-12-30T06:32:10Z
transaction,3038871b-082e-4727-9358-98b323cb832e,posted,TFR Acc14000 TO 12389,-124.45,4f4d51e6-4c2e-4a60-bcd2-c3263cfe4ecc,-4466.5,debit,cash-withdrawal,AU00000,2024-05-10T03:21:35Z
transaction,938d8bcd-1d02-428a-bc1b-2b0bfcaeb843,posted,Gasoline Purchase,-3404.69,0c900757-8a06-450b-98a0-c02e456ee6c6,-7871.19,debit,payment,AU00000,2023-06-22T05:17:34Z
transaction,11e93fc2-6ba4-49f3-98a0-c3d1b1ca7940,posted,Travel Agency Booking,-2064.66,fdec23cb-99b1-45d8-a1d5-c9ff5b0257a9,-9935.85,debit,bank-fee,AU00000,2024-01-31T14:56:59Z
transaction,942bb2d7-711c-4f33-b026-b40c06ca62fe,posted,Public Transport Fare,-2371.34,c9e213dc-8bad-4c86-9058-9548d4c6a546,-12307.19,debit,bank-fee,AU00000,2023-12-06T05:13:04Z
transaction,3a17f9e5-0c14-4952-ba42-e7a970d3e4ad,posted,Amazon Online Shopping,-1732.99,e0481da0-4e11-41ed-8573-d3fc95472eb7,-14040.18,debit,cash-withdrawal,AU00000,2023-10-07T14:49:06Z
transaction,f42bdeb9-354c-461c-9c97-b1a93539c095,posted,Public Transport Fare,-1159.31,8e397526-ccb1-4fa3-be3a-9a225b42b81c,11101.44,debit,bank-fee,AU00000,2023-10-26T07:02:23Z
transaction,f4b8ac4b-d3ac-4eca-ab1f-037964e34eea,posted,Manly Maths Tutor Wages,-4492.06,27ae4cd0-cfe1-4b16-b979-1da79c9ddf57,6609.38,debit,cash-withdrawal,AU00000,2023-07-29T07:42:29Z
transaction,10d26285-3a1e-43f7-b00e-95f2812d3935,posted,Hair Salon Appointment,-4797.21,e53a3163-837f-4e19-9d69-01e006d2a406,1812.17,debit,payment,AU00000,2023-06-02T01:40:59Z
transaction,c5eb7fff-e725-45fa-a8e9-32dd6077e549,posted,Home Improvement Store Purchase,-87.53,5f4d07ed-a52d-4803-b41a-7b9f3bb0c5d6,1724.64,debit,cash-withdrawal,AU00000,2023-10-14T08:02:46Z
transaction,ad28be3b-a7e3-4e2b-9c30-a5e0c1cc9313,posted,Non Hooli ATM Withdrawal Fee,-4665.44,973d48ac-6239-4e28-976f-5de6e6678a0d,-2940.8,debit,bank-fee,AU00000,2023-09-11T08:59:44Z
transaction,fa106936-0222-4e00-801c-367d2db76609,posted,Uber Ride,-1964.11,647e2ae3-fb50-47a3-b65a-05ab5f4f1e26,-4904.91,debit,cash-withdrawal,AU00000,2023-11-29T21:40:40Z
transaction,56b431ca-6748-4a01-9156-b0664316616a,posted,Non Hooli ATM Withdrawal Fee,-4204.54,33040148-07af-4ec7-a0aa-23cd3da31d96,-9109.45,debit,payment,AU00000,2024-01-13T07:10:59Z
transaction,7f4235e8-05bb-4556-9107-4572bd1d0a70,posted,Coffee Shop Purchase,-2956.09,4365d458-db09-4534-bf8f-d7876de5c6db,-12065.54,debit,payment,AU00000,2023-07-12T04:02:04Z
transaction,e2b04213-6d3d-4ba1-89bb-52097fd36e21,posted,TRANSFER TO JOANNA SMITH CAMPING,-626.55,7e96d372-86fe-46d4-ae56-b39b848357ba,-12692.09,debit,payment,AU00000,2024-02-12T11:26:44Z
transaction,1b1bfa6a-cd73-471d-af84-268a90279ca1,posted,Amazon Online Shopping,-967.68,409e8e55-3487-4994-8366-6136b9b80a5e,-13659.77,debit,payment,AU00000,2024-01-04T20:51:11Z
transaction,fcc36886-48d8-459a-9728-d8f3804546ac,posted,Public Transport Fare,-3742.04,17b2dd0e-c0ae-4289-93cc-ffa3d5d2db16,12701.35,debit,payment,AU00000,2024-01-09T19:29:14Z
transaction,03e61ef3-7afb-4c30-a24a-b7336c17f997,posted,Transfer Platnm Homeloan 346454,-382.31,f050addb-4e33-42c8-98de-623112a028d2,12319.04,debit,bank-fee,AU00000,2024-04-06T17:22:43Z
transaction,cd6bdbbb-8b1e-48fd-9699-63888ee92a80,posted,TFR Acc14000 TO 12389,-736.17,7f692fd6-3933-461a-8940-632eac2263e5,11582.87,debit,cash-withdrawal,AU00000,2024-01-08T23:33:19Z
transaction,a0f1c1db-839a-4ae3-998c-7ee4083367fe,posted,Payroll WFRMS 15439393,11661.89,7b02f23d-d128-4170-b7fa-cad759f101ec,23244.76,credit,transfer,AU00000,2023-10-23T05:25:43Z
transaction,0bdd920e-0be7-4bdc-90cb-6435bf7e8399,posted,TRANSFER TO JOANNA SMITH CAMPING,-2018.74,e2de13ac-6fad-475c-b41c-4dd2c794093f,21226.02,debit,payment,AU00000,2023-05-26T07:49:57Z
transaction,2c1e2ac8-73d9-46f2-9fcd-e1d70ed5f3c5,posted,Uber Ride,-774.01,c76c4598-46c2-40d4-95db-ee60608e01fd,20452.01,debit,bank-fee,AU00000,2024-01-14T08:44:36Z
transaction,2594a37b-96c2-4156-a5f9-221e5ba24c11,posted,Non Hooli ATM Withdrawal Fee,-3690.13,de3618f8-4151-478e-b4d6-e39d88950192,16761.88,debit,payment,AU00000,2023-11-03T12:16:36Z
transaction,c65e83af-63e4-4c06-a26f-2c60dcc1bea9,posted,Pharmacy Purchase,-2689.7,a1a78507-c8b7-4541-abab-66b87c79db9a,14072.18,debit,payment,AU00000,2024-05-07T14:15:21Z
transaction,a78bee1e-4acd-42db-8b3c-3ee7da3224cf,posted,Uber Ride,-1806.02,a87a82db-f75b-47ab-9892-397759e2f51b,12266.16,debit,payment,AU00000,2024-01-20T09:11:40Z
transaction,75718e8c-88cd-4aa7-b19c-9fb169b1faf4,posted,Clothing Store Purchase,-810.9,166fc219-56f1-4780-9162-d0d336de3ee2,11455.26,debit,bank-fee,AU00000,2023-06-30T23:22:22Z
transaction,05e534f4-bf48-4ec7-96c8-f92e12d79b52,posted,Clothing Store Purchase,-1892.06,c32c30cb-ae37-432d-8f4b-bec78b11cee0,15317.29,debit,bank-fee,AU00000,2024-04-15T18:33:18Z
transaction,ad4fd616-fecd-4cc3-a749-6f919b07342f,posted,Clothing Store Purchase,-698.45,5948e233-1530-4d84-9f3c-f448525373e5,14618.84,debit,bank-fee,AU00000,2023-12-13T21:51:19Z
transaction,b9010bc1-2ba1-4b5b-a688-8b54cc2fefe9,posted,Movie Ticket Purchase,-3319.54,313b2c65-16fd-4b31-9542-15c7719cf7e0,11299.3,debit,bank-fee,AU00000,2023-05-17T08:03:48Z
transaction,022b7a22-f743-4bed-8631-712bd881ee9a,posted,Public Transport Fare,-840.3,c59a6a4f-0137-4706-bd5d-563d8bb2f963,10459.0,debit,bank-fee,AU00000,2024-03-11T16:41:56Z
transaction,c9cfd840-7998-4a0d-b9f3-3ce425619eea,posted,Home Improvement Store Purchase,-1836.17,04d431ed-a2c5-4896-9f6e-7e567ce0527d,8622.83,debit,bank-fee,AU00000,2024-01-10T00:14:53Z
transaction,6f24ec60-11ea-4032-8ec1-f0ea0ee45375,posted,Payroll WFRMS 15439393,11604.58,48d5e03e-6df7-470f-88bf-efe9b459924e,20227.41,credit,transfer,AU00000,2023-12-23T07:58:29Z
transaction,e39dca22-7fa6-4e46-95b8-14e4053a380e,posted,Online Gaming Purchase,-1424.57,40480df6-29f2-4748-bcfb-4b6b506e1423,18802.84,debit,bank-fee,AU00000,2024-01-26T08:41:28Z
transaction,10e86754-c4cc-447e-9b3b-df3622968688,posted,Mobile Phone Bill Payment,-2605.35,0357f04b-91e0-4e18-bc4b-f7cfe7d21b4b,16197.49,debit,payment,AU00000,2023-07-04T14:22:01Z
transaction,6149dc35-f3cd-487f-b42f-12e8e8d23f02,posted,Restaurant Dinner,-4398.81,f99d3bcd-24f8-412c-b140-5f367f17f72f,11798.68,debit,bank-fee,AU00000,2024-02-23T09:35:00Z
transaction,3e2e98dc-b113-4f0f-92c9-dd4b9f36cc28,posted,Pharmacy Purchase,-4425.93,6e17a512-783a-47af-8977-6efaa6740ea0,7372.75,debit,cash-withdrawal,AU00000,2023-12-27T04:45:29Z
transaction,22a326ba-71e7-45da-8672-44252c048764,posted,Wdl ATM WESTPAC IGA BALGOWLAH BALGOWL AU,-1733.56,c220dba8-7863-4cff-95a9-ef4c59e23991,10302.26,debit,bank-fee,AU00000,2023-07-17T21:58:50Z
transaction,a778093b-8a2b-4109-9940-a8f18080aa28,posted,Clothing Store Purchase,-3177.25,f1766a47-366f-4739-8a71-637006e98302,7125.01,debit,payment,AU00000,2024-04-01T18:04:39Z
transaction,e2472a2e-b749-4033-9587-27f5d5e44f99,posted,Pharmacy Purchase,-4604.66,f2a2b777-3329-4666-ae8b-324f515d0e9a,2520.35,debit,cash-withdrawal,AU00000,2024-04-15T02:45:29Z
transaction,85f469da-2b27-4dbe-a663-45f2498c4075,posted,TRANSFER TO JOANNA SMITH CAMPING,-4198.79,d7f9e041-3998-4c11-a4f0-77eab13cb538,-1678.44,debit,bank-fee,AU00000,2023-07-19T08:20:59Z
transaction,64b6477a-b620-4a61-945d-92aaae89d3fb,posted,Hair Salon Appointment,-74.77,197e3bc6-6d72-4a0b-9ddd-6ed1d085eed9,-1753.21,debit,bank-fee,AU00000,2023-11-01T12:01:09Z
transaction,0dff2010-d665-45aa-94b5-b3c38d42efd8,posted,Online Gaming Purchase,-2660.2,d82ea8fe-2b4a-4b98-91b1-a9d459d1208c,-4413.41,debit,payment,AU00000,2023-10-01T10:48:57Z
transaction,032e59c0-5ea5-4c88-81ba-e9f5cddcb115,posted,Clothing Store Purchase,-975.29,cd3f6b78-c31f-4ee5-a496-9c1dbdda535f,-5388.7,debit,cash-withdrawal,AU00000,2023-08-30T18:24:18Z
transaction,e3a6161d-c274-47a8-8865-de6a63d0e11a,posted,Non Hooli ATM Withdrawal Fee,-917.72,092ee780-80ef-4489-a205-30cd6041b780,-6306.42,debit,cash-withdrawal,AU00000,2024-02-05T10:38:57Z
transaction,fd870594-ec97-4d15-aa9e-038b55e8314e,posted,Hair Salon Appointment,-4260.95,2450a7e9-7a3f-46a2-8ae8-a7a772b262c2,-10567.37,debit,cash-withdrawal,AU00000,2024-04-19T23:48:00Z
transaction,fb90f144-be23-4db0-9921-040bdcd8485d,posted,Hair Salon Appointment,-1222.0,be7583f0-2afe-40ed-ad92-0787b4befee1,-11789.37,debit,payment,AU00000,2024-03-06T20:06:50Z
transaction,e5e47a0d-3013-4197-b8e3-af2e559ded3f,posted,Restaurant Dinner,-4873.03,9e753649-1055-41e2-a23d-2c42bac6a4f2,9634.99,debit,cash-withdrawal,AU00000,2023-06-07T13:57:16Z
transaction,cc2f556e-3ef6-4f27-944b-a0fd30173a36,posted,Manly Maths Tutor Wages,-1180.6,6dbd4aee-e54f-4ad1-a006-e74d9300e2bc,8454.39,debit,bank-fee,AU00000,2024-04-10T09:08:37Z
transaction,0e0a2f03-740f-444e-b597-7a999d769a6a,posted,Non Hooli ATM Withdrawal Fee,-1697.32,d3545873-bd7a-41d0-a0b8-08f13a31d669,6757.07,debit,payment,AU00000,2023-09-21T01:20:46Z
transaction,b737e1af-f2a8-4e7c-8ebe-1ed3f989e6c5,posted,TRANSFER TO JOANNA SMITH CAMPING,-3537.34,c41d56b0-3d1b-4706-a7e6-81d8b9354606,3219.73,debit,payment,AU00000,2023-06-20T20:13:38Z
transaction,0ccadc14-ffed-4bf3-918d-76345a4611ad,posted,Home Improvement Store Purchase,-2008.1,cfdbc4f0-3802-426d-9819-0006ec885a99,1211.63,debit,cash-withdrawal,AU00000,2023-08-11T00:24:10Z
transaction,0134aaee-ec70-4857-9d74-439f289f217e,posted,Transfer Platnm Homeloan 346454,-203.22,cabe84f9-0212-48f3-afab-1b8af9e621b3,1008.41,debit,payment,AU00000,2023-10-21T00:18:28Z
transaction,bf00540b-f04d-4bfc-b83a-b225938481dd,posted,Gym Membership Fee,-3161.31,e045a80f-77ad-4eb7-bb3e-b6e9515f73ab,-2152.9,debit,bank-fee,AU00000,2024-02-01T16:10:41Z
transaction,46ea6e0b-cf74-4ce8-8510-661683dd7559,posted,Netflix Subscription,-3105.75,6b40b80a-1be7-4931-b492-99fe9bc55df1,-5258.65,debit,bank-fee,AU00000,2024-02-01T16:24:23Z
transaction,75e3fcb0-373e-4db7-90ed-ca95e7f0f1ad,posted,Coffee Shop Purchase,-1257.9,b7b6eaba-36de-4a77-aeba-36c191d346f3,-6516.55,debit,cash-withdrawal,AU00000,2023-08-13T00:48:03Z
transaction,54d8f11b-10d2-4438-a8ef-78bca12ba54b,posted,Mobile Phone Bill Payment,-4025.41,b9297c96-2a6d-4648-9fdd-07f46cf41cad,-10541.96,debit,payment,AU00000,2023-05-26T22:05:27Z
transaction,75746780-b6b2-4573-ba22-937d1e7d6bc9,posted,AGL RETAIL ENERGY LTD (GAS),-1295.33,389a4620-c0a8-4d84-9011-62e9c29b3e6f,3774.77,debit,bank-fee,AU00000,2024-03-16T11:09:37Z
transaction,1c564af0-c7ea-4961-b277-b48b12313bbf,posted,Amazon Online Shopping,-2346.52,c0134da8-da44-4863-8a7f-bf379f355c1a,1428.25,debit,payment,AU00000,2023-10-08T01:13:25Z
transaction,105ce9e0-2405-4737-9638-1497af742267,posted,TRANSFER TO JOANNA SMITH CAMPING,-30.78,64283e28-5bd1-44b4-9ebc-61486a102c4d,1397.47,debit,bank-fee,AU00000,2024-03-22T21:08:15Z
transaction,737801c9-2460-49c0-be90-f8c6f7f4d2b5,posted,Car Maintenance Expense,-2570.48,496d60ca-c2ef-4b2f-8d06-613419f6e2e4,-1173.01,debit,cash-withdrawal,AU00000,2023-07-31T03:31:55Z
transaction,b08dc0a7-cb18-41f8-8fc6-4a62fc69a28b,posted,Restaurant Dinner,-4941.64,717d07e2-f2d6-4021-9587-05321366b9f7,-6114.65,debit,payment,AU00000,2024-01-14T22:45:45Z
transaction,d41cd395-bbf4-4a50-9c06-1011be2e8194,posted,Bookstore Purchase,-386.57,3d3916e1-d2da-466d-b540-4918f7df11ab,-6501.22,debit,bank-fee,AU00000,2023-08-28T20:46:57Z
transaction,23ffe6eb-df38-4678-8d5a-2eaebd3f22e5,posted,Public Transport Fare,-1544.46,c7d9e22a-f989-47b4-86af-2e23dae8e57d,-8045.68,debit,bank-fee,AU00000,2023-05-22T04:54:02Z
transaction,130414de-89af-4615-97a8-3c17682a3bee,posted,AGL RETAIL ENERGY LTD (GAS),-160.72,dfdf718e-92e5-436a-b08e-5ad8cac31499,-8206.4,debit,bank-fee,AU00000,2023-09-10T23:53:41Z
transaction,9c786232-ab96-4f3d-a982-a224e326c365,posted,Bookstore Purchase,-3934.7,f94631f3-3008-4ef0-8cde-35189b110d6e,-12141.1,debit,bank-fee,AU00000,2023-08-25T04:50:45Z
transaction,84927954-cf7a-4ffd-b690-f905e953876b,posted,AGL RETAIL ENERGY LTD (GAS),-2666.15,567c1d19-e67e-4843-b88c-4c3d99e8dd41,-14807.25,debit,bank-fee,AU00000,2023-11-10T20:16:23Z
transaction,e32280fc-d3ec-4f40-a0e8-8f2a863486d5,posted,Car Maintenance Expense,-1577.01,3bf13c6c-ce55-483c-b14e-cd56e6b0006a,6244.33,debit,cash-withdrawal,AU00000,2023-09-22T19:13:14Z
transaction,42c52a33-761c-45a1-b0da-254860527e23,posted,Wdl ATM WESTPAC IGA BALGOWLAH BALGOWL AU,-1712.67,1e9e025e-cca0-46b4-af5c-a36194178708,4531.66,debit,cash-withdrawal,AU00000,2023-06-16T06:25:34Z
transaction,81026060-6f5f-4162-91fe-3338058db786,posted,Non Hooli ATM Withdrawal Fee,-1453.49,23fade6f-6e75-4133-b3a1-24f2a72b28c8,3078.17,debit,payment,AU00000,2024-01-10T18:32:23Z
transaction,e22f75f8-67c1-4351-adeb-6fce0112f51f,posted,Netflix Subscription,-2400.29,f8174002-7025-4ca1-b7c5-6172ab36c28f,677.88,debit,bank-fee,AU00000,2024-02-27T23:43:41Z
transaction,6bd7ea40-5135-4640-9650-f8ecab31ef3c,posted,Netflix Subscription,-3374.71,6cc5b8c4-343d-43c1-b4d8-2d542905bd9a,-2696.83,debit,payment,AU00000,2023-06-13T18:12:19Z
transaction,162ec18b-5655-4cc1-b8d9-04963d0cd210,posted,Public Transport Fare,-2983.98,38434a58-02c0-43cd-939b-edb4239d0857,-5680.81,debit,cash-withdrawal,AU00000,2023-09-17T01:31:16Z
transaction,f5007dcb-6dde-452c-9a13-369cfbfbaa9d,posted,Hair Salon Appointment,-816.15,650adac7-7a01-4d1a-a209-9d9bd94a866f,-6496.96,debit,cash-withdrawal,AU00000,2023-06-30T00:31:46Z
transaction,774ea3db-8469-42e4-80a7-48c21314ec60,posted,Public Transport Fare,-3071.3,06eb170e-532f-474d-81ed-dfd0bd855963,-9568.26,debit,payment,AU00000,2023-10-06T12:45:50Z
transaction,1757b334-ff69-4530-b642-ba2289ae7277,posted,Pharmacy Purchase,-3768.56,8f9e0182-a66d-4b89-83b7-77851cb3b04c,-13336.82,debit,bank-fee,AU00000,2024-01-13T18:03:09Z
transaction,79faae47-ae61-452d-80d6-3460f667f448,posted,CTRLINK CARERS Ref: 998R6789201610974V,-4230.57,49b65caa-b19d-4353-9419-ed3e9081972a,-17567.39,debit,cash-withdrawal,AU00000,2024-01-19T01:26:31Z
transaction,7fdb4da2-5720-4e8d-adea-b216bf33fc1a,posted,Gym Membership Fee,-57.73,557816df-30a8-4bd6-bf5f-68b07c00e340,16578.94,debit,payment,AU00000,2024-04-09T13:50:33Z
transaction,9f2fbb5a-a6c2-4191-931f-a35dd545e300,posted,Pharmacy Purchase,-2921.33,cc4a1667-606f-4629-8786-80939527ac67,13657.61,debit,bank-fee,AU00000,2024-04-27T00:09:16Z
transaction,c18da524-e9f9-4605-bfee-32572c5d6473,posted,Clothing Store Purchase,-4219.68,6714aace-a704-4a80-bd7f-e8b9ac42849c,9437.93,debit,cash-withdrawal,AU00000,2023-12-30T00:33:59Z
transaction,b30cb0df-0847-4fd7-9fde-c9bbff22a162,posted,Electricity Bill Payment,-1334.57,287c2b4d-922d-4638-b210-ac3233972869,8103.36,debit,payment,AU00000,2023-10-11T22:52:16Z
transaction,1cbece2c-663f-4f2e-992e-478889d3233f,posted,Car Maintenance Expense,-1005.29,bfad8b8e-dd86-430f-8037-c3db0f91383c,7098.07,debit,payment,AU00000,2023-10-14T11:16:49Z
transaction,077e557c-4948-4a8d-a159-4eeceeaffc61,posted,Restaurant Dinner,-2374.54,90099b96-489c-457f-ab25-792837c3b74d,4723.53,debit,bank-fee,AU00000,2023-06-07T08:00:47Z
transaction,ccec1115-f4fe-4899-b262-23374ac7f4b7,posted,Coffee Shop Purchase,-3509.09,81970cc0-e8d1-469b-b58f-1bf4f40bbc9f,1214.44,debit,payment,AU00000,2024-04-05T19:07:45Z
transaction,20ff5ae5-2b72-4593-9e6b-1b339b4bbd66,posted,Movie Ticket Purchase,-3773.65,77409054-6e59-4a74-a085-b9f20a453603,-2559.21,debit,payment,AU00000,2023-11-18T13:29:12Z
transaction,1309a2b0-25e6-4204-981a-0493552d0ebe,posted,Travel Agency Booking,-1306.24,04d4babd-e28c-44af-b90f-2d088253978c,-3865.45,debit,cash-withdrawal,AU00000,2023-05-28T10:32:11Z
transaction,590192b5-fc87-4c5c-8f37-c6f2272adf8d,posted,Home Improvement Store Purchase,-4507.39,b042c7d0-cc08-419c-bd30-579004d9bc29,-8372.84,debit,bank-fee,AU00000,2023-11-08T23:15:39Z
transaction,82b2c6f6-54c3-4910-9e60-95e155f98fef,posted,Hair Salon Appointment,-4204.07,5b8b5182-ad4c-4f14-84f0-a77a0c8eb3c0,13138.69,debit,cash-withdrawal,AU00000,2023-10-04T02:42:46Z
transaction,074064eb-658e-4779-b59b-df3aff90e2e2,posted,Amazon Online Shopping,-3461.45,e3377a5c-dca4-401e-8f97-95afa3f060c5,9677.24,debit,bank-fee,AU00000,2024-02-01T00:00:44Z
transaction,6ac66ce4-dbdb-4bf6-93b3-68f8d3a66536,posted,Travel Agency Booking,-878.61,aba8a17c-5b3a-425b-a2c7-6378008a66c8,8798.63,debit,bank-fee,AU00000,2023-09-08T04:27:05Z
transaction,f154a7a4-45ca-479e-84e0-8ba28e2c7440,posted,Manly Maths Tutor Wages,-869.08,f8707308-72dd-4e02-9643-c9ea8e306df1,7929.55,debit,cash-withdrawal,AU00000,2023-06-16T09:50:05Z
transaction,be714ac5-4e70-48dd-a2dc-43e06a298ce3,posted,Online Gaming Purchase,-2705.51,e2cc8e46-961f-4cf6-b8a7-36e8201285e1,5224.04,debit,cash-withdrawal,AU00000,2024-03-15T18:47:36Z
transaction,5b836474-688c-4ca4-a518-6bf57fac1297,posted,Uber Ride,-2185.02,9b73c0ab-6442-4a0b-b8da-08821e1e17f5,3039.02,debit,payment,AU00000,2023-12-27T04:36:09Z
transaction,477aeb3b-6efb-4aca-a330-6bb468949818,posted,Gym Membership Fee,-745.86,251b677d-de26-4ac9-9726-699a4aac2e20,2293.16,debit,cash-withdrawal,AU00000,2024-03-13T14:37:17Z
transaction,a011ce19-efe5-4673-8812-67f2ca8e8a6e,posted,Movie Ticket Purchase,-130.81,24dc496d-56d9-4d55-8159-0cd546488371,2162.35,debit,payment,AU00000,2023-07-03T22:49:34Z
transaction,4a4a855d-46b3-4277-a188-40ae2835b0a8,posted,Hair Salon Appointment,-1352.13,ac0754d1-df6f-4870-bb71-ab7be9736021,810.22,debit,payment,AU00000,2023-06-18T05:54:48Z
transaction,ae1d7170-4f0b-4c76-bc91-7a48a9bd4a70,posted,Car Maintenance Expense,-3902.58,57d44675-78c7-435d-942b-90c164b47985,-3092.36,debit,bank-fee,AU00000,2023-07-19T03:57:34Z
transaction,279de245-f74e-44b5-ac8b-f1898e46745a,posted,Home Improvement Store Purchase,-2017.55,4d8644f7-1574-421c-952a-be01d2f9ae68,12316.18,debit,payment,AU00000,2024-01-30T07:18:35Z
transaction,9332a80c-bd05-4c54-bb15-5e10c6dede04,posted,Bookstore Purchase,-181.88,fbec924d-6120-4a43-afb9-3e32f466a778,12134.3,debit,cash-withdrawal,AU00000,2023-09-02T14:08:45Z
transaction,f8e74b46-1656-46ad-9f98-0308726fcde0,posted,Travel Agency Booking,-3235.12,c8cdd675-6970-44ac-a589-75f414a38ebb,8899.18,debit,bank-fee,AU00000,2023-06-23T19:10:28Z
transaction,23784b02-b464-4abf-afe8-593ba6ae9727,posted,Clothing Store Purchase,-4804.71,df8b9652-408b-4b00-9520-163e24e4c208,4094.47,debit,bank-fee,AU00000,2024-02-24T15:04:31Z
transaction,fae6accf-1f77-4f95-aa65-8ed7acb313e1,posted,TRANSFER TO JOANNA SMITH CAMPING,-2789.83,acd9ce24-1d6e-4ce4-b51c-e794182616b4,1304.64,debit,bank-fee,AU00000,2024-03-17T11:47:42Z
transaction,3f8d34a4-568a-4ac7-8448-a6a1468c90dc,posted,CTRLINK CARERS Ref: 998R6789201610974V,-3880.27,694e7216-15d0-47e0-a733-cf4df3481b60,-2575.63,debit,payment,AU00000,2024-03-18T20:48:18Z
transaction,794cc4db-2265-47df-9413-8e57e58fc5ac,posted,Bookstore Purchase,-3533.32,4129c21d-3db2-49bf-9823-4951d94b225a,-6108.95,debit,payment,AU00000,2024-05-03T22:21:37Z
transaction,78e00557-324c-4d43-bfa5-cadc4c19cb9c,posted,TFR Acc14000 TO 12389,-3470.27,6fcc2341-77d1-4ea0-8659-1eac8d586e08,-9579.22,debit,bank-fee,AU00000,2023-11-06T00:44:25Z
transaction,2b80a402-5d6c-4cdf-b22d-dd450a349118,posted,Amazon Online Shopping,-3474.17,c5ce214a-cbc4-4ec8-be69-f18cc411363e,-13053.39,debit,payment,AU00000,2023-12-18T21:11:18Z
transaction,032b30ea-76ed-42d4-b6d7-086634d18a9a,posted,Clothing Store Purchase,-1499.07,03f58f5d-6532-422d-a7ad-ae339db0d810,-14552.46,debit,payment,AU00000,2024-03-31T17:26:59Z
transaction,8ca90209-c4eb-4dfd-886c-6fed89dc040c,posted,Netflix Subscription,-114.45,ca99b1ee-2063-43bd-97ee-4e4680fc3def,12238.25,debit,payment,AU00000,2023-08-16T08:10:35Z
transaction,1f9b596d-316d-4fa0-83d9-abd7c63c05ac,posted,Car Maintenance Expense,-198.68,9b44eb27-49b6-4e9c-98bc-abd359a863ab,12039.57,debit,payment,AU00000,2023-11-10T12:27:58Z
transaction,83213ef2-c6b0-44be-b391-43ccee50febc,posted,Public Transport Fare,-2647.79,ed803772-e4ee-4886-905f-3bd6fe4b9dc2,9391.78,debit,payment,AU00000,2024-02-13T21:27:32Z
transaction,65d4db05-29fb-4183-82f6-58a28a1d0461,posted,Netflix Subscription,-1567.51,59b27f1c-d4cb-4651-bf0b-7695aae83b3f,7824.27,debit,cash-withdrawal,AU00000,2023-06-08T16:02:38Z
transaction,bb3be598-6845-4e46-bbe7-6db6981ca01f,posted,Wdl ATM WESTPAC IGA BALGOWLAH BALGOWL AU,-829.36,8289ef3e-84e4-409f-b84e-1681ab08eee6,6994.91,debit,cash-withdrawal,AU00000,2024-03-04T22:59:34Z
transaction,281f7ee5-36b9-4a98-a199-acdcc6e4b7c2,posted,Home Improvement Store Purchase,-943.25,82222876-d614-4d93-b4ec-0939503305cc,6051.66,debit,bank-fee,AU00000,2023-07-27T11:27:56Z
transaction,9853b626-cdcf-4ca8-ac81-a7c8ea29688f,posted,Hair Salon Appointment,-4690.03,57ceb91c-c5a8-431f-80c8-ebfbb7c3ff0a,1361.63,debit,cash-withdrawal,AU00000,2023-06-04T22:35:37Z
transaction,dd9a7f76-bb55-40eb-8586-df32a662994e,posted,Clothing Store Purchase,-110.89,5bf31782-5586-4218-830b-0f53fd64ce43,1250.74,debit,payment,AU00000,2023-06-25T02:30:59Z
transaction,833c4e2a-b281-4adb-ac95-922ff23edd46,posted,Restaurant Dinner,-3676.71,8c42745e-51a0-4df3-8a65-91a4679f13d9,-2425.97,debit,cash-withdrawal,AU00000,2023-12-16T08:33:34Z
transaction,7d227fc1-5a7c-4a20-802b-5745ff2317e0,posted,Netflix Subscription,-39.7,06c7d438-ff40-47f1-8d96-2ba832463096,-2465.67,debit,bank-fee,AU00000,2023-10-19T03:39:50Z
transaction,77b086af-1cf3-4f78-a7fa-76c358ea1b2f,posted,Coffee Shop Purchase,-4717.94,eb96042d-1f1d-411e-bae7-29fc302cd77f,1220.03,debit,payment,AU00000,2023-09-03T09:05:17Z
transaction,8b08afd7-f787-4692-9049-0173821f6c11,posted,Clothing Store Purchase,-271.02,fd857e11-3a2a-4d99-adad-db4bf7c0e59b,949.01,debit,cash-withdrawal,AU00000,2023-10-08T10:46:39Z
transaction,41aae9fb-2d7f-4443-b0c3-acb884bf9319,posted,Home Improvement Store Purchase,-4011.37,9ba1cde9-d9e4-4992-8522-c5c61549c4bd,-3062.36,debit,bank-fee,AU00000,2023-11-02T14:43:18Z
transaction,43d8f169-a2bb-49d5-936b-28b2cc7e1926,posted,Restaurant Dinner,-932.72,0200519d-ef4b-4736-ba4f-0e398594b0dd,-3995.08,debit,payment,AU00000,2023-12-26T17:40:24Z
transaction,e89761bb-e28a-4e7d-b9a5-f550973a9bf7,posted,Car Maintenance Expense,-2685.41,65fba79d-cf71-4a24-ad0d-aa29d31dd3c4,-6680.49,debit,bank-fee,AU00000,2024-01-10T06:37:32Z
transaction,f097b604-aacd-4712-9114-dfd855311aa0,posted,Home Improvement Store Purchase,-402.78,68185c20-1499-418c-bb0f-6035ec78630f,-7083.27,debit,bank-fee,AU00000,2023-05-23T07:50:28Z
transaction,e684313b-74c7-498a-8392-0135c013f8f0,posted,TRANSFER TO JOANNA SMITH CAMPING,-4682.19,6a6b6824-0461-4864-8eb1-da3a7fd9121e,-11765.46,debit,cash-withdrawal,AU00000,2023-07-26T04:41:37Z
transaction,51e34c1c-57c0-4e6b-9cda-62afbe7cbf88,posted,Coffee Shop Purchase,-4467.11,f7577cda-7eea-4b87-a0ff-9255b92db577,-16232.57,debit,payment,AU00000,2024-02-29T19:24:00Z
transaction,fe381a6f-c21e-4c97-ab3f-ae026ee4f89c,posted,Home Improvement Store Purchase,-3423.02,eb26230b-1dbe-47c0-820c-5668ee94d301,-19655.59,debit,cash-withdrawal,AU00000,2024-02-10T23:02:37Z
transaction,44eed2c8-7362-459a-b7f7-cb6e7e3684f2,posted,TFR Acc14000 TO 12389,-826.41,75157f53-3899-4f51-a572-20bb2ad94d1b,-20482.0,debit,payment,AU00000,2023-07-16T18:00:14Z
transaction,737c4049-7dc3-4bbd-9d23-f97bd07f2292,posted,AGL RETAIL ENERGY LTD (GAS),-3295.05,82c77edc-d424-4309-9097-e46874b45c03,14320.67,debit,bank-fee,AU00000,2023-05-29T13:02:53Z
transaction,c02dd679-f97e-41aa-8023-57c4ba53c73b,posted,Public Transport Fare,-267.37,bb5e14d1-5814-437d-91e3-3ba21557c7ef,14053.3,debit,bank-fee,AU00000,2023-05-28T03:57:57Z
transaction,23c7f8ac-223f-43b8-889d-18d883a35610,posted,Hair Salon Appointment,-4416.89,1609ec55-ccab-43a3-af83-f31c8a834eab,9636.41,debit,bank-fee,AU00000,2024-03-12T05:27:49Z
transaction,c1851e66-d855-4501-81e6-e19ddd32b07e,posted,Electricity Bill Payment,-891.21,f4577aab-8549-499f-9783-445bae6a7cf1,8745.2,debit,bank-fee,AU00000,2023-12-12T11:03:18Z
transaction,439bd64c-b9c3-4a1b-a597-3a5d6c6bd9f3,posted,Travel Agency Booking,-4734.5,2d601dbf-848e-4e5f-a7df-1044155617c1,4010.7,debit,payment,AU00000,2023-06-15T07:42:13Z
transaction,778dabb1-2531-4189-a66b-4e7fb43a955d,posted,Music Streaming Subscription,-622.67,52cab289-36a0-4796-a8ee-91062c6b54eb,3388.03,debit,cash-withdrawal,AU00000,2023-09-22T01:38:24Z
transaction,199f97dd-a145-41b0-8274-8cedf7f3b18d,posted,Restaurant Dinner,-4499.43,54ccb619-1515-4ed1-b923-f0ef1451dd64,-1111.4,debit,bank-fee,AU00000,2024-03-27T12:27:49Z
transaction,fc2e644a-2104-4caf-9631-6723c2da8d58,posted,CTRLINK CARERS Ref: 998R6789201610974V,-2698.32,e61659c0-551c-42b6-99f3-8b103608a56f,-3809.72,debit,cash-withdrawal,AU00000,2023-06-13T12:51:05Z
transaction,5e136a71-d2ef-46ae-aaab-08be38a25e08,posted,Music Streaming Subscription,-2807.59,10b44102-80b1-49cf-b246-728b25a7b47c,-6617.31,debit,cash-withdrawal,AU00000,2023-11-21T08:45:44Z
transaction,fa16399a-f705-46ab-9940-738792a5ef98,posted,AGL RETAIL ENERGY LTD (GAS),-4517.75,bd904082-7b45-49ea-bb99-21dc298f81f9,-11135.06,debit,cash-withdrawal,AU00000,2024-05-03T01:51:34Z
transaction,920c4183-63e3-42d2-96f3-91b0cef980c1,posted,Non Hooli ATM Withdrawal Fee,-2281.64,76269164-422d-4e9b-ab1a-0846cc2e3bf5,7503.08,debit,cash-withdrawal,AU00000,2023-07-22T03:34:09Z
transaction,ceafbadd-56b4-4a12-8927-5ab17cf56c31,posted,Electricity Bill Payment,-1387.63,f02f5fcf-0e28-4b54-99c9-58604243e7f3,6115.45,debit,bank-fee,AU00000,2023-09-06T22:08:36Z
transaction,e7c04408-a6b3-4f19-8ae0-745b135a39e3,posted,AGL RETAIL ENERGY LTD (GAS),-4788.0,529c70a0-20d6-4cc5-8824-82dd4c9fce93,1327.45,debit,bank-fee,AU00000,2024-02-07T15:02:10Z
transaction,f9785a88-1e6e-4619-b22b-1452ee52c2dc,posted,Pharmacy Purchase,-4950.27,a217b7c0-d90d-42b9-aa49-3027dc0aae28,-3622.82,debit,cash-withdrawal,AU00000,2023-05-31T15:05:19Z
transaction,56b0da46-f096-4cc3-ba40-ce4e7cf01474,posted,Hair Salon Appointment,-439.9,fbf25689-6510-4c32-96b4-bc2423d7186c,-4062.72,debit,payment,AU00000,2023-10-31T23:53:07Z
transaction,27b2823b-723b-4a89-88c8-947faa1a9588,posted,Amazon Online Shopping,-1552.24,52f53990-bafb-4fd2-a517-56af52db1587,-5614.96,debit,payment,AU00000,2023-06-13T14:26:07Z
transaction,df3ec531-9695-4032-bc59-66595656e7fe,posted,TRANSFER TO JOANNA SMITH CAMPING,-3852.12,59aa8aa8-fa05-4808-981b-91651f3a8ccf,-9467.08,debit,bank-fee,AU00000,2023-10-19T21:48:11Z
transaction,5bfbe72f-5a7c-4ba9-9622-03a4dbd87957,posted,Manly Maths Tutor Wages,-1188.66,a8296c31-4494-4a9d-ace5-bf59860228aa,-10655.74,debit,cash-withdrawal,AU00000,2023-08-13T21:12:50Z
transaction,547e63bf-d1c4-4179-bd4b-54b42d25fd2f,posted,AGL RETAIL ENERGY LTD (GAS),-4564.74,fd291871-98a1-426c-9305-130ddb7e8763,-15220.48,debit,payment,AU00000,2024-01-31T17:02:11Z
transaction,01712db9-38d1-4f9f-b399-c496f14e1255,posted,Restaurant Dinner,-3534.3,97d3da82-8e78-4877-a3b0-6326cc4674d4,-18754.78,debit,bank-fee,AU00000,2024-05-08T13:28:12Z
transaction,cb4d09c2-b6a9-49a7-911a-bcde748f61d4,posted,Gasoline Purchase,-2695.51,1ea41584-248a-46b6-be06-9da4bf0429ee,6127.13,debit,bank-fee,AU00000,2024-02-08T09:55:11Z
transaction,6a101435-3b72-463f-9a41-5e47f43c49cf,posted,Gym Membership Fee,-2751.94,d9d73482-4f57-4c62-9586-fdac5f62e0a2,3375.19,debit,cash-withdrawal,AU00000,2023-09-16T21:08:53Z
transaction,96c38aa0-8031-49a6-baea-2d623f32b9e3,posted,Gym Membership Fee,-2364.69,b96d5fbd-ba57-4411-9f9e-6b522f2cda82,1010.5,debit,cash-withdrawal,AU00000,2024-04-22T02:13:43Z
transaction,d272b86f-cf39-461b-963f-2c50c3495961,posted,Public Transport Fare,-4942.5,71a812be-33c5-40f7-97a6-039cd3d0e016,-3932.0,debit,cash-withdrawal,AU00000,2024-05-02T00:09:40Z
transaction,6b03dd83-43a7-4a65-a48b-fb001105b5cc,posted,Transfer Platnm Homeloan 346454,-4238.44,36b9f183-82d0-4b6f-8da0-433108f82b36,-8170.44,debit,cash-withdrawal,AU00000,2023-11-08T07:56:55Z
transaction,a31dcd89-43e8-49a6-80c1-485fb1686057,posted,AGL RETAIL ENERGY LTD (GAS),-4054.73,a65a795d-8287-4347-9034-8a27aac606d7,-12225.17,debit,bank-fee,AU00000,2024-02-29T09:44:01Z
transaction,5d762355-d3c8-4876-80a0-c7789a6adc8d,posted,Car Maintenance Expense,-4806.68,4ee10656-029b-4cd4-bfb9-fd231868c7b1,-17031.85,debit,cash-withdrawal,AU00000,2023-12-05T11:04:59Z
transaction,328a5053-b2cc-4b54-a898-3f66729bf99e,posted,Clothing Store Purchase,-897.69,bf0e96ed-8cd8-4ece-9c83-09be11ba99bc,-17929.54,debit,payment,AU00000,2023-06-27T03:32:16Z
transaction,0d30c648-0737-43ac-86eb-cea390ac9d13,posted,TRANSFER TO JOANNA SMITH CAMPING,-955.04,c5e30904-8e98-451b-83be-42011e8d121d,-18884.58,debit,cash-withdrawal,AU00000,2023-06-28T06:38:45Z
transaction,8a1395e0-0a86-4bb9-8d65-ae9d73aa596c,posted,Clothing Store Purchase,-1240.23,644e14e0-91d5-43bf-ac24-dc1293b813f2,-20124.81,debit,payment,AU00000,2023-11-28T22:54:23Z
transaction,93089270-c2d4-4377-8f70-359d7e6c57f8,posted,Travel Agency Booking,-751.9,1e55eef2-bb86-4c4f-9529-d680a46dd798,16065.2,debit,payment,AU00000,2023-11-01T19:05:07Z
transaction,6415f864-5202-4216-85ad-f4833800a4a3,posted,Hair Salon Appointment,-4352.06,7ae9c6c9-8342-4f6b-b45c-5129f2836b9c,11713.14,debit,cash-withdrawal,AU00000,2023-08-07T11:33:30Z
transaction,97be65a9-2254-4ba7-83d8-fc4958d18682,posted,Music Streaming Subscription,-1476.03,d66119bd-2227-4ac6-b1ec-f0d263c4070c,10237.11,debit,cash-withdrawal,AU00000,2024-03-17T07:20:31Z
transaction,c5c0c737-e3af-4f9c-a490-9b04f24209fb,posted,Bookstore Purchase,-2233.52,8a977b37-c930-47ae-823a-8c7305ec517e,8003.59,debit,payment,AU00000,2023-12-27T00:28:07Z
transaction,38cc8664-cfcf-4685-9c5e-8631c03114d7,posted,Public Transport Fare,-3033.89,a3462399-e310-4b64-8dbb-0319956ab3be,4969.7,debit,cash-withdrawal,AU00000,2023-12-07T07:34:36Z
transaction,0cd94b60-74d7-495d-bb89-abc2bd5d5e02,posted,Netflix Subscription,-2178.5,266c4f41-e7a4-4492-bf87-a0fc3474c616,2791.2,debit,payment,AU00000,2023-09-26T17:25:27Z
transaction,956f7c56-4277-46da-9998-21b88ed84e5c,posted,Online Gaming Purchase,-3480.93,5ee36eee-ffbe-4a90-8b3e-104182aa7cd5,-689.73,debit,payment,AU00000,2024-03-20T18:50:37Z
transaction,e094a4c6-f764-4caa-af1d-309f640645b5,posted,Hair Salon Appointment,-4681.75,1fe529d5-fcee-449d-8321-f2320a516abc,-5371.48,debit,cash-withdrawal,AU00000,2023-05-25T03:33:01Z
transaction,21586f42-28a5-4dcc-9630-9f36e0da5f0a,posted,TRANSFER TO JOANNA SMITH CAMPING,-4881.36,fbe1d681-9df4-4278-acd3-8ae3d646b2ae,-10252.84,debit,bank-fee,AU00000,2024-03-05T19:03:39Z
transaction,82dc6a71-9786-487b-a752-659fe02a126c,posted,Travel Agency Booking,-4513.2,fe710b9c-f6ec-4073-9b55-90a24495b7d5,-14766.04,debit,cash-withdrawal,AU00000,2024-02-14T07:54:03Z
transaction,05f0b2c3-9a12-4406-9caa-608d58a59650,posted,Travel Agency Booking,-380.45,b1999180-8c10-452c-a047-0881eb19fe05,5183.15,debit,cash-withdrawal,AU00000,2023-05-29T20:29:18Z
transaction,a5fe037a-05f5-4322-b21e-15f81775f1f9,posted,Movie Ticket Purchase,-3727.28,9ab581eb-b41b-4c6e-aa99-8b5d1b425918,1455.87,debit,bank-fee,AU00000,2023-12-06T14:10:02Z
transaction,c8ff1c50-04e8-4a5e-a006-b09168fa8135,posted,Amazon Online Shopping,-3216.31,af886c5c-a542-455b-8a17-83506b790eaa,-1760.44,debit,cash-withdrawal,AU00000,2024-01-27T17:54:06Z
transaction,23f46b54-8728-4d76-9514-35687e5804bc,posted,Netflix Subscription,-4607.79,57636bd4-8fa8-43b9-8778-b5c149af08fd,-6368.23,debit,payment,AU00000,2023-06-27T14:52:53Z
transaction,3fac2fa2-ced5-4fb9-86a0-3bee81305d9a,posted,Coffee Shop Purchase,-318.73,e1c36c0b-24e4-4668-bfb4-b8fbd66d5bf2,-6686.96,debit,payment,AU00000,2023-08-06T11:56:54Z
transaction,c271df83-48a7-4837-aaa2-436fb411ada1,posted,Gym Membership Fee,-2666.48,556710b6-c9ba-4443-8639-1f9f234409d8,-9353.44,debit,cash-withdrawal,AU00000,2024-01-17T08:22:21Z
transaction,74f6691d-56f0-4b85-a24d-1672be9c2f4d,posted,Bookstore Purchase,-1389.28,6e4aaa1a-2b5e-47e4-8713-95ab1fcd244d,-10742.72,debit,cash-withdrawal,AU00000,2023-05-24T01:32:32Z
transaction,a304c9e0-8fa4-4f7f-950b-661079e1e918,posted,Electricity Bill Payment,-1868.41,ae790ef2-7521-4047-ade4-318b7bdb5165,-12611.13,debit,payment,AU00000,2023-07-03T22:40:30Z
transaction,afbb9405-14e5-4726-8e65-75e9f7cbb354,posted,Transfer Platnm Homeloan 346454,-2278.6,6dc60e8f-2e4a-453d-89f7-a7f0f8a1b732,-14889.73,debit,payment,AU00000,2023-11-18T19:58:13Z
transaction,210a16ac-a8f9-4c7c-b690-5a8280714ba4,posted,Pharmacy Purchase,-1529.37,2eb364df-867f-42f1-8e30-b0e73986eef4,-16419.1,debit,payment,AU00000,2024-03-04T13:06:44Z
transaction,e1cb8afb-2b91-405d-a6e3-cc5b6f5782e1,posted,Non Hooli ATM Withdrawal Fee,-4777.7,4a85b710-a4af-4ddc-9216-c804270c2c44,4193.25,debit,cash-withdrawal,AU00000,2023-05-16T16:13:14Z
transaction,4e2d609e-4e70-43f8-a6d9-f36fc6b83f91,posted,Gym Membership Fee,-864.16,ff098f5a-8e0d-4e7e-940f-0b29cff32ddc,3329.09,debit,payment,AU00000,2023-11-15T11:16:48Z
transaction,cb0ecb93-9e39-4fac-bb13-08fd42440a49,posted,Restaurant Dinner,-249.31,aa1e9845-9fae-4d1e-a545-b2a7287f1207,3079.78,debit,payment,AU00000,2023-09-09T02:42:08Z
transaction,46b0caca-f281-44f8-87f8-6ad0b7c2beed,posted,TFR Acc14000 TO 12389,-3176.22,6fd4bfe5-b85a-41e0-8492-ecc618b7ca04,-96.44,debit,bank-fee,AU00000,2023-08-03T02:27:06Z
transaction,fd08b571-7c82-4b1e-9875-dd23a704f728,posted,Gym Membership Fee,-2111.27,3c9d2187-d4de-46ed-883f-bf1778aca303,-2207.71,debit,cash-withdrawal,AU00000,2023-09-26T17:49:57Z
transaction,eb120ecc-f649-4c03-8d53-45a85e6c5f47,posted,AGL RETAIL ENERGY LTD (GAS),-892.12,59f8c157-5022-447d-b1cb-cf33d7e5e2d7,-3099.83,debit,payment,AU00000,2023-05-18T05:58:07Z
transaction,bfe2fd9a-0a32-4c71-a2e0-adadfedd5410,posted,TRANSFER TO JOANNA SMITH CAMPING,-2083.19,94d4e5b7-0419-406f-8377-5b5d30d3736c,-5183.02,debit,bank-fee,AU00000,2023-10-17T21:43:57Z
transaction,6a4b1cfc-5bad-482e-b2e2-d925020fdad3,posted,Netflix Subscription,-3250.7,0a01a3d8-356b-4fcd-9db4-6364e4ae03b4,-8433.72,debit,payment,AU00000,2023-05-28T05:43:49Z
transaction,b367d82e-4245-42a2-a1dc-e0137ff7a5b6,posted,Bookstore Purchase,-4367.35,fa702262-8342-4bd5-81aa-51b753373bd5,-12801.07,debit,bank-fee,AU00000,2024-03-21T03:43:25Z
transaction,2d6f90e4-eb9d-46d2-bdd6-a34db4de6073,posted,Uber Ride,-1273.9,785b3118-268b-49e4-8d0d-32cb59b02324,-14074.97,debit,bank-fee,AU00000,2024-01-18T07:51:35Z
transaction,025b9b28-12ec-4e25-ac87-780f6355240d,posted,Home Improvement Store Purchase,-4578.62,1d2dc5ee-9c51-4109-8a85-8227373263fb,12472.14,debit,bank-fee,AU00000,2024-04-25T00:06:40Z
transaction,fab1c380-2e0d-49e0-976a-9adfa607e13b,posted,Clothing Store Purchase,-4245.36,87086a9c-d628-4fa7-9c70-5f40fba33c51,8226.78,debit,cash-withdrawal,AU00000,2023-10-06T06:57:22Z
transaction,851d8d5d-9573-4ac2-aa51-223cc2d9d43f,posted,Non Hooli ATM Withdrawal Fee,-4392.04,c1e41104-b7e0-4f26-96fb-e3e95e708989,3834.74,debit,payment,AU00000,2023-08-14T12:36:35Z
transaction,08e97293-56dd-436c-b176-108730a217a8,posted,Gasoline Purchase,-642.79,2c2ce2d5-0400-4e21-a522-544b14e6b7f8,3191.95,debit,payment,AU00000,2023-07-17T11:10:43Z
transaction,0416e1ee-b023-4263-9bf9-9afe3bcc8b01,posted,Wdl ATM WESTPAC IGA BALGOWLAH BALGOWL AU,-1142.91,1b247255-7d63-48fa-b4cb-d858dbb6633f,2049.04,debit,payment,AU00000,2024-04-16T16:36:30Z
transaction,5ee0b73d-05ef-4445-b4ef-97cbc04907d1,posted,TFR Acc14000 TO 12389,-2030.51,aceb8c23-918f-4f47-838e-27af6621a73e,18.53,debit,bank-fee,AU00000,2023-11-28T15:55:55Z
transaction,9f660566-f37c-43dc-92e7-9a46ec58e457,posted,Pharmacy Purchase,-696.45,56b56379-c6bd-46c0-a097-726f1f8f46e9,-677.92,debit,cash-withdrawal,AU00000,2023-08-29T02:03:33Z
transaction,8e37651c-33be-49ca-87dd-ccdf75d894c6,posted,TFR Acc14000 TO 12389,-3160.16,75f9ebe4-0ce4-4254-93a7-d81b41168d15,-3838.08,debit,cash-withdrawal,AU00000,2023-08-14T15:14:50Z
transaction,fed8eb98-eed7-4f8d-b35b-76f3a90bbcfa,posted,Manly Maths Tutor Wages,-2789.92,a3ffa638-abf8-42c2-b44d-dba45f723b20,-6628.0,debit,cash-withdrawal,AU00000,2023-06-27T08:48:31Z
transaction,ec99b2df-61db-4469-8dc9-8f0e3165315f,posted,TFR Acc14000 TO 12389,-750.65,6841a06e-823f-4773-bc24-7f2d73aec185,-7378.65,debit,payment,AU00000,2023-09-18T05:45:31Z
transaction,b67a60f6-8a4c-4044-a3a0-d5cd3cd425fd,posted,Amazon Online Shopping,-1630.69,22a46f32-ac39-4bec-9b40-895835b00536,4547.94,debit,payment,AU00000,2024-04-21T17:34:06Z
transaction,b6acaa5e-a5fe-4514-a24e-f5c1515a6d68,posted,Hair Salon Appointment,-1252.33,4b7a697d-6146-4bd9-a7f6-83472dd5d8b7,3295.61,debit,cash-withdrawal,AU00000,2024-01-29T23:10:26Z
transaction,3ac44916-2389-4227-8550-c46414ba0b03,posted,AGL RETAIL ENERGY LTD (GAS),-978.94,469c07d4-0efe-49ec-8cfc-111f45c775ae,2316.67,debit,cash-withdrawal,AU00000,2023-10-03T00:13:23Z
transaction,3edd263a-6db7-4fcb-8c41-38c799c7e307,posted,CTRLINK CARERS Ref: 998R6789201610974V,-6.77,253cfb16-1d2a-40d7-9a67-5e7b5f5f812e,2309.9,debit,payment,AU00000,2024-01-12T02:33:55Z
transaction,58bd557b-9ca0-4856-8e4e-4ddcbb81d4b8,posted,Mobile Phone Bill Payment,-2172.71,8af718ad-98c5-4883-8752-70c69ec2f906,137.19,debit,bank-fee,AU00000,2023-12-04T01:42:00Z
transaction,9daab475-4ca0-4f0d-a66a-23dd9cf4e639,posted,Mobile Phone Bill Payment,-1874.67,abe68844-8701-4327-9dca-41f87b6f81c3,-1737.48,debit,payment,AU00000,2023-12-21T11:09:07Z
transaction,306935f5-bcb4-4caf-8f4c-bc95d852a6d4,posted,Mobile Phone Bill Payment,-1968.02,5cfd5822-1a4c-4ae2-aa0e-1ea1841af7bc,-3705.5,debit,bank-fee,AU00000,2024-03-14T10:06:47Z
transaction,d318c545-3480-42aa-a1eb-2de48f5ea4c2,posted,Restaurant Dinner,-1324.69,dfb66320-5dd8-4d1f-8fcd-91eb4a3f2608,-5030.19,debit,cash-withdrawal,AU00000,2023-10-09T05:49:25Z
transaction,dbf06d20-b6f0-43cc-ab10-6e46c15207af,posted,Pharmacy Purchase,-943.22,c7f2756a-5e31-44cb-9753-62d6cbbea310,-5973.41,debit,payment,AU00000,2023-11-03T10:22:15Z
transaction,0ddf3444-7a70-4e93-858c-b906ac31f995,posted,Amazon Online Shopping,-4168.07,172fa80d-5b16-49c0-94d3-6834a1703196,-10141.48,debit,payment,AU00000,2023-12-22T00:57:50Z
transaction,c2b698f1-4d91-4fe5-836a-d1df704fd32f,posted,AGL RETAIL ENERGY LTD (GAS),-4635.11,65a49db5-13ee-42c5-a173-3f97dde9b6fc,13942.99,debit,cash-withdrawal,AU00000,2023-08-02T11:53:03Z
transaction,235ecf9b-5e94-47f9-b62d-3d1603524044,posted,Gym Membership Fee,-4786.95,8dfe2486-290c-4ed7-b6a5-2dc1845167db,9156.04,debit,payment,AU00000,2024-03-21T22:39:20Z
transaction,c4af23bb-4a84-4614-a126-0a72a377185c,posted,Home Improvement Store Purchase,-2992.36,5a2ce867-67ef-4598-b1d9-5ff33df3a2b7,6163.68,debit,payment,AU00000,2023-11-21T20:04:19Z
transaction,2b83c94e-8b7a-4266-8d17-57df1493c6df,posted,Wdl ATM WESTPAC IGA BALGOWLAH BALGOWL AU,-3386.41,2ac9941f-19c3-4c27-99fe-6de1826579e2,2777.27,debit,cash-withdrawal,AU00000,2023-06-12T09:23:31Z
transaction,34c69622-e15c-4587-a539-a88185566161,posted,Non Hooli ATM Withdrawal Fee,-4976.88,5c2d9d62-c04b-4467-adb5-cc8f9cc7a8fc,-2199.61,debit,bank-fee,AU00000,2023-05-30T03:53:33Z
transaction,ff0f2eda-5daf-4d99-8947-fc2c240f9bd1,posted,Home Improvement Store Purchase,-1493.16,14644b54-bdc5-4262-98c7-278f4fa27887,-3692.77,debit,payment,AU00000,2024-01-11T07:42:27Z
transaction,f59cdfd4-14b0-4dc6-98c6-f56d4d700ed4,posted,Movie Ticket Purchase,-1669.48,79146a1d-070c-4a73-b7fc-f6a83e99d06d,-5362.25,debit,payment,AU00000,2023-10-02T18:57:00Z
transaction,f1221633-b92e-4702-8d91-d46dfde25a64,posted,Restaurant Dinner,-4784.23,8715b476-d6a6-4b36-b099-911b56e8f21e,-10146.48,debit,bank-fee,AU00000,2024-03-05T12:44:39Z
transaction,f3285e81-f2ce-4e84-aa78-8aae43f59436,posted,Music Streaming Subscription,-1308.8,9d35b981-50a0-49c9-8445-0c9112b4294d,-11455.28,debit,payment,AU00000,2023-07-08T22:06:40Z
transaction,f2473f96-c97e-4eb7-923b-2ae1ce55b75d,posted,Non Hooli ATM Withdrawal Fee,-3242.2,20d86626-d510-4de0-93a4-a1501835b976,-14697.48,debit,bank-fee,AU00000,2024-04-16T17:16:14Z
transaction,c2b23a0f-a495-4b99-b34d-6bca624954ca,posted,Netflix Subscription,-2524.48,45afe0ab-b81d-42c0-a03c-6fa4dfe4067b,17322.4,debit,payment,AU00000,2024-03-24T07:36:29Z
transaction,02249f6c-9b82-43eb-bada-ac40bc37ed41,posted,Transfer Platnm Homeloan 346454,-4228.29,6aa13b0d-cd6e-435b-9fe5-2e3ee21c0337,13094.11,debit,cash-withdrawal,AU00000,2024-03-08T05:13:19Z
transaction,d14b16ab-ea3c-44b0-8f13-6cb6dc877de7,posted,Payroll WFRMS 15439393,11932.04,a4f94442-d4ba-4e89-b970-89fe994a84fd,25026.15,credit,transfer,AU00000,2023-11-13T13:43:41Z
transaction,a5151df0-4f25-4763-91bd-e0e099d0270c,posted,Netflix Subscription,-723.79,003b8992-c98e-476e-b8af-70a352e91e81,24302.36,debit,bank-fee,AU00000,2024-04-13T19:35:04Z
transaction,1789d4f6-6972-4595-baf1-06c37104f869,posted,Gym Membership Fee,-2582.11,f43d90e4-336b-4b61-9b87-2904e6db6057,21720.25,debit,bank-fee,AU00000,2024-02-06T04:02:03Z
transaction,50be1ad3-e2e3-4647-ada2-cf29f25e2d19,posted,Movie Ticket Purchase,-2171.95,bfd237a5-c766-428a-8d5c-f17ebb9367b0,19548.3,debit,bank-fee,AU00000,2024-01-29T05:46:17Z
transaction,21c5d07e-5b89-4115-a6be-2884a798a5a0,posted,Gasoline Purchase,-1076.12,0676f4de-57c6-4924-b78a-4f513a6f881d,18472.18,debit,bank-fee,AU00000,2024-05-10T19:42:47Z
transaction,a5383053-7099-49d6-8e71-f7df9398fca9,posted,Electricity Bill Payment,-3929.25,b44a6b53-3297-4502-9ed7-69e4f2be4862,14542.93,debit,cash-withdrawal,AU00000,2024-01-05T00:26:08Z
transaction,829b9620-b014-4eee-ab6f-33a791c09c48,posted,TFR Acc14000 TO 12389,-2546.94,c7ae65da-de86-4e79-8b3f-7e56faccefdb,11995.99,debit,payment,AU00000,2024-05-09T03:17:39Z
transaction,151a1130-c2c0-431c-aca6-3e51a67ad4c2,posted,Movie Ticket Purchase,-1893.44,f30c04cc-337f-4336-9121-acbcb4015d65,10102.55,debit,payment,AU00000,2023-12-22T18:24:39Z
transaction,882308ff-6f25-46d2-910b-667c6325d110,posted,TRANSFER TO JOANNA SMITH CAMPING,-695.87,6ed1a97e-eaeb-4e9f-95ab-79b2d48784fb,10653.35,debit,cash-withdrawal,AU00000,2024-04-13T03:31:49Z
transaction,e76083c7-e105-4489-b01f-65cc375835f9,posted,Wdl ATM WESTPAC IGA BALGOWLAH BALGOWL AU,-1955.48,f2c08f0e-7cf8-42fb-be80-26ae266f8ca3,8697.87,debit,bank-fee,AU00000,2024-01-24T16:58:58Z
transaction,ec690920-2f57-4b8c-affa-93f903d92af6,posted,CTRLINK CARERS Ref: 998R6789201610974V,-2007.26,3e4ba2bd-d65d-49ae-bfdf-f17bbc1afefa,6690.61,debit,payment,AU00000,2023-06-29T13:22:00Z
transaction,8db620d1-8e7c-4f5a-9697-9401362fbc4c,posted,Home Improvement Store Purchase,-3343.19,2d5702af-4a95-40f9-9185-33dfc4aaf6da,3347.42,debit,cash-withdrawal,AU00000,2023-06-24T18:51:49Z
transaction,8cd3258a-9570-478f-89a4-702f9367211c,posted,Car Maintenance Expense,-4186.9,4cccd47a-31b0-400f-8f52-85bd05fb9bf4,-839.48,debit,bank-fee,AU00000,2023-07-17T18:01:14Z
transaction,453fb14a-0628-4018-b36f-cb31003529c2,posted,Restaurant Dinner,-1968.66,e6f48ba3-f972-40d0-9176-15fc4ba20b73,-2808.14,debit,bank-fee,AU00000,2023-08-08T04:18:06Z
transaction,21fb8475-7899-43cd-a8a7-9e17e0a5a287,posted,Mobile Phone Bill Payment,-1075.49,61a42a39-a69b-4c21-9129-4a68f7aa583b,-3883.63,debit,bank-fee,AU00000,2024-04-09T08:53:19Z
transaction,90464f6c-2eef-47f1-8430-18fbf7844c80,posted,Restaurant Dinner,-753.46,382f02cd-c548-4d3c-ad1d-0cc51dac3c7c,-4637.09,debit,cash-withdrawal,AU00000,2023-10-29T01:38:38Z
transaction,23063f4a-a62a-42dc-8dc5-e6eee5b37446,posted,Wdl ATM WESTPAC IGA BALGOWLAH BALGOWL AU,-2333.79,e06890f5-98b0-4d26-9f3e-7d4d7738cc5d,-6970.88,debit,bank-fee,AU00000,2024-05-08T17:08:31Z
transaction,60d32a88-6ac0-490e-b372-b5605e0f6d41,posted,Clothing Store Purchase,-32.26,6cce5668-9071-48fe-bae1-933e900fa1c3,-7003.14,debit,bank-fee,AU00000,2024-02-07T14:01:29Z
transaction,e271697e-edde-486a-b226-d5148b925af1,posted,Gym Membership Fee,-220.77,2dd6b499-2f50-46e6-9269-92900f78e86b,9383.08,debit,cash-withdrawal,AU00000,2023-12-03T20:47:32Z
transaction,2c6654e1-eeb5-4e56-8733-1baf559b44aa,posted,Gym Membership Fee,-2660.04,df794956-6401-4e01-8c17-1899a84a715a,6723.04,debit,cash-withdrawal,AU00000,2024-03-23T17:23:16Z
transaction,57854205-5752-4712-82e9-57260596fe31,posted,TFR Acc14000 TO 12389,-3768.25,c6330700-2ac0-479a-ae07-2c181da0d2a3,2954.79,debit,cash-withdrawal,AU00000,2023-11-26T15:05:17Z
transaction,86c3bce9-da2e-4da0-a9e3-48331371d7a3,posted,Public Transport Fare,-430.4,c4a5ccb8-a579-4765-8fe5-2a1cd5a35033,2524.39,debit,bank-fee,AU00000,2024-01-20T07:54:35Z
transaction,46968866-0778-44e8-b856-e2cf2ae94c4b,posted,Music Streaming Subscription,-3275.32,77a12db4-7f05-4683-a9c1-14936dd56403,-750.93,debit,bank-fee,AU00000,2024-04-15T06:37:30Z
transaction,c857a6d2-aa03-46b1-a7aa-b9bd38dda649,posted,Amazon Online Shopping,-3360.65,7610ba5e-e777-4a92-a959-a9757c5319ec,-4111.58,debit,cash-withdrawal,AU00000,2024-05-09T03:31:42Z
transaction,97cd06a9-7862-4284-9284-11dde46f334c,posted,Coffee Shop Purchase,-3448.54,d2815da3-35d1-4c46-a8a0-a3469918f1f9,-7560.12,debit,payment,AU00000,2024-02-14T23:37:32Z
transaction,75906714-82a4-418e-adcd-6a157d811636,posted,Gym Membership Fee,-2594.19,b04d22f5-d3af-442c-aaea-82eaf38fd328,-10154.31,debit,cash-withdrawal,AU00000,2023-11-27T00:46:04Z
transaction,66f454e2-8093-4bff-a08b-295c0e53d44e,posted,Amazon Online Shopping,-264.36,0ad762ba-4aa8-4e61-9c0e-3b47b8d113cc,-10418.67,debit,payment,AU00000,2023-08-28T15:46:05Z
transaction,0a83ff2b-223e-42f8-a316-5d3c4f30fe07,posted,AGL RETAIL ENERGY LTD (GAS),-3353.34,ee30900a-abe5-420d-91fa-d3730748cff0,-13772.01,debit,payment,AU00000,2024-01-04T19:56:41Z
transaction,ddaaab14-6256-40e4-a80a-65be18202818,posted,Electricity Bill Payment,-4221.71,bf771afb-0500-4938-8913-39e278d3c4a8,5836.44,debit,cash-withdrawal,AU00000,2023-10-08T14:55:37Z
transaction,74aa031f-8ceb-4607-8037-70d62b2b6925,posted,Clothing Store Purchase,-4612.92,197dfd78-7fef-4f74-bdcd-2808dc38f4f2,1223.52,debit,payment,AU00000,2023-07-03T12:17:32Z
transaction,8f4db7f9-2473-4a04-90ed-27c0d14d0455,posted,AGL RETAIL ENERGY LTD (GAS),-2824.06,fa5fc734-2156-4424-b400-3b0e81edb3b5,-1600.54,debit,cash-withdrawal,AU00000,2023-11-09T05:36:31Z
transaction,819e45c9-c50c-4e1b-88e1-038e0400a8d4,posted,Amazon Online Shopping,-3262.7,d5bb0c07-3b94-447a-8316-0f2f764cec08,-4863.24,debit,payment,AU00000,2023-10-07T17:32:17Z
transaction,33dc2877-975b-40a0-9c23-9a8a6b373a3b,posted,Car Maintenance Expense,-3451.41,93f1eee1-5c2a-4a67-92b2-3ba0309d09e0,-8314.65,debit,bank-fee,AU00000,2024-03-29T15:05:56Z
transaction,5ef2716d-0132-459c-9770-312c8796d1ac,posted,TFR Acc14000 TO 12389,-3347.19,29ed116c-fa82-4192-b711-ae8e467d181c,-11661.84,debit,cash-withdrawal,AU00000,2023-09-02T14:12:28Z
transaction,1943b317-ceb3-4b4e-b387-7967e94307e9,posted,Clothing Store Purchase,-1732.88,011afbdd-e314-4997-8d84-beac67be0ae4,-13394.72,debit,payment,AU00000,2023-10-25T11:47:26Z
transaction,a0e517d0-00e7-45ff-8bd2-aa71d6be8ba0,posted,TFR Acc14000 TO 12389,-944.36,98ec5c1b-f919-4238-9bf6-64671a7393ec,-14339.08,debit,cash-withdrawal,AU00000,2023-07-13T05:35:01Z
transaction,d2855d73-0211-4e00-8d90-a057220dad3b,posted,Amazon Online Shopping,-4234.06,ee89f85c-f55f-4488-ad49-bbd7784bf987,-18573.14,debit,payment,AU00000,2023-11-22T07:57:54Z
transaction,7a779157-1cba-407e-9e8e-6c6cb0b5adc2,posted,Payroll WFRMS 15439393,10590.02,a97d36d0-3b49-4b31-920b-18fbc0350baa,-7983.12,credit,transfer,AU00000,2023-08-30T02:24:09Z
transaction,065c052c-2cbc-4b99-8705-aeba631c7b47,posted,Payroll WFRMS 15439393,10182.6,fc83dc92-1ff5-415f-9d20-cff1681606b4,20418.44,credit,transfer,AU00000,2023-11-02T13:05:23Z
transaction,bbc2be0b-8353-4c94-ae62-dba3dd98bfc2,posted,Mobile Phone Bill Payment,-3078.47,79f27488-ab09-41b4-8276-48514e2e8fd9,17339.97,debit,bank-fee,AU00000,2023-11-12T19:56:19Z
transaction,1599ee3b-e3ab-4797-87b0-dac23ff41b2b,posted,Payroll WFRMS 15439393,11125.05,b9cae4f8-d012-44fa-ae1f-bad87a7796f5,28465.02,credit,transfer,AU00000,2023-11-16T18:48:24Z
transaction,c95b3e79-1d6b-44ef-b1b7-e1483be9d78b,posted,Mobile Phone Bill Payment,-3613.57,4ec1166c-6f07-43e2-9a85-62894c191460,24851.45,debit,bank-fee,AU00000,2024-04-14T03:41:04Z
transaction,6d7e7d76-c605-4c46-a17e-d1f0547ab1e4,posted,Coffee Shop Purchase,-3083.41,a9c2ec53-dd8a-48a8-897a-0a60aa93ce8a,21768.04,debit,payment,AU00000,2023-12-18T11:23:49Z
transaction,465ad89b-3fee-4cca-9a03-a5da088fb821,posted,TFR Acc14000 TO 12389,-302.8,5257eee3-8e53-4c81-ad85-170c20300dcb,21465.24,debit,bank-fee,AU00000,2023-06-30T07:54:05Z
transaction,60c3b8cd-498f-4ca4-8d3a-4aa370d6cc73,posted,Gasoline Purchase,-610.81,7a7f2146-6d7c-4db0-aab8-0eb5d7be41f6,20854.43,debit,cash-withdrawal,AU00000,2024-02-10T11:15:46Z
transaction,a58751cb-ede4-4152-9751-49f42dad8c4b,posted,Payroll WFRMS 15439393,10390.02,2e9e9b5d-3017-4976-b9e9-e6ae44ba26d4,31244.45,credit,transfer,AU00000,2023-11-09T15:41:36Z
transaction,8f3251d8-3c2e-4e4d-b84f-351e82f08511,posted,Uber Ride,-4657.58,c7c3637c-9df0-4aa3-82bc-b1d527c3cb03,26586.87,debit,payment,AU00000,2023-06-09T06:11:11Z
transaction,b9e8ff04-b8c6-4fa1-b6dd-8afefe2f8a8a,posted,Mobile Phone Bill Payment,-3432.39,91450a71-a2df-43d2-b9ac-eae987549eca,23154.48,debit,cash-withdrawal,AU00000,2023-06-30T15:48:56Z
transaction,711820a2-c20a-47b9-b786-b9c2edc064f4,posted,Gasoline Purchase,-2684.95,dddd5cf9-0c8a-4ac9-9fda-02d6e6f531db,15928.18,debit,payment,AU00000,2023-09-11T10:50:40Z
transaction,d89e8eac-1a88-43f1-8487-3acd4ffe8d35,posted,Coffee Shop Purchase,-4894.21,0221b4e3-9c96-4a91-9f57-05ac37fa6d48,11033.97,debit,cash-withdrawal,AU00000,2023-09-09T03:20:34Z
transaction,08d83f87-3af3-4bf9-bcda-baa64cc1a797,posted,Amazon Online Shopping,-3837.19,ae374216-a0c5-411b-b122-d6661b8a123e,7196.78,debit,payment,AU00000,2024-03-13T11:21:21Z
transaction,cb1b4fd0-4851-4230-af35-54a3faf703cc,posted,Car Maintenance Expense,-939.29,510d95be-19fd-458a-b2b2-ff4455c049d8,6257.49,debit,bank-fee,AU00000,2023-06-16T10:33:33Z
transaction,df3069d0-4c5c-48e0-a7ee-1f7351b61d59,posted,Hair Salon Appointment,-661.85,dae2c60d-8446-48cf-956d-b71ef16df89f,5595.64,debit,cash-withdrawal,AU00000,2023-05-17T03:27:47Z
transaction,90a24bb8-9283-47bf-a72b-bf0183ceb41b,posted,TRANSFER TO JOANNA SMITH CAMPING,-4710.27,cc305aa8-51c9-450a-9812-eddd8620a834,885.37,debit,cash-withdrawal,AU00000,2023-12-04T00:50:03Z
transaction,ccc6f680-2bfd-4185-b5d1-5a5536139cb3,posted,Payroll WFRMS 15439393,11490.84,f27a2538-1db5-454b-bcda-b12427f255f9,12376.21,credit,transfer,AU00000,2023-07-09T00:24:34Z
transaction,b4ccc0a2-2855-4e2d-9236-b4de7d28a8a2,posted,Hair Salon Appointment,-2209.21,5d976f38-58a7-4fdf-bd36-8330d5e2f08b,10167.0,debit,payment,AU00000,2023-10-07T11:41:32Z
transaction,3a4417a2-4367-4f36-b7dc-f88c9d6c2ae6,posted,Movie Ticket Purchase,-3556.26,5229838f-d1a5-4fdf-9c90-47ef3dcdd136,6610.74,debit,bank-fee,AU00000,2024-04-12T08:54:01Z
transaction,f852d7cc-3646-437d-942f-c0c6950a3e8c,posted,Gym Membership Fee,-549.15,db51979f-43e2-4115-aa78-a87870a9925a,6061.59,debit,payment,AU00000,2023-12-18T15:38:01Z
transaction,42ea72ee-0976-4647-b469-224d10648bee,posted,Mobile Phone Bill Payment,-2006.35,aa43139c-a2c4-459a-bf97-fd5556345f18,9567.12,debit,cash-withdrawal,AU00000,2024-02-15T23:14:26Z
transaction,6ddcdea5-9909-47a3-8cd9-103d459e3387,posted,Payroll WFRMS 15439393,10677.25,bf707fc8-2ec8-45ed-969c-2d1a591231e4,20244.37,credit,transfer,AU00000,2023-11-04T13:40:07Z
transaction,f3bd97b2-3559-4c99-936b-a1a5b7c2c12f,posted,Online Gaming Purchase,-1185.96,47ef14a3-3ff7-4fda-93f2-7c2d28f1947d,19058.41,debit,bank-fee,AU00000,2024-01-11T03:29:31Z
transaction,7d4a6003-50e5-4d5d-ae3b-ff58b9c49f5b,posted,Gasoline Purchase,-4798.35,8e9623a1-bd74-45cf-8569-b5e21d520230,14260.06,debit,cash-withdrawal,AU00000,2023-06-15T13:27:49Z
transaction,3cc59b7e-813e-459e-b491-509d12a96484,posted,Travel Agency Booking,-4916.16,e5a1c32c-7aa4-420d-8be7-ac4bfb28c668,9343.9,debit,bank-fee,AU00000,2023-07-25T14:12:44Z
transaction,cec19e95-0b50-4fbf-8ed9-85b944a6ecc3,posted,Public Transport Fare,-4388.81,47e16511-d4e0-461a-a83d-56e5b634df94,4955.09,debit,cash-withdrawal,AU00000,2024-01-16T03:26:14Z
transaction,3902c6ed-432b-4821-bb87-102ac809c1b9,posted,Coffee Shop Purchase,-2733.01,679d1646-230d-407e-8353-94b2a7bb75c4,2222.08,debit,payment,AU00000,2023-06-20T08:21:49Z
transaction,29e76193-5975-4bd3-b3d3-9f8d96df4739,posted,Gym Membership Fee,-2173.58,f79944d1-c4fa-4b68-a7dc-406d2f844e58,48.5,debit,bank-fee,AU00000,2023-05-15T13:23:27Z
transaction,c82536ca-ecd6-47ce-a13b-d57947eeb195,posted,Mobile Phone Bill Payment,-548.04,f7905574-be72-41b2-a524-8c50cd0cc95a,-499.54,debit,payment,AU00000,2023-08-30T11:00:25Z
transaction,7b5d15d5-643c-48a7-a373-6b3e35db75ff,posted,Non Hooli ATM Withdrawal Fee,-1167.05,7d2043c7-0bea-4afc-ad47-f09d4e8cc2aa,-1666.59,debit,bank-fee,AU00000,2024-05-04T02:07:34Z
transaction,ebb97500-33bf-4743-896b-8d2c8e791da1,posted,Uber Ride,-2241.5,aae973b5-289c-41b9-927c-5fb6932acd2b,3764.88,debit,bank-fee,AU00000,2023-06-09T08:09:01Z
transaction,362d615c-cd03-4b38-8db9-e03642ac3b3c,posted,Music Streaming Subscription,-2661.09,e10d3d76-61aa-4166-98f8-e076e2297b78,1103.79,debit,cash-withdrawal,AU00000,2023-07-14T01:01:57Z
transaction,d6de0f51-eed5-43d6-9989-52d1d5ee4603,posted,Music Streaming Subscription,-2904.17,31f449d4-672e-4b79-a8b7-f66916b02344,-1800.38,debit,bank-fee,AU00000,2023-10-02T08:22:00Z
transaction,ec4edce8-165b-40c4-8409-3a6b3e7fb91e,posted,Uber Ride,-3267.11,3e5026d4-ecd4-4611-8652-ccc5c19ca4cf,-5067.49,debit,cash-withdrawal,AU00000,2023-12-16T23:43:31Z
transaction,f537e884-419d-4662-9701-cdafaf0fd3c1,posted,Bookstore Purchase,-1906.07,732e6d93-dd09-4a96-94ac-199ea49ad8e4,-6973.56,debit,bank-fee,AU00000,2024-04-04T02:27:26Z
transaction,df86c94d-a127-48cd-9aab-b3710007f7b8,posted,Hair Salon Appointment,-2009.07,61d78e54-b84b-4a90-91f7-73a317ddf76c,-8982.63,debit,bank-fee,AU00000,2023-07-22T05:16:27Z
transaction,794660ed-7539-492b-bf3c-3eccc950d5e3,posted,Online Gaming Purchase,-4965.54,be84debc-2a29-4957-b901-8a398528a201,-13948.17,debit,payment,AU00000,2024-04-25T13:30:35Z
transaction,57cac1c2-dcb6-44c3-b065-190e7893d9d0,posted,TFR Acc14000 TO 12389,-3216.81,7151ff31-1b04-465d-b3fb-61a1529fb1ca,-17164.98,debit,bank-fee,AU00000,2024-02-28T19:40:32Z
transaction,06e0662e-1464-4f4b-8e42-47f4bba127d5,posted,Uber Ride,-3222.77,ed998205-f61c-4030-9a6c-07e3b414ca54,-20387.75,debit,payment,AU00000,2023-08-20T17:05:25Z
transaction,c19ec189-4c80-4c52-894d-d4955c2fb6ee,posted,Movie Ticket Purchase,-21.52,54406705-d78f-4dcc-9e4a-179459d2e8ce,-20409.27,debit,cash-withdrawal,AU00000,2023-09-27T05:16:58Z
transaction,65d3b457-882c-45cb-a474-f41878019226,posted,Online Gaming Purchase,-3511.05,f6fc1dab-0924-4536-859e-f68ef9c296a7,15660.47,debit,bank-fee,AU00000,2023-12-06T09:12:17Z
transaction,8b90fd50-ab75-4fd1-8b33-80f85e2ce8aa,posted,Pharmacy Purchase,-3221.11,d2ea48e9-0873-491b-adbf-1a2eb6e204d0,12439.36,debit,payment,AU00000,2023-07-02T01:14:26Z
transaction,ef325503-a5e6-4df0-97a5-1f86ac61ce8f,posted,Electricity Bill Payment,-3449.34,36e1152e-645e-44ae-b326-b01f6daa1c1d,8990.02,debit,bank-fee,AU00000,2023-09-02T11:00:28Z
transaction,e9a16af1-d942-41e5-8491-e1d57155b846,posted,Car Maintenance Expense,-4168.86,64ae8f21-f1ec-4872-b2fb-5f47fa9dff08,4821.16,debit,bank-fee,AU00000,2023-07-18T02:10:07Z
transaction,d36aeede-3cac-4940-935e-1a7e45f16630,posted,Clothing Store Purchase,-3971.97,62b6c4e4-5e86-4eb0-9c20-fc4b0ac6732a,849.19,debit,bank-fee,AU00000,2023-08-27T14:08:49Z
transaction,29d9c8c6-a179-4089-ab16-1c848795a002,posted,Gym Membership Fee,-910.11,fdbabff8-db86-47df-9b4c-17425b4436c2,-60.92,debit,bank-fee,AU00000,2023-06-21T11:09:21Z
transaction,3699165d-39e9-4b7e-aff8-f5a4893cb21d,posted,Online Gaming Purchase,-4889.74,ce323965-3ed9-4ad4-83d6-9a7ca1951ff9,-4950.66,debit,payment,AU00000,2024-01-06T15:17:34Z
transaction,f30d2f3f-5e4d-45d7-a1e2-8def83d00e4f,posted,Gym Membership Fee,-1066.07,210494c8-c5e1-48d2-a9b2-231e487a1e18,-6016.73,debit,bank-fee,AU00000,2023-12-31T10:19:02Z
transaction,d1003ef0-8e7b-48b8-b0b5-dd123b112517,posted,Electricity Bill Payment,-1191.03,5357a8d3-0b45-4a30-9637-a23d7a15d93a,-7207.76,debit,cash-withdrawal,AU00000,2023-06-30T04:34:31Z
transaction,d02d79dd-4e3f-44c8-9834-f5e0a47b0c5b,posted,Amazon Online Shopping,-4667.33,1d954e95-884a-4c15-b829-c7cefdad4c9f,-11875.09,debit,cash-withdrawal,AU00000,2023-08-21T05:30:04Z
transaction,e4a2b086-9132-4bc8-8f2d-298152c09c6a,posted,Clothing Store Purchase,-2069.95,e81a3f86-33cf-48f1-95ac-8a74f37e7c7b,15381.46,debit,cash-withdrawal,AU00000,2023-11-09T19:13:13Z
transaction,19db2b75-3563-4953-a12c-2e070e002e68,posted,Coffee Shop Purchase,-4802.65,dd89d6e3-0197-4503-a3a8-cda3535777b6,10578.81,debit,cash-withdrawal,AU00000,2023-08-20T23:25:06Z
transaction,f58181d8-83a4-4126-adaf-c8cd49d7014d,posted,CTRLINK CARERS Ref: 998R6789201610974V,-4091.82,61a03faf-f149-4494-b4a4-25a5ae39d99b,6486.99,debit,cash-withdrawal,AU00000,2024-01-07T11:39:04Z
transaction,103e106a-b0c7-444d-9189-efaea35fa697,posted,TFR Acc14000 TO 12389,-1762.53,0aaa9562-65f2-477b-81e7-fb917bb9b726,4724.46,debit,cash-withdrawal,AU00000,2023-06-03T14:43:11Z
transaction,9001a28d-45c2-4d84-aa81-3545042398a7,posted,Gym Membership Fee,-377.66,342e362a-0eee-4ab9-a864-f1e9aefbe5c7,4346.8,debit,cash-withdrawal,AU00000,2024-02-26T15:39:03Z
transaction,73f76b2d-64ab-4638-a212-cef3925f8a7f,posted,Transfer Platnm Homeloan 346454,-4379.25,b99072b2-aea5-4a16-bfb1-3ccf1f8270b9,-32.45,debit,payment,AU00000,2023-10-14T05:44:04Z
transaction,c1b3c408-70ad-4808-97fb-eb8179b4bfa7,posted,Clothing Store Purchase,-835.16,ad16a94b-8fad-410e-96e2-caa9e46d867e,-867.61,debit,cash-withdrawal,AU00000,2023-07-15T17:40:04Z
transaction,4d48c5ad-fe71-4fa2-a22d-4ffd740fbacd,posted,Payroll WFRMS 15439393,10926.38,73c81651-2a32-433f-a3c6-0cbfa38c901d,10058.77,credit,transfer,AU00000,2024-01-20T22:28:36Z
transaction,c6d0f82a-f3b6-4f08-b2ba-ee0b2c0a60af,posted,Public Transport Fare,-3523.59,668753b4-f0c9-426f-a24c-0db08a741cad,6535.18,debit,cash-withdrawal,AU00000,2023-09-09T11:35:43Z
transaction,b418d3de-078a-4107-9673-010217f7a590,posted,Travel Agency Booking,-2692.67,0a749197-0303-4047-b972-825752e71190,3842.51,debit,payment,AU00000,2023-09-03T18:48:26Z
transaction,453dd95b-51d1-4c49-8315-62c0f8dccd8a,posted,Mobile Phone Bill Payment,-3113.8,417012fb-664d-426e-97a4-04ce2448f783,4635.92,debit,bank-fee,AU00000,2023-12-15T20:18:44Z
transaction,76056370-2b24-4712-8e3f-9bef870fba79,posted,Hair Salon Appointment,-3888.02,368466da-0aa8-449c-b4f3-32b5ed1c65fe,747.9,debit,cash-withdrawal,AU00000,2023-08-01T16:39:54Z
transaction,c095595a-e3ec-4237-a4c7-e3bead760db4,posted,Payroll WFRMS 15439393,10468.55,7cbb65cc-3aa5-4f43-8d81-900fc00e130c,11216.45,credit,transfer,AU00000,2023-07-13T07:11:02Z
transaction,bceae573-d647-439f-aad8-4ad3ddc07283,posted,Netflix Subscription,-1631.39,902d194c-e8d9-461c-8a22-f9f12c51d36c,9585.06,debit,bank-fee,AU00000,2023-11-26T20:39:30Z
transaction,1fdbb009-3b2e-4ebe-8644-49185d0c30f0,posted,Wdl ATM WESTPAC IGA BALGOWLAH BALGOWL AU,-4973.6,dce5f6a7-cf82-430d-ba3f-eec501ede96b,4611.46,debit,cash-withdrawal,AU00000,2023-10-26T13:13:12Z
transaction,03200550-0da8-43e1-bc6f-4b5bd4ed7c7c,posted,TFR Acc14000 TO 12389,-1334.12,87d7c38d-f6b8-4d97-a16d-26d0fa4a8ad2,3277.34,debit,payment,AU00000,2023-09-20T20:29:58Z
transaction,5e579f1b-634f-41e6-bbb0-72ad4b952a83,posted,Car Maintenance Expense,-4897.11,d0d13b00-d3ad-4a76-9673-145045befbc2,-1619.77,debit,payment,AU00000,2023-10-22T17:53:22Z
transaction,abd5a99d-40be-4e57-bd8f-bb2f16bafa5c,posted,Music Streaming Subscription,-3310.95,8338682c-2e8d-4f36-8c66-d57d1d829c15,-4930.72,debit,bank-fee,AU00000,2024-04-27T13:08:27Z
transaction,24e85029-f41a-4194-86d2-ad7fbf9e5746,posted,Mobile Phone Bill Payment,-6.38,e118d159-2403-449b-8676-8c706d97d602,-4937.1,debit,bank-fee,AU00000,2024-03-26T18:25:13Z
transaction,59e3b511-1c2c-4972-88e8-f9d67684ed4d,posted,Uber Ride,-1525.22,7f6091ec-3cdc-471e-becc-c4a8f3b833b1,-6462.32,debit,bank-fee,AU00000,2023-05-30T19:57:12Z
transaction,a94e4060-6b9b-4b47-b3d3-dd4760d86ad4,posted,TRANSFER TO JOANNA SMITH CAMPING,-3800.17,9d4dab4c-8d88-4332-91f1-79019f1bf4a1,8427.73,debit,bank-fee,AU00000,2023-05-18T11:12:11Z
transaction,87727bc5-9a11-492a-a650-b3577c43743a,posted,Public Transport Fare,-3987.47,33dbc60e-b9da-4ca1-b109-5bae442538e2,4440.26,debit,payment,AU00000,2023-12-24T14:26:03Z
transaction,5584df28-9898-492d-8352-c114bcfd4b6e,posted,TRANSFER TO JOANNA SMITH CAMPING,-4399.54,13019bd7-d91a-4373-8494-f7fa0766c9fb,40.72,debit,bank-fee,AU00000,2024-01-25T12:43:26Z
transaction,fe29be3a-da54-409b-a216-17d4af0887e5,posted,Uber Ride,-2166.89,32efb0fd-7cab-427a-b281-a2bc589f2a17,-2126.17,debit,cash-withdrawal,AU00000,2023-10-13T07:45:07Z
transaction,76312856-e4b5-4833-b6a7-59825c655a50,posted,Coffee Shop Purchase,-967.63,5023f61d-b757-453a-b3fa-2a7c36845a9d,-3093.8,debit,payment,AU00000,2024-01-28T09:07:02Z
transaction,dfc1fe93-d4d6-4e2e-a7df-ad995e9a7f7a,posted,TFR Acc14000 TO 12389,-295.55,bd2a88c0-e0b2-41d6-9b2a-5003622be8ee,-3389.35,debit,bank-fee,AU00000,2023-06-02T07:34:44Z
transaction,c17bb600-211e-4acb-a832-3e7bb512f0e6,posted,Bookstore Purchase,-4517.98,087e01ac-3d5e-478e-ba0f-6f5f3002de7b,-7907.33,debit,cash-withdrawal,AU00000,2024-03-24T10:36:55Z
transaction,0ef6cc10-0684-4810-89ef-0d0e1cd3808f,posted,Transfer Platnm Homeloan 346454,-847.77,706c09bd-2bb4-478a-a2d1-b0380e00e189,-8755.1,debit,cash-withdrawal,AU00000,2023-05-14T17:20:44Z
transaction,27776d0f-f12d-4b1d-be39-c4268592a917,posted,Restaurant Dinner,-4960.24,1df19405-1c29-4902-acac-ed31999924df,-13715.34,debit,cash-withdrawal,AU00000,2024-01-08T14:03:54Z
transaction,dfb4407d-4cb5-4905-984a-255eda0aba6b,posted,Public Transport Fare,-2164.34,26bb696d-8753-4497-b03b-d8dd7caafcd1,-15879.68,debit,cash-withdrawal,AU00000,2023-08-28T10:24:23Z
transaction,d7c1c419-60bf-4a0a-a878-047825556ec9,posted,Netflix Subscription,-4290.86,37d235e8-a790-4772-ab98-d112debc1dac,5276.54,debit,payment,AU00000,2023-09-03T12:18:03Z
transaction,ac1130f1-7413-4d97-9552-cf49d54715fd,posted,Payroll WFRMS 15439393,10070.9,49699097-2259-41d2-a1c7-32afb6fbd146,15347.44,credit,transfer,AU00000,2023-10-21T12:07:58Z
transaction,07906720-2fc5-4d25-b559-ea0d777cb1d5,posted,Mobile Phone Bill Payment,-1964.82,5db0b45c-4b4f-41f2-9d26-57e4572fc399,13382.62,debit,cash-withdrawal,AU00000,2024-01-14T13:57:45Z
transaction,a89da29f-f075-456b-a363-7d580facbb89,posted,Wdl ATM WESTPAC IGA BALGOWLAH BALGOWL AU,-1877.56,6745719f-dda9-4c4c-9610-a55229cf5e80,11505.06,debit,payment,AU00000,2023-06-08T22:27:44Z
transaction,0d8ebfc1-8caf-4dac-8bbc-06ef15b8e317,posted,Bookstore Purchase,-4727.73,a78955dd-4911-4427-9784-21fa52c053bc,6777.33,debit,payment,AU00000,2023-09-10T13:14:38Z
transaction,1cb5fac5-7288-41d2-845a-7838630d67f3,posted,Music Streaming Subscription,-2849.02,35f4b850-9780-43db-b601-d6c8a3f49104,3928.31,debit,payment,AU00000,2023-07-21T09:05:46Z
transaction,c25976c5-9933-486b-a15f-8c61de2db092,posted,Movie Ticket Purchase,-249.57,9a543855-627f-4097-a2b7-ec6331b39916,3678.74,debit,bank-fee,AU00000,2024-02-06T04:05:49Z
transaction,2549f4d9-ae31-46d7-b212-8372f4315048,posted,CTRLINK CARERS Ref: 998R6789201610974V,-2463.71,23b3410e-a395-4454-b4b5-5f82f15f5ddd,1215.03,debit,cash-withdrawal,AU00000,2023-06-21T22:05:24Z
transaction,84604573-392e-4db4-ab92-699f02523699,posted,Clothing Store Purchase,-3237.08,d5f16bac-55f0-4b30-bdfd-a33630bb9a58,-2022.05,debit,cash-withdrawal,AU00000,2023-07-09T05:32:44Z
transaction,cb364533-d1f0-4aaa-a2ec-e9a597a1d41d,posted,Electricity Bill Payment,-1076.15,76703f01-bf5a-49d0-9379-14cf175ba2dd,-3098.2,debit,cash-withdrawal,AU00000,2023-08-26T07:28:34Z
transaction,bfffd257-4d26-4cbf-8855-998be837d387,posted,Bookstore Purchase,-1867.76,1b355bf8-88a3-48ce-9ce5-7c28b0d489f0,10474.67,debit,bank-fee,AU00000,2024-04-27T02:09:05Z
transaction,f40cf379-de83-4bae-8e49-8fc975b7bed0,posted,Movie Ticket Purchase,-188.89,cbed02c9-41f5-4ad0-aef3-470e5e6b005e,10285.78,debit,bank-fee,AU00000,2024-04-16T19:22:18Z
transaction,19b23481-b215-41f9-9550-73f61cf715d6,posted,Car Maintenance Expense,-3106.32,9d886425-1448-4b20-97d9-dc0e81567629,7179.46,debit,payment,AU00000,2023-09-01T21:01:08Z
transaction,d4faae6f-4694-4214-878e-e10b489c5de9,posted,Coffee Shop Purchase,-4122.16,0bef81f5-989f-4c70-a626-0ca62ece4984,3057.3,debit,payment,AU00000,2023-10-09T20:13:51Z
transaction,85c8415c-8332-416a-9b6e-8ac5c9be0114,posted,Electricity Bill Payment,-2110.57,4d5af96b-f99f-45c6-ba9c-7a2094856ccd,946.73,debit,cash-withdrawal,AU00000,2024-02-09T10:00:15Z
transaction,7f5a4a50-a2b1-4746-929c-c93373845a59,posted,Transfer Platnm Homeloan 346454,-4322.05,92b533b6-ddce-4183-bd95-0600a3a6c666,-3375.32,debit,bank-fee,AU00000,2023-09-26T17:01:47Z
transaction,aef7d609-7c62-4ec0-ad12-873640c53adc,posted,Uber Ride,-2812.07,6f98ee2e-05d7-400b-abab-39d3233f9679,-6187.39,debit,bank-fee,AU00000,2023-11-24T15:37:19Z
transaction,a1887298-cc37-43e1-845d-240bbbba9bc4,posted,Clothing Store Purchase,-75.31,d1c6dd8c-f6f2-45a1-aca2-865075fb422b,-6262.7,debit,payment,AU00000,2024-01-25T05:02:42Z
transaction,839dd77c-a4a1-44bc-baff-a8f676a70bd4,posted,Music Streaming Subscription,-1425.94,54d2fc0d-5b6e-4618-94d3-713deb3888b8,-7688.64,debit,payment,AU00000,2024-01-20T00:20:48Z
transaction,b10f7303-115d-4077-aaba-1d1fd45b02ae,posted,Gasoline Purchase,-41.8,cbe48d1b-5bac-4054-a608-e0051ff25531,-7730.44,debit,bank-fee,AU00000,2024-05-05T05:27:37Z
transaction,99fec8d3-e818-4dcd-97e0-e7e09b0182a7,posted,Travel Agency Booking,-2185.05,8f61d897-6c1a-46bc-a95f-0114d0add5ee,12342.68,debit,bank-fee,AU00000,2023-07-11T07:01:25Z
transaction,722f6a77-6162-471f-987a-fadb67aaadb0,posted,CTRLINK CARERS Ref: 998R6789201610974V,-61.01,2ebe264f-bda1-4b50-bf1b-b1c214b23abb,12281.67,debit,payment,AU00000,2023-10-28T05:42:33Z
transaction,cf902683-e90b-49e9-a378-05f6a761793c,posted,Wdl ATM WESTPAC IGA BALGOWLAH BALGOWL AU,-4092.59,d56e16a3-e919-464b-9240-6fd04df8572a,8189.08,debit,bank-fee,AU00000,2023-05-24T02:20:19Z
transaction,19bb99c4-c273-4447-82ed-bb4ad05cc0e1,posted,Restaurant Dinner,-3030.9,e7820a03-342b-424b-8721-6b21682c4d60,5158.18,debit,payment,AU00000,2023-09-02T22:57:23Z
transaction,f5fcce9b-2784-4510-bc7a-a946801bdbef,posted,Payroll WFRMS 15439393,11884.68,f19b8ea4-3d04-4cc1-8516-148199031fec,17042.86,credit,transfer,AU00000,2024-05-10T18:52:20Z
transaction,57126d88-791d-4f34-82a5-1d4e3002e6e9,posted,Pharmacy Purchase,-676.21,ab3012cd-02d2-451c-9f93-8f8bc48a9fb4,16366.65,debit,cash-withdrawal,AU00000,2024-03-09T00:11:08Z
transaction,477cef36-619e-4066-a613-670be03c53e9,posted,TFR Acc14000 TO 12389,-67.3,6b2bfcf5-60db-471c-802a-c293a7669d03,16299.35,debit,bank-fee,AU00000,2023-09-12T03:59:57Z
transaction,f8a75823-3bcd-4ee3-a653-5f7d62abe7ea,posted,Hair Salon Appointment,-122.65,e94d5301-6504-40e5-9ba3-1bd3fd0f411a,16176.7,debit,bank-fee,AU00000,2024-02-13T16:24:42Z
transaction,a2c9fcdc-93b2-43f7-84e2-af334855743f,posted,Wdl ATM WESTPAC IGA BALGOWLAH BALGOWL AU,-3665.28,90c05870-f62d-4115-8dfa-77ec77f2768d,12511.42,debit,cash-withdrawal,AU00000,2024-02-27T13:59:52Z
transaction,43e3e88a-36dc-42c0-88b9-a188817946b1,posted,Mobile Phone Bill Payment,-2504.71,1f323829-0b41-44a3-981d-fe348df39953,10006.71,debit,cash-withdrawal,AU00000,2024-01-07T00:04:09Z
transaction,a80f9c41-4568-4589-84d9-7ccb08780f5b,posted,Transfer Platnm Homeloan 346454,-4438.18,93a98102-7353-43fe-9f0e-8d5b7b149a81,7443.41,debit,payment,AU00000,2023-11-11T06:33:21Z
transaction,9cfc4863-d0e7-4f2d-8825-3dd6c3da28a2,posted,Hair Salon Appointment,-2099.62,f7d1da04-30d6-4dab-931d-8f110c18fb43,5343.79,debit,cash-withdrawal,AU00000,2023-12-12T12:39:48Z
transaction,1424d75b-fe1e-4c07-9121-f1771e5968fe,posted,Payroll WFRMS 15439393,11450.3,ede9a6c1-52f2-467f-8798-a370f267f097,16794.09,credit,transfer,AU00000,2024-02-17T14:25:51Z
transaction,7c0706ad-c953-487a-99e9-1d308089c3bb,posted,Non Hooli ATM Withdrawal Fee,-3094.46,5ed76227-1040-4946-b742-2a0fdfbef22f,13699.63,debit,cash-withdrawal,AU00000,2023-09-06T06:03:22Z
transaction,b033c231-916b-4e7d-ad83-e3c1e0767db8,posted,TRANSFER TO JOANNA SMITH CAMPING,-1275.05,6d47cf94-aa13-4a0d-8405-993c442922f3,12424.58,debit,cash-withdrawal,AU00000,2024-04-30T17:59:06Z
transaction,0c1a0292-dc80-4d1f-9fa1-2cef3b589363,posted,AGL RETAIL ENERGY LTD (GAS),-4864.74,9195234a-14ab-4585-b7a0-b2bdd7d17b5b,7559.84,debit,payment,AU00000,2024-03-21T02:40:13Z
transaction,01ccc5a9-c3b3-4f00-8c2c-b7168753e507,posted,Gasoline Purchase,-2455.33,55433426-5bd3-4bef-a8de-fc45ccba35db,5104.51,debit,payment,AU00000,2023-09-23T15:30:58Z
transaction,df0a8cff-05e9-451e-a8a0-4e168d74c051,posted,Music Streaming Subscription,-2639.91,3f60be5e-eef1-4f88-b6a1-f254ce926c34,2464.6,debit,bank-fee,AU00000,2024-03-26T13:15:46Z
transaction,8fbb49ec-69bf-4bfb-a69b-3b7201ef7751,posted,Coffee Shop Purchase,-1417.99,7fc3f45f-3cc6-4624-b7c6-f776d02c1608,1046.61,debit,bank-fee,AU00000,2023-10-09T02:39:09Z
transaction,341042c7-a007-491b-9abe-bf5445f2ec0c,posted,Pharmacy Purchase,-2290.43,702ce8dc-d92d-4d4f-b659-6e086eb94c2a,-1243.82,debit,cash-withdrawal,AU00000,2023-09-27T04:41:48Z
transaction,69d359b1-f9d6-46e8-8858-fd0fedc499f9,posted,Coffee Shop Purchase,-394.35,d9d39ad3-68b0-4595-9f94-b364eda0f43c,6268.06,debit,bank-fee,AU00000,2023-08-28T09:17:27Z
transaction,1f6eab40-9d38-4739-8558-82e308403b08,posted,Netflix Subscription,-4324.25,92d7760e-824f-4640-a02b-f79a5fa8afb9,1943.81,debit,bank-fee,AU00000,2023-05-13T01:28:11Z
transaction,96d2eeb6-b859-49db-87ca-606f3144ff1a,posted,AGL RETAIL ENERGY LTD (GAS),-1103.28,03fb4b6c-a725-43b8-b50a-e67f3f9bc33f,840.53,debit,payment,AU00000,2023-06-22T17:21:59Z
transaction,7140dc5e-f47b-4058-8cc9-46e109a29857,posted,Travel Agency Booking,-2843.87,a9446fad-0b52-4ccf-b6d4-9524bcee9e0d,-2003.34,debit,payment,AU00000,2023-12-19T06:08:04Z
transaction,e7a75f08-e454-4ea3-a2e3-4d3788093afe,posted,Online Gaming Purchase,-3959.51,655c4c03-c42f-4ca8-b892-7cff73148844,-5962.85,debit,payment,AU00000,2023-06-05T05:59:48Z
transaction,defab37f-8fe3-427d-89c1-2d0ab226e2fb,posted,Mobile Phone Bill Payment,-3264.15,6c4715a4-91e9-496c-be01-df3b196221d7,-9227.0,debit,cash-withdrawal,AU00000,2023-11-26T13:54:44Z
transaction,c7316eff-9242-4825-a301-0a351bc50d9b,posted,Bookstore Purchase,-4880.91,f030b777-2d24-4657-b82c-64da4fcffe04,-14107.91,debit,payment,AU00000,2023-07-17T01:16:33Z
transaction,e2f180ba-b368-40d8-8e8a-7607aeb900f2,posted,TRANSFER TO JOANNA SMITH CAMPING,-1795.01,23273050-9b76-46f7-83e8-8ee9ed6b0572,-15902.92,debit,bank-fee,AU00000,2023-06-01T07:43:32Z
transaction,2a198bbc-cc48-473e-90b6-7e69bb887a09,posted,Uber Ride,-3051.78,05f7834b-2ee2-458d-b590-a81f111a77ab,-18954.7,debit,bank-fee,AU00000,2024-03-18T13:57:49Z
transaction,59f90cfa-c8f3-4006-a4e0-eb50be6ca851,posted,AGL RETAIL ENERGY LTD (GAS),-1019.96,1116ec07-9c55-436c-adf9-9b85722c9afb,-19974.66,debit,payment,AU00000,2023-06-02T08:33:02Z
transaction,b867dd02-e432-4a9a-ab70-24c6e7bd979a,posted,Transfer Platnm Homeloan 346454,-857.3,89a8657e-5003-4faa-8d46-f7e05893f23a,11786.03,debit,bank-fee,AU00000,2024-01-31T04:29:52Z
transaction,028491c3-7f44-406b-a7f0-86724ccc45f6,posted,Amazon Online Shopping,-81.33,17796bcd-3747-4ece-b8cc-b04baa1f3c21,11704.7,debit,bank-fee,AU00000,2023-11-12T21:46:08Z
transaction,6dad041b-34a7-4354-9d59-fdd51c994c4f,posted,Electricity Bill Payment,-1619.95,de135758-50ef-44e1-9516-20933a02dd2f,10084.75,debit,bank-fee,AU00000,2023-07-29T18:02:36Z
transaction,793f8e57-1be2-40b6-9fe9-e6423f445413,posted,Uber Ride,-2102.52,4189efa9-7866-4bd4-afd0-d672b6dc0ff4,7982.23,debit,payment,AU00000,2023-09-28T09:22:35Z
transaction,b7b519c2-ce89-4623-b6ec-6be13c07b2b4,posted,Gasoline Purchase,-1560.79,17bdc5bc-55c4-4a7d-9739-ff0f7ee27d7b,6421.44,debit,bank-fee,AU00000,2023-05-27T14:59:47Z
transaction,67874015-3081-4c7f-ac7d-14b1fdd80184,posted,AGL RETAIL ENERGY LTD (GAS),-2300.85,286cc7af-53af-45d1-8d05-d64802265cdd,4120.59,debit,bank-fee,AU00000,2023-05-20T00:05:30Z
transaction,6c3aaf4a-f46c-486c-86af-6fdb086bfbe3,posted,Restaurant Dinner,-2471.55,526b672f-9b82-49fb-bd0d-63fae97dd1e1,1649.04,debit,bank-fee,AU00000,2023-08-26T02:24:57Z
transaction,8b8eb356-7fba-425c-bbec-38e833102359,posted,AGL RETAIL ENERGY LTD (GAS),-4429.05,91404347-8451-484d-bff5-15b3ac325a3d,-2780.01,debit,cash-withdrawal,AU00000,2023-06-01T00:11:45Z
transaction,a2c53c2d-9c6b-414d-8583-1b2eefc556d2,posted,Home Improvement Store Purchase,-715.71,c284c6de-b6a0-4e51-93a1-21b8d5f59a27,-3495.72,debit,cash-withdrawal,AU00000,2024-03-06T13:26:53Z
transaction,e782e7b6-4101-495e-9ad1-b825f5f3583f,posted,Transfer Platnm Homeloan 346454,-960.97,319cc87f-0ee4-42f9-a4b0-29c15847e4c8,-4456.69,debit,bank-fee,AU00000,2023-07-22T07:13:24Z
transaction,74dd7e9d-e7fd-4be5-8f13-00af8cec5f1e,posted,Coffee Shop Purchase,-4356.3,470a5220-1b00-4d6e-8f54-1d54f2542bc0,2692.81,debit,cash-withdrawal,AU00000,2024-04-18T05:03:37Z
transaction,52b5ccfc-d332-4a54-b9bc-deeb6ef7b3c1,posted,Uber Ride,-4823.3,79f27009-cbfd-4aeb-b6f9-f8161862ac87,-2130.49,debit,cash-withdrawal,AU00000,2023-08-18T15:34:48Z
transaction,bb99ab82-cc75-4c12-b052-48ab3d6a0ba1,posted,Movie Ticket Purchase,-3206.19,cbcba1fc-4bae-400e-ad81-922f1a8afc14,-5336.68,debit,payment,AU00000,2024-01-22T03:41:37Z
transaction,30dcc9e6-3d18-4187-8594-b85a67475b2a,posted,Restaurant Dinner,-4781.9,6aed421f-f5b7-4d16-95ad-5e906dd792f9,-10118.58,debit,bank-fee,AU00000,2023-12-07T20:56:43Z
transaction,bd3c1477-fd00-4650-a759-d3edfe501886,posted,Gym Membership Fee,-785.68,f36d1c80-2d92-4952-ad2d-3027a3ebcf0a,-10904.26,debit,cash-withdrawal,AU00000,2023-06-09T12:32:34Z
transaction,d86c50b2-376e-43df-8b50-6b7daac2b772,posted,Online Gaming Purchase,-2893.94,5242a10d-16d0-4867-8f0f-936044e77674,-13798.2,debit,bank-fee,AU00000,2024-03-21T08:33:31Z
transaction,d4e20ca8-7609-4749-a204-4f8ceb7a2eff,posted,Car Maintenance Expense,-396.47,0c82000b-47aa-4b2f-9f60-913914a212fb,-14194.67,debit,bank-fee,AU00000,2024-04-17T02:58:31Z
transaction,18648001-725c-4b74-be0c-1d0f05307f90,posted,Hair Salon Appointment,-2926.73,65a8b334-29c5-4e7b-864d-b0fdc31eaf06,-17121.4,debit,cash-withdrawal,AU00000,2023-11-27T04:16:31Z
transaction,de20b15e-1333-40aa-b016-81e92cc83489,posted,TRANSFER TO JOANNA SMITH CAMPING,-3793.36,ccdff697-3dc8-437b-82e7-b4ab6bde04a9,-20914.76,debit,payment,AU00000,2023-06-15T07:04:53Z
transaction,e05f2d74-a370-4a76-aed8-072fcf858c01,posted,Online Gaming Purchase,-3234.65,f4e86e3c-1f89-4100-a657-abbbfd841294,-24149.41,debit,cash-withdrawal,AU00000,2023-05-13T03:37:24Z
transaction,26b195c1-515f-44ee-82e5-d0618c706beb,posted,Mobile Phone Bill Payment,-3304.14,d2841cc0-4a7f-4c50-872c-44bbc33f226b,5296.22,debit,cash-withdrawal,AU00000,2023-05-20T00:00:04Z
transaction,735d29d4-41b2-47e0-851e-d1b521d9c78d,posted,Music Streaming Subscription,-1522.67,aa6927d6-8377-4cfd-8912-4cd1fb430256,3773.55,debit,bank-fee,AU00000,2023-10-18T17:26:04Z
transaction,a28669e3-31c5-423c-909c-55013c4e79a5,posted,CTRLINK CARERS Ref: 998R6789201610974V,-396.13,921b9318-dd24-41a6-b887-4524474bed28,3377.42,debit,bank-fee,AU00000,2023-09-06T03:54:54Z
transaction,a3f0c605-1ce5-41b5-98ea-fbf7ea5a8758,posted,Electricity Bill Payment,-4690.66,1b47f90f-ee5f-41d1-a059-099019a4e78e,-1313.24,debit,bank-fee,AU00000,2024-05-01T19:37:06Z
transaction,8ecb0827-1a69-4406-88c0-25dc278799e7,posted,Home Improvement Store Purchase,-637.73,ed9c188e-bb1d-4340-b0bb-8f43e5a6683d,-1950.97,debit,cash-withdrawal,AU00000,2024-03-21T05:34:59Z
transaction,4e33ac7f-6df7-479e-82a8-e5ab0318e80e,posted,Amazon Online Shopping,-4328.29,f0201e0f-0e4a-44c7-a035-34e149e60dba,-6279.26,debit,bank-fee,AU00000,2023-08-29T13:20:58Z
transaction,367d894e-8653-4c27-b087-119d60dcd092,posted,Car Maintenance Expense,-211.74,64604f76-b859-4e61-aadd-64b8546be902,-6491.0,debit,bank-fee,AU00000,2023-12-28T18:05:52Z
transaction,8ebcf36f-b06c-4bae-9eeb-087655207667,posted,TRANSFER TO JOANNA SMITH CAMPING,-4585.07,99194b59-4671-42f8-bf0f-e696b055b40c,-11076.07,debit,bank-fee,AU00000,2023-06-28T19:32:19Z
transaction,3170778c-5222-4677-96f2-8c5769b6ff88,posted,Uber Ride,-2163.8,a495740e-a050-4176-9f78-97d5ed47a6ca,-13239.87,debit,payment,AU00000,2024-03-07T16:18:57Z
transaction,c9574981-56b7-44fa-a967-7ce5148eeecf,posted,Mobile Phone Bill Payment,-687.41,d9b897ce-4e59-415b-baaf-c47662fdf88a,-13927.28,debit,cash-withdrawal,AU00000,2024-02-12T05:00:55Z
transaction,9d72e068-55d1-471d-a2fd-8f15e363b771,posted,Pharmacy Purchase,-3657.75,e5854d76-7489-437a-b56a-0e65ab608283,7764.17,debit,payment,AU00000,2023-10-07T17:37:55Z
transaction,548107d1-bcc2-4a7c-b79e-4ca0c29e5fe8,posted,Restaurant Dinner,-315.14,25e50122-b2b8-4c86-b9fc-31189544f375,7449.03,debit,payment,AU00000,2024-03-15T09:45:53Z
transaction,3a07a5ba-398b-4dff-8b3d-48acabee71bd,posted,Public Transport Fare,-1345.85,4560f05e-ba45-43af-bc92-6e104da3be2d,6103.18,debit,bank-fee,AU00000,2023-09-19T10:47:00Z
transaction,9d4adf57-948f-4ec7-89de-5ee1d55e22b4,posted,AGL RETAIL ENERGY LTD (GAS),-4949.48,a707b36d-1933-43b0-ba42-a2bc726a95b5,1153.7,debit,bank-fee,AU00000,2024-03-28T09:21:25Z
transaction,070bd740-c603-4f65-a049-0238cc24186a,posted,Electricity Bill Payment,-3557.44,d0ec2c01-b3ed-4b67-85db-044a4fbf9efc,-2403.74,debit,bank-fee,AU00000,2023-09-11T06:44:57Z
transaction,1cbc565d-abf9-47fc-b5fa-74f4aa2c6434,posted,Gym Membership Fee,-3963.29,6081ec8b-1db2-48d0-8bb0-e35e44cbd536,-6367.03,debit,cash-withdrawal,AU00000,2024-02-05T03:21:31Z
transaction,9a4d1ec8-1bbd-4a4e-892b-d07d29ef6f03,posted,Uber Ride,-2147.39,848e114d-a704-4218-8298-97639fb6e8a2,-8514.42,debit,payment,AU00000,2024-01-23T13:16:54Z
transaction,07bff8ce-7f37-49ec-91d3-4d7b9f5e66cb,posted,Clothing Store Purchase,-4297.17,2b3aa697-0285-41b3-838e-51c2d2b0be29,-12811.59,debit,bank-fee,AU00000,2024-02-29T20:46:32Z
transaction,64a63a3e-a59b-4c44-afc8-1afcdabf1490,posted,Bookstore Purchase,-3066.95,2818a5db-38ca-46b0-afe4-40e65ac15b5a,-15878.54,debit,payment,AU00000,2023-05-22T13:48:47Z
transaction,1ce42882-8dea-4d05-9c96-3dbba79b65cc,posted,Online Gaming Purchase,-472.12,1af9ec43-3f7c-49c2-a8e3-cf9cfe08d619,-16350.66,debit,cash-withdrawal,AU00000,2024-05-05T22:45:24Z
transaction,b4a8ff9d-a9d8-4767-9b27-36197ad62105,posted,Restaurant Dinner,-4061.78,02c3f50d-1326-4193-bbd8-bded15da249c,7660.6,debit,payment,AU00000,2023-07-01T03:31:04Z
transaction,3894ab87-d66f-4df5-ad5d-7b5d720fd078,posted,Manly Maths Tutor Wages,-4149.05,30ed8989-7612-478a-aeb3-ea5c536b8255,3511.55,debit,bank-fee,AU00000,2023-08-15T04:38:24Z
transaction,070128b5-39d1-466e-97ce-ea23413b1bc7,posted,Payroll WFRMS 15439393,10043.62,57aaf3a3-802f-44b0-9688-9f8a4508d45d,13555.17,credit,transfer,AU00000,2024-01-20T17:17:37Z
transaction,e759fff6-8664-4fe4-8095-a078700208a5,posted,Amazon Online Shopping,-4240.53,97497044-b6b8-4d59-a3a1-e1a9a68b3e10,9314.64,debit,cash-withdrawal,AU00000,2023-07-08T17:59:53Z
transaction,24c6b95b-6815-463d-bf48-ac1840d645f8,posted,AGL RETAIL ENERGY LTD (GAS),-3951.8,84a7bef3-8221-4c7f-8c9e-315d459e444a,5362.84,debit,bank-fee,AU00000,2023-07-05T17:09:40Z
transaction,08c256ef-9f5a-478a-9c7b-2a6644804fd0,posted,Music Streaming Subscription,-107.08,8717b4ff-d950-4f7d-881c-5df06937465b,5255.76,debit,payment,AU00000,2023-05-29T22:17:39Z
transaction,6302a8e8-0879-4b42-99dc-bce2a98e704b,posted,Movie Ticket Purchase,-2834.62,4f031532-d22b-405e-8ea6-0766039ef93d,2421.14,debit,bank-fee,AU00000,2023-06-11T02:35:30Z
transaction,0ae8f204-42e1-4839-a5b3-dbac2c33f1f1,posted,Gym Membership Fee,-4539.87,38dd0922-4941-46bf-875d-d883c273d006,-2118.73,debit,bank-fee,AU00000,2023-10-04T04:39:21Z
transaction,23d8ca4f-c13b-4d09-bd53-90f210026681,posted,Mobile Phone Bill Payment,-4023.26,5a4a1abf-06a8-4191-8d05-f631726e2d8b,-6141.99,debit,payment,AU00000,2023-09-21T07:34:10Z
transaction,4ddd8fa4-55a4-44d0-9838-376c6e724e3d,posted,Non Hooli ATM Withdrawal Fee,-1045.1,5d230d50-1e98-41e6-8b5c-7d5dd471aa94,-7187.09,debit,bank-fee,AU00000,2023-11-10T09:42:00Z
transaction,f9a45044-75e9-41ea-8a40-e5108afc30ee,posted,Transfer Platnm Homeloan 346454,-759.08,cfcc7875-92a5-4fcb-981c-4035a822cffd,14327.96,debit,cash-withdrawal,AU00000,2023-05-23T05:00:57Z
transaction,2ee92acd-d4ac-49ff-b714-f0c7975ea213,posted,Movie Ticket Purchase,-4080.8,0dba5836-3364-4eff-a432-4a4338376aa0,10247.16,debit,bank-fee,AU00000,2024-05-02T23:44:01Z
transaction,ed4bc55a-b327-456f-b0c4-8060e762eb94,posted,CTRLINK CARERS Ref: 998R6789201610974V,-3361.6,5030a984-872d-4a61-8cf0-da652664eaae,6885.56,debit,bank-fee,AU00000,2023-06-02T06:08:39Z
transaction,ec2fa4d0-b0d1-41c9-a7c8-916a16fe18e6,posted,Non Hooli ATM Withdrawal Fee,-39.56,1f19a4ba-0ce6-4aec-bcca-44f834ac0a1f,6846.0,debit,cash-withdrawal,AU00000,2023-06-27T16:30:03Z
transaction,211dae9d-7b8d-43be-9c2d-284c49f1007d,posted,Bookstore Purchase,-1308.27,440833f3-a9ec-4597-b662-73ad8a95d821,5537.73,debit,payment,AU00000,2023-05-12T17:19:37Z
transaction,b7f1209c-8f8d-4f0b-a523-a378aec6ecba,posted,TFR Acc14000 TO 12389,-4881.67,a7d4a206-b642-4cbb-8efc-064e9ab821a5,656.06,debit,bank-fee,AU00000,2023-11-23T05:31:11Z
transaction,b311a4b2-0a39-41bb-91a4-4ac1964d3418,posted,Netflix Subscription,-4363.93,76e3aac2-99ea-4152-9690-2a763f1ec220,-3707.87,debit,bank-fee,AU00000,2023-11-03T09:25:19Z
transaction,1698f42b-7a0e-4cb4-84a2-ea3813645395,posted,Home Improvement Store Purchase,-673.21,993e492b-df17-4e44-9d16-75f1e938c5a5,-4381.08,debit,cash-withdrawal,AU00000,2023-09-20T05:40:32Z
transaction,a7ff8177-07c4-444a-9e67-4b1e47402d14,posted,Clothing Store Purchase,-4113.01,910a1f3b-6ee6-454a-9c4c-34954b45b06b,-8494.09,debit,cash-withdrawal,AU00000,2023-10-15T11:48:50Z
transaction,5acd8c36-8289-4b2d-b604-35e99b78cfd6,posted,Home Improvement Store Purchase,-1096.74,90d424d0-aaae-43d8-96db-b6dd655435a9,-9590.83,debit,cash-withdrawal,AU00000,2023-07-22T07:14:49Z
transaction,4fc01cff-063a-4cdc-a7ab-45018637a1cc,posted,Coffee Shop Purchase,-3164.99,fa8df7dc-5ee6-42ad-b16f-f39a0a03fa55,16055.74,debit,payment,AU00000,2023-07-21T22:28:32Z
transaction,091fa64f-c8b2-408d-8da6-804761337fb7,posted,Gym Membership Fee,-2064.25,c29100e7-7308-42c2-a4d2-956324c239f3,13991.49,debit,payment,AU00000,2024-01-26T03:57:32Z
transaction,627c2ec3-7080-47e5-a5cf-3a074ce0f8b4,posted,Online Gaming Purchase,-546.14,78bf7249-7439-442a-abd0-bef5d3a1a08a,13445.35,debit,payment,AU00000,2024-01-25T07:35:33Z
transaction,37a4493f-1595-49b9-b8de-1a3e3b254eb7,posted,Electricity Bill Payment,-3735.06,7d1e4fa8-5063-4ec0-b069-a8a4275c7dd2,9710.29,debit,bank-fee,AU00000,2023-07-30T09:37:39Z
transaction,f19900d8-3709-4381-a6e2-974220822a72,posted,Uber Ride,-613.67,7dbcf6ae-6004-4264-940f-b084f902ba6d,9096.62,debit,bank-fee,AU00000,2023-11-06T12:48:55Z
transaction,b1e3b741-eee1-462e-937a-3b1b9511dfab,posted,Hair Salon Appointment,-4371.95,b22c6133-b77f-4fd2-b6fe-65295a136839,4724.67,debit,bank-fee,AU00000,2024-02-20T09:44:25Z
transaction,8e32f324-125a-423d-88a5-733b173bc7d2,posted,Netflix Subscription,-3135.92,2cbc97e2-5460-4eed-b420-276e0a39759f,1588.75,debit,cash-withdrawal,AU00000,2023-06-09T04:58:44Z
transaction,3f0b5ae3-8857-430e-bd43-50c1c0f8d24a,posted,Travel Agency Booking,-125.22,d0cf0d32-1825-448a-9d7b-ec27d7809601,1463.53,debit,payment,AU00000,2024-04-18T10:48:18Z
transaction,720cf534-4ad1-4618-a63c-784277a42d99,posted,Netflix Subscription,-2268.9,2b339450-20ef-4848-a28a-55387b281a6c,-805.37,debit,bank-fee,AU00000,2023-07-07T02:42:45Z
transaction,f9f3c3cf-a033-4e44-8f57-17fd512441e4,posted,Car Maintenance Expense,-1552.99,46ff8f05-2994-4650-aa5a-892ed0d2c8e6,-2358.36,debit,payment,AU00000,2023-12-17T01:34:28Z
transaction,50e3f216-1d7c-45ba-88de-3bcc74f3be4e,posted,Pharmacy Purchase,-2946.14,332d37c2-dce2-4955-8705-cf378bf3cef3,11585.41,debit,payment,AU00000,2023-09-06T19:43:02Z
transaction,e65d964b-1e40-4814-b9a9-8b14d0620e37,posted,Bookstore Purchase,-4168.42,6dd071d3-8b61-4c19-9cbb-da2a83ed2442,7416.99,debit,bank-fee,AU00000,2023-06-15T19:33:46Z
transaction,c79b0851-2ef1-459a-b006-9ab28529f407,posted,Clothing Store Purchase,-2119.51,86f2a6bc-4ba5-4fd7-8384-2a837136025f,5297.48,debit,cash-withdrawal,AU00000,2023-08-06T14:19:03Z
transaction,03a9ddf6-9f8a-485a-bdca-de2faede1190,posted,Clothing Store Purchase,-3975.04,4c724098-79ca-4721-8387-417f0a619276,1322.44,debit,payment,AU00000,2023-12-30T16:08:32Z
transaction,ce4812cb-a5ad-41b8-a17a-4240c27ca7b7,posted,Electricity Bill Payment,-425.33,64490356-9a81-455f-ad33-797a9c346232,897.11,debit,cash-withdrawal,AU00000,2023-06-14T13:51:56Z
transaction,003d6a2e-f148-423e-8302-376157e6d202,posted,Gasoline Purchase,-1970.13,c6ee9f56-89d0-4b52-acbb-4a5f767cd6f7,-1073.02,debit,cash-withdrawal,AU00000,2023-12-03T11:43:25Z
transaction,92c98a2c-75d1-4a3a-ab8b-74f2206a5986,posted,Gasoline Purchase,-4171.01,d27e5165-5c8b-46cd-b1a3-2197c9c6e16c,-5244.03,debit,bank-fee,AU00000,2024-03-06T06:40:12Z
transaction,79d54a03-1e34-4e1c-91cc-50ec4a26f9f0,posted,TRANSFER TO JOANNA SMITH CAMPING,-3472.44,abf3b99a-2b0c-453d-aab8-9b0b0c93d8a4,-8716.47,debit,payment,AU00000,2023-12-15T01:31:36Z
transaction,e4d4b245-8923-4762-bc0c-d1ffceacfc42,posted,TRANSFER TO JOANNA SMITH CAMPING,-943.26,4425d5c5-d054-41ba-b88d-b76e1416f2a1,-9659.73,debit,bank-fee,AU00000,2024-03-11T12:10:26Z
transaction,32eaf494-98fd-4344-ad74-c5c624372aa0,posted,Amazon Online Shopping,-831.38,2b35274a-2393-4d9f-9abc-69947431c044,-10491.11,debit,payment,AU00000,2023-12-23T16:51:27Z
transaction,55fa27b5-025d-4006-b4ad-488a7376ac50,posted,Netflix Subscription,-4893.72,8565f4e9-c356-4f69-97b3-cc5bd0ea9c47,11863.73,debit,cash-withdrawal,AU00000,2023-05-22T03:55:52Z
transaction,f3d83974-4d4b-4fc2-b347-539482e14dcb,posted,Amazon Online Shopping,-2610.48,fe77658c-1f45-4f1d-bfb3-ff40dc9ec7f9,9253.25,debit,bank-fee,AU00000,2024-05-10T20:01:19Z
transaction,d08146ec-86a0-43b8-aa88-146c2ee70dd8,posted,Coffee Shop Purchase,-4612.33,64fda28d-f33f-4605-9af0-9e87a1b75a06,4640.92,debit,payment,AU00000,2023-10-12T11:26:32Z
transaction,45ec51df-0abd-47da-94ef-0b8d9526421b,posted,Public Transport Fare,-1445.72,f2cb54fb-9dc1-4692-88fe-957648210b83,3195.2,debit,payment,AU00000,2024-02-15T18:30:09Z
transaction,1fa2ed47-4613-4fcb-81d2-a933a78bf4d6,posted,Hair Salon Appointment,-2395.46,a1b49f2a-ef30-4661-af34-9b5dd2bbf595,799.74,debit,cash-withdrawal,AU00000,2024-03-28T00:52:48Z
transaction,b7c24b26-c79e-4518-a8f1-ea11df8d62ad,posted,Uber Ride,-2968.99,2dd4fd00-2344-4016-a29e-f2632ae4980a,-2169.25,debit,bank-fee,AU00000,2024-01-11T01:59:40Z
transaction,51c3cba4-72f0-483b-b2fa-80d0398d4868,posted,Payroll WFRMS 15439393,11983.32,cf1cf013-894d-4b98-b10d-8f0b377f23d7,9814.07,credit,transfer,AU00000,2024-02-28T20:56:11Z
transaction,e10f1720-02cc-457f-9cd4-f33c5e94be44,posted,Electricity Bill Payment,-4931.71,5c88a38d-deaa-46df-8638-79785751ad1b,4882.36,debit,payment,AU00000,2023-07-19T11:01:32Z
transaction,3465237b-1bb9-4cc4-9669-4c8c2bfa347f,posted,Public Transport Fare,-3268.51,90e0dd25-8420-499c-9406-929577d088a1,1613.85,debit,bank-fee,AU00000,2024-04-07T01:37:25Z
transaction,814467c7-4121-4561-aa9e-33a2642f1e78,posted,Uber Ride,-1146.32,121bcbf2-9d96-4b1f-beac-c4655ca964a7,467.53,debit,bank-fee,AU00000,2023-09-24T23:46:31Z
transaction,ee533964-790b-47d7-be02-8b9f6af64b3e,posted,Gym Membership Fee,-2389.84,76a148e9-9acf-45ae-b3ee-e2251039f912,2809.14,debit,cash-withdrawal,AU00000,2024-04-08T06:44:23Z
transaction,f6b6a0d6-dc4a-464c-b5ba-f38acfcc6fc2,posted,Bookstore Purchase,-2937.87,6556c654-e62c-4cb5-99c2-d9918c08839a,-128.73,debit,cash-withdrawal,AU00000,2024-01-14T04:35:54Z
transaction,11413ce0-eb57-4a3c-ba5a-9a236717acd2,posted,Mobile Phone Bill Payment,-1329.13,fe2841e3-035a-43a4-bcd1-d96df470144b,-1457.86,debit,payment,AU00000,2024-03-06T16:16:28Z
transaction,5b4cbf08-c2a4-4101-8589-edc1896d8364,posted,Home Improvement Store Purchase,-2887.95,2b82be3d-c4d2-42ed-b385-90b502964580,-4345.81,debit,bank-fee,AU00000,2023-05-26T15:58:45Z
transaction,5744e3bc-70f5-43eb-ade8-4a526e2c43f9,posted,Manly Maths Tutor Wages,-4835.05,446d3590-7fd0-4cf1-b273-db9d5259406e,-9180.86,debit,bank-fee,AU00000,2023-12-06T07:55:18Z
transaction,d2441e6d-8055-4262-9ec4-a2f479cfb2e6,posted,Mobile Phone Bill Payment,-4302.65,512652d3-5479-4c3b-bfaa-116fcb3a2533,-13483.51,debit,bank-fee,AU00000,2023-11-03T09:20:38Z
transaction,1971af43-e55a-4639-97b5-c4ce9fe5d674,posted,Music Streaming Subscription,-2230.3,e78ef9c5-1614-4627-b7ba-4042391961a7,-15713.81,debit,payment,AU00000,2024-03-13T04:11:44Z
transaction,93b78448-f7f9-48ae-8e92-5efb983e9039,posted,Transfer Platnm Homeloan 346454,-2180.32,45ab54d2-be77-4a19-9f68-0ba3a72cadb7,-17894.13,debit,bank-fee,AU00000,2023-10-29T10:56:05Z
transaction,7d15357c-a517-465d-aa0a-8e9c7b440a7c,posted,Music Streaming Subscription,-2531.98,0702a06b-316a-43d7-9d92-fadbfee5f741,-20426.11,debit,payment,AU00000,2023-08-17T03:09:48Z
transaction,e0480751-8b89-4da4-9389-97669e7d8175,posted,CTRLINK CARERS Ref: 998R6789201610974V,-4717.53,3ade441b-a732-4acb-83fe-74f92a57d18a,-25143.64,debit,payment,AU00000,2023-07-07T01:47:50Z
transaction,4eb95162-04b2-4879-ba19-1adc2e166987,posted,CTRLINK CARERS Ref: 998R6789201610974V,-4825.16,4353ab7d-b38f-4693-a8b4-29ab0b9d1d2d,6852.59,debit,payment,AU00000,2023-07-21T00:24:58Z
transaction,f702af45-cfd4-4d4d-8016-9e36d927a951,posted,Pharmacy Purchase,-638.29,99d4de51-7603-4168-868b-66a4041b4025,6214.3,debit,cash-withdrawal,AU00000,2024-01-04T06:24:21Z
transaction,41a43968-ffc3-43f4-ae36-e3ffaf0c777c,posted,Electricity Bill Payment,-1752.72,181aa8fc-bd30-4dad-972e-ea455dc74798,4461.58,debit,bank-fee,AU00000,2023-08-27T12:42:20Z
transaction,d2529694-e327-434e-ae31-ef2a52de098a,posted,Public Transport Fare,-1190.65,e622dc49-0958-4312-9978-47187ae1f0e1,3270.93,debit,bank-fee,AU00000,2024-01-07T16:51:30Z
transaction,740bae37-d24b-48e4-a597-93c8448322ea,posted,Travel Agency Booking,-1520.12,d102d378-debf-4fdd-ae29-02d75daba9c6,1750.81,debit,cash-withdrawal,AU00000,2023-07-18T01:45:34Z
transaction,fd1b5ec6-7c3e-4896-9d9b-967030e2467e,posted,Music Streaming Subscription,-616.74,de492861-ab97-4d02-8ecf-6a6198623157,1134.07,debit,cash-withdrawal,AU00000,2023-05-23T02:28:06Z
transaction,f838930d-8221-475e-803a-6545581c6043,posted,Travel Agency Booking,-514.51,44bba1b9-1b24-4390-8dc5-56784aca4a77,619.56,debit,cash-withdrawal,AU00000,2024-03-06T10:39:43Z
transaction,915744a2-3a9b-4999-8b35-a5bbd479ce79,posted,Pharmacy Purchase,-2730.75,536923db-81f6-4ba2-bfef-71e593e01a83,-2111.19,debit,bank-fee,AU00000,2023-06-04T01:30:47Z
transaction,cba4373f-97f5-48b4-8821-63390d22d552,posted,TRANSFER TO JOANNA SMITH CAMPING,-2380.91,15d2223d-fb4e-42ca-a261-5ded2c45e77a,-4492.1,debit,bank-fee,AU00000,2023-09-06T15:50:11Z
transaction,f7bc0b91-0eb6-4016-a377-211a2b63fd41,posted,Clothing Store Purchase,-1649.21,4cdef85f-b7ca-4ce7-9fff-466eaf8ee814,-6141.31,debit,bank-fee,AU00000,2024-03-07T12:22:51Z
transaction,5fc96df6-46da-484e-9e9d-4334f0dcd6e7,posted,AGL RETAIL ENERGY LTD (GAS),-169.4,248f792e-4946-4bb1-b0f2-c21201353675,5209.96,debit,bank-fee,AU00000,2023-11-26T12:59:02Z
transaction,baa2c782-e8bb-4649-a4f8-56bb7545cae6,posted,Clothing Store Purchase,-3030.34,02661dce-7158-4ef7-9e06-1540f741290e,2179.62,debit,cash-withdrawal,AU00000,2023-06-22T19:12:04Z
transaction,9f8a13f1-7791-4d50-a058-952cb7f8c135,posted,Payroll WFRMS 15439393,11754.13,388fed61-dace-424a-a155-5f46491fe21e,13933.75,credit,transfer,AU00000,2023-06-20T19:17:26Z
transaction,9ce12b20-433c-48bf-891a-d7faca0344a1,posted,Movie Ticket Purchase,-295.41,1830d96c-3ebe-4bbd-8d2a-4b9640c23f3b,13638.34,debit,payment,AU00000,2024-01-03T19:12:57Z
transaction,e47ef087-cb95-47f4-bc1a-b986daac8c2f,posted,Payroll WFRMS 15439393,10049.32,b9dbd0f3-00a0-4645-9cb7-9964ad09c5d6,23687.66,credit,transfer,AU00000,2024-02-11T02:13:34Z
transaction,83073753-3a60-4bff-af2a-49c8d49a2d8c,posted,Music Streaming Subscription,-2578.08,e4e99374-9f80-44b9-a54e-aa5973355082,21109.58,debit,payment,AU00000,2023-10-15T21:40:06Z
transaction,43cc2c79-994a-4e3b-9d5e-aadd0cd75687,posted,Pharmacy Purchase,-2176.49,58e643d4-b6dd-41c5-902e-6d1b1f0de719,18933.09,debit,bank-fee,AU00000,2023-08-02T21:52:00Z
transaction,40f5031a-f47c-41bc-a26e-29a104f3324d,posted,Netflix Subscription,-4462.7,958c44d4-cb60-4201-96e5-4b14d550c1d9,14470.39,debit,cash-withdrawal,AU00000,2023-05-25T10:57:34Z
transaction,84d37a09-b605-4b6f-a9b5-0d264af6e9ce,posted,Movie Ticket Purchase,-3258.83,b46fd630-c2bd-41a8-a80e-f196dc76f00f,11211.56,debit,cash-withdrawal,AU00000,2024-02-24T23:02:06Z
transaction,3fde0b9f-849a-4ff3-96cf-7d630a8072e3,posted,Non Hooli ATM Withdrawal Fee,-1101.45,17c4c7ad-0b84-453d-a32d-e55f1be9812f,10110.11,debit,payment,AU00000,2023-08-16T04:51:13Z
transaction,c631c553-47ce-432b-ad99-eb46def1ada1,posted,Restaurant Dinner,-1555.77,5450707f-3d0b-4f35-a53c-cffd30ef57a9,15133.9,debit,cash-withdrawal,AU00000,2023-08-06T07:45:27Z
transaction,d20ee36b-0ea9-4078-8f72-85209d7e64ff,posted,AGL RETAIL ENERGY LTD (GAS),-4629.32,77dae15a-d733-4bfa-a9b2-e8ae2464a839,10504.58,debit,payment,AU00000,2023-08-07T19:27:04Z
transaction,b4b77292-c3d4-4b58-a2f8-d84aaae85e10,posted,TRANSFER TO JOANNA SMITH CAMPING,-574.92,854a32bd-178f-43e2-85f0-4c43d98085a8,9929.66,debit,bank-fee,AU00000,2023-09-15T14:48:54Z
transaction,5dc28b38-83bb-4df2-a5d6-ba07dbb12293,posted,Pharmacy Purchase,-3941.83,2aa00823-17a6-4436-9199-f985e7e7a575,5987.83,debit,bank-fee,AU00000,2024-01-10T17:54:37Z
transaction,5f09b861-4fe6-4c40-b917-f8e2d4386af6,posted,CTRLINK CARERS Ref: 998R6789201610974V,-4212.41,26eb1369-2973-46ab-8ea7-8282e7bf71bd,1775.42,debit,payment,AU00000,2023-10-28T00:26:24Z
transaction,95efb207-6b67-483c-999f-73fdb78ee206,posted,CTRLINK CARERS Ref: 998R6789201610974V,-4096.69,d7383142-8d43-4c34-a3ea-a5cdd8bdc056,-2321.27,debit,cash-withdrawal,AU00000,2023-10-02T08:49:26Z
transaction,edd1a29f-dbf4-45ad-88e6-59b90d89e524,posted,CTRLINK CARERS Ref: 998R6789201610974V,-718.87,9fddd634-2d89-4610-b8ee-6b3f1a09736d,-3040.14,debit,cash-withdrawal,AU00000,2023-08-03T23:04:43Z
transaction,56d6d9b1-7fc6-4674-a7ec-680fbda8aa1c,posted,Mobile Phone Bill Payment,-2667.53,e4fab400-eed8-498a-a5f7-5e6eef4df0c4,-5707.67,debit,payment,AU00000,2023-12-16T08:22:00Z
transaction,b3c8b661-b2aa-4130-8b5f-f0303471a111,posted,Hair Salon Appointment,-1049.28,3b4b51d4-9a31-4dd7-afc6-01bda1f30471,-6756.95,debit,payment,AU00000,2023-07-09T18:43:05Z
transaction,9163c615-e01b-496a-9c27-015c1204eb47,posted,Amazon Online Shopping,-1460.45,79271942-8e23-4bd7-86f2-a3bb9b2f2dcb,-8217.4,debit,payment,AU00000,2023-07-13T18:45:49Z
transaction,2174a656-cccc-4a69-94b8-69c13d1a3331,posted,Car Maintenance Expense,-1176.54,81541a81-8d38-421a-9947-1e8b7ec578bd,15079.39,debit,bank-fee,AU00000,2023-07-31T14:07:06Z
transaction,d60d5f63-be9c-4061-abac-57e06e35dcb0,posted,Bookstore Purchase,-2880.53,a3adbb70-d98c-40f8-937d-e6d2b64e8c74,12198.86,debit,payment,AU00000,2023-12-08T02:45:07Z
transaction,5a4a71e7-7da6-4eba-b5ad-fd7074e57511,posted,Electricity Bill Payment,-3777.6,0ac8c499-86fe-4261-88b0-946a8ed3fe2a,8421.26,debit,payment,AU00000,2023-11-02T03:24:19Z
transaction,f32760a1-7195-4aab-b086-af6a6be9202a,posted,TRANSFER TO JOANNA SMITH CAMPING,-1752.52,79b56679-e5ed-4ad8-bd8d-4446a7af3d4c,6668.74,debit,bank-fee,AU00000,2023-07-23T05:11:26Z
transaction,56c20dd0-c8af-4390-b329-71627865dd38,posted,Online Gaming Purchase,-876.23,df2c6146-0eed-437f-aeea-87bfb32b5ee7,5792.51,debit,cash-withdrawal,AU00000,2024-02-18T11:57:26Z
transaction,68c4df28-14d9-4c48-aed7-feb69601035b,posted,Pharmacy Purchase,-3762.98,388a6ba5-253d-4435-9ca8-437143b5f079,2029.53,debit,payment,AU00000,2023-12-18T16:04:15Z
transaction,17b4c2b6-204b-4f83-8631-c1fb21c17a27,posted,Pharmacy Purchase,-1053.7,54d7ed0a-90bb-4ca4-b75f-b05f83a5b1e8,975.83,debit,payment,AU00000,2023-06-12T12:27:07Z
transaction,c580cc16-8d14-42e4-827b-ce6213ef8ec5,posted,Amazon Online Shopping,-3151.09,a8e5908d-0047-4177-9159-ad57402e386f,-2175.26,debit,cash-withdrawal,AU00000,2023-10-31T22:22:53Z
transaction,da6b48f8-36b1-44af-8839-d13983b484c7,posted,Hair Salon Appointment,-180.69,518c7ef0-cd86-4f32-9a70-f33bde9f6b70,-2355.95,debit,payment,AU00000,2023-05-22T20:57:16Z
transaction,19fc2cfb-48f5-4439-9908-dc373aedcf9a,posted,CTRLINK CARERS Ref: 998R6789201610974V,-4224.38,f2581af4-584c-4010-92a6-33be85f92e15,-6580.33,debit,cash-withdrawal,AU00000,2023-10-14T12:21:54Z
transaction,23adee3e-6569-478a-b78d-a3a125b2d1ca,posted,Coffee Shop Purchase,-3539.44,057e27b3-cb50-439b-b193-07a484a42c2b,15667.14,debit,payment,AU00000,2023-07-04T16:37:39Z
transaction,a60d26b4-c852-43e2-ad7c-f1369af6e45c,posted,Mobile Phone Bill Payment,-1629.12,74cb07e0-cbe4-460e-b580-15f6a75d74fa,14038.02,debit,bank-fee,AU00000,2023-06-15T14:17:07Z
transaction,f5cc28e1-5784-4ca9-8c4c-ae577891b062,posted,Gym Membership Fee,-4046.39,275c7482-1c00-43fa-b287-9381d1f1f159,9991.63,debit,bank-fee,AU00000,2023-09-30T18:35:33Z
transaction,0d0941c8-797f-4107-959a-20fb6cd2fd82,posted,Public Transport Fare,-1335.76,70352586-3ee7-410e-8887-91ded2ff78d5,8655.87,debit,payment,AU00000,2024-03-17T15:46:17Z
transaction,182d24c4-db7b-4397-bf13-567a9ed3fc6d,posted,Restaurant Dinner,-949.62,5ff8507b-f524-4a3c-9067-7254ae3fa560,7706.25,debit,payment,AU00000,2023-07-22T00:26:27Z
transaction,640c7ee8-8b92-4076-b5f8-66a1780b95e2,posted,TRANSFER TO JOANNA SMITH CAMPING,-211.82,73ef6c3c-964f-412f-83f2-baa1f2e58023,7494.43,debit,bank-fee,AU00000,2023-06-23T00:34:54Z
transaction,0acca2fc-841b-4c08-8b3b-07744f864a4d,posted,Transfer Platnm Homeloan 346454,-1112.38,9b940a68-3de3-4ed6-83b0-341db7c5d79f,6382.05,debit,bank-fee,AU00000,2023-09-10T01:36:35Z
transaction,dbd59d62-76ce-4046-bc47-db249b9f0386,posted,Travel Agency Booking,-4401.86,c30628b9-647d-4a07-8a0d-7d49e5ecfe37,1980.19,debit,payment,AU00000,2023-10-07T17:34:51Z
transaction,1443a324-101b-4927-b5d2-efe7b395ce48,posted,Movie Ticket Purchase,-4141.63,31970a00-f849-4940-95c9-866e4f225fa3,-2161.44,debit,cash-withdrawal,AU00000,2024-04-20T01:53:21Z
transaction,a3f3300c-f1a6-4696-b318-c9845f496501,posted,Online Gaming Purchase,-3386.0,8561aa06-6dfb-4af7-9e3e-f9785688dd4d,-5547.44,debit,payment,AU00000,2024-02-25T04:29:29Z
transaction,db9dec3f-cf87-4269-9652-bfeb82f49d1f,posted,Netflix Subscription,-40.87,38603a99-c500-46c0-9631-cd324413b832,8649.19,debit,cash-withdrawal,AU00000,2024-04-25T03:32:51Z
transaction,f9c51776-bc50-4232-93f8-562cc893b44c,posted,Online Gaming Purchase,-3953.18,ff93eb28-0869-4f3d-9345-27325b113fcf,4696.01,debit,payment,AU00000,2023-05-14T19:49:46Z
transaction,ca6ebefc-c4ef-447f-948c-a62063affecb,posted,Uber Ride,-4872.44,29c925f1-0be4-4295-bbc4-e5c7f2fe2181,-176.43,debit,payment,AU00000,2023-09-09T09:43:30Z
transaction,052bfaec-8e75-48ab-822c-ad64a0c4317c,posted,Travel Agency Booking,-1109.02,a36602c6-302c-40e6-b6f5-b6454f595477,-1285.45,debit,payment,AU00000,2024-01-11T21:24:26Z
transaction,8dbf3a62-b42f-4f90-a34c-f2466ad88e0b,posted,Payroll WFRMS 15439393,10185.89,6469bd1c-163c-4042-8891-0c88c61268b4,8900.44,credit,transfer,AU00000,2023-09-08T16:46:25Z
transaction,19c1ebdc-d898-4683-9240-af998afbcb02,posted,Payroll WFRMS 15439393,11098.48,d7965547-3d57-4a86-ab74-8f231a9a3a39,19998.92,credit,transfer,AU00000,2023-09-13T13:34:26Z
transaction,2f92a735-f81b-4c55-b9a6-37fa4531cf68,posted,Home Improvement Store Purchase,-1569.24,87376a21-ad59-4d1d-9766-0f8acbb48b9b,18429.68,debit,payment,AU00000,2023-09-27T12:21:57Z
transaction,2ec76333-adae-4af8-9e03-51edfe4bef77,posted,Payroll WFRMS 15439393,10454.34,9cf40082-1a93-4ec2-8433-475ad83ad8ff,28884.02,credit,transfer,AU00000,2024-02-10T23:03:01Z
transaction,830735f5-b814-4f4a-9ec7-c2562d465e6e,posted,Wdl ATM WESTPAC IGA BALGOWLAH BALGOWL AU,-995.17,f35585a8-e799-4f90-823f-a0731f6c85e3,27888.85,debit,cash-withdrawal,AU00000,2024-04-09T06:56:28Z
transaction,f91b6dc3-4bca-47ae-b852-67101005549a,posted,TRANSFER TO JOANNA SMITH CAMPING,-2068.44,0e13e8f7-21fb-42a9-be0e-51cb7028a74d,25820.41,debit,bank-fee,AU00000,2024-05-09T20:14:53Z
transaction,b363ba52-89c9-4022-81bd-f6f4c03222d9,posted,TRANSFER TO JOANNA SMITH CAMPING,-3549.5,3081ac91-5371-4688-a3fe-c7eb4c3a6b6f,15720.17,debit,bank-fee,AU00000,2024-02-02T01:34:17Z
transaction,5a458718-2825-469f-91ce-97ec2c1be228,posted,TFR Acc14000 TO 12389,-2389.77,612f5285-6595-4633-92bd-bf6759d7eb70,13330.4,debit,bank-fee,AU00000,2023-11-02T18:38:19Z
transaction,4d383a12-5482-4a18-bedc-c520dc5fa917,posted,Wdl ATM WESTPAC IGA BALGOWLAH BALGOWL AU,-1669.14,112ff1e9-5d26-45d3-9258-b56d92300d97,11661.26,debit,bank-fee,AU00000,2023-09-30T06:48:03Z
transaction,11e4dede-05f0-40bf-acdd-6af206694036,posted,Mobile Phone Bill Payment,-1091.44,c8d9ab13-a9de-44ce-b723-54772239e251,10569.82,debit,payment,AU00000,2024-05-08T18:09:21Z
transaction,39e93650-d810-467e-9142-47cda0ec849c,posted,Pharmacy Purchase,-4866.35,66ec46dd-b9cd-4fd5-9cec-50023b45c8d7,5703.47,debit,bank-fee,AU00000,2023-08-20T03:26:27Z
transaction,5b65038b-d394-4955-91f3-32a60bf4ca1e,posted,AGL RETAIL ENERGY LTD (GAS),-164.76,49fcfc5f-ecb6-4d7e-a6de-b5ccaa5eda12,5538.71,debit,payment,AU00000,2023-11-01T09:38:01Z
transaction,70bb997b-e315-4600-90d6-8001c15cd503,posted,Gasoline Purchase,-4556.07,f7091608-fb8b-43a0-8348-24944038d2f4,982.64,debit,cash-withdrawal,AU00000,2024-02-02T08:45:58Z
transaction,71a59616-7412-420b-841e-306a0ed9149b,posted,Transfer Platnm Homeloan 346454,-4819.99,f78d4704-54df-4524-aad1-5860ab9acd85,-3837.35,debit,bank-fee,AU00000,2023-10-13T08:15:19Z
transaction,eb888c3c-4ef0-4af1-9f6a-098ad336cdf7,posted,Car Maintenance Expense,-2226.67,81f9f4d4-ca2a-4707-84c5-9025aabdf2da,-6064.02,debit,cash-withdrawal,AU00000,2024-01-30T20:42:55Z
transaction,423921c1-f8c4-4044-a682-69274c8230db,posted,Car Maintenance Expense,-708.74,39f186fa-8891-41f7-8de2-548af9e2f6b8,-6772.76,debit,bank-fee,AU00000,2024-04-24T11:29:30Z
transaction,fd048e08-47e5-41a2-9202-a9d247025877,posted,Amazon Online Shopping,-2321.82,a3da8f3d-305d-479e-9b62-683d52c95454,5333.24,debit,bank-fee,AU00000,2023-12-24T20:07:41Z
transaction,162a4855-a8e0-4510-ab02-604c691ceb54,posted,Movie Ticket Purchase,-2304.58,f5598849-c110-4848-b2c5-6f9de58f5cb5,3028.66,debit,payment,AU00000,2023-12-11T16:21:37Z
transaction,51d28279-83f0-4351-b1ba-29135583d18c,posted,Gasoline Purchase,-2379.24,c977faf2-0dbd-44c5-a3c7-9d19f3014468,649.42,debit,cash-withdrawal,AU00000,2024-01-03T20:32:57Z
transaction,220e4513-5083-4161-bb40-a19efe2fe953,posted,Restaurant Dinner,-2817.76,942d4a8b-c7a0-4d24-80e5-625242d74dfe,-2168.34,debit,payment,AU00000,2024-01-10T17:09:48Z
transaction,ffe730f5-cdf7-4f16-a990-4c04ef1b54a9,posted,Coffee Shop Purchase,-755.68,c27630eb-c21f-4bce-8823-58552b11ccbb,-2924.02,debit,cash-withdrawal,AU00000,2024-01-08T22:32:15Z
transaction,46cd60b9-a423-4c78-beb5-2964839fdc15,posted,Wdl ATM WESTPAC IGA BALGOWLAH BALGOWL AU,-4596.78,7e9d09ff-bd3c-4f19-81c9-17a95cfd8be0,-7520.8,debit,cash-withdrawal,AU00000,2023-09-03T21:47:31Z
transaction,218e842c-bcdb-443b-8f97-2b37f552844e,posted,Amazon Online Shopping,-2934.44,44e280ed-aad1-412d-8b50-9509b1a6df41,-10455.24,debit,bank-fee,AU00000,2024-01-17T23:44:18Z
transaction,04b14323-ad5e-4afd-8e51-5f8da517912c,posted,Electricity Bill Payment,-253.12,0e884c81-7ede-4b6b-9a59-1eb91c7265e5,-10708.36,debit,bank-fee,AU00000,2023-08-20T18:34:33Z
transaction,fda85715-7465-46f8-a225-caa6bc7cc8cb,posted,Mobile Phone Bill Payment,-3825.93,3fc86fd1-7f79-46e0-8166-fc9f40d2f0ed,-14534.29,debit,payment,AU00000,2024-02-23T00:44:37Z
transaction,d52f80f0-f42e-42e1-8216-35bba253cfab,posted,Non Hooli ATM Withdrawal Fee,-215.51,62bc190c-76ba-488a-98b4-b71e7a1c84eb,-14749.8,debit,payment,AU00000,2023-06-14T11:30:01Z
transaction,9059b068-3492-4350-8ddf-8f2a854fe869,posted,Music Streaming Subscription,-2514.39,57b777c2-7c20-4582-b15f-487368bb0e04,7200.98,debit,cash-withdrawal,AU00000,2023-11-03T01:04:32Z
transaction,b51ad46f-f654-49ba-a087-3cd9711ab987,posted,Non Hooli ATM Withdrawal Fee,-2343.27,f6ca3f56-8571-4b6b-b88c-0a05d1e5ecc3,4857.71,debit,bank-fee,AU00000,2023-06-14T18:05:54Z
transaction,cab79740-7ca4-4c7b-957a-d597546ce2f3,posted,Payroll WFRMS 15439393,10433.88,d881dc04-521c-4f86-80c2-e7b27dab36fe,15291.59,credit,transfer,AU00000,2023-11-12T19:45:30Z
transaction,d64e63e1-61fa-4a8f-8099-a76e0a41faf1,posted,Gasoline Purchase,-3923.52,9808d040-36e2-42a2-bb2b-0f32aba2cf6f,11368.07,debit,cash-withdrawal,AU00000,2024-02-12T07:02:08Z
transaction,77149de9-d81f-498d-8028-f23c240d97ac,posted,Music Streaming Subscription,-1420.34,5444f019-4d5c-4d66-9705-a005b6e612ba,9947.73,debit,payment,AU00000,2024-01-19T13:08:03Z
transaction,af469891-31be-4cf9-aa32-dab75fd4e2b3,posted,Gym Membership Fee,-4403.79,6922ab81-2f2a-443e-974a-9712c8539e50,5543.94,debit,bank-fee,AU00000,2023-10-23T20:36:31Z
transaction,cb0c5299-5bdd-4109-a7aa-c43170549676,posted,Manly Maths Tutor Wages,-1843.59,bbdc3e83-19ce-4b77-bd71-4b535becb051,3700.35,debit,cash-withdrawal,AU00000,2023-12-17T03:59:06Z
transaction,b483b5bc-80aa-4dce-8dc2-a1de350caa3c,posted,Payroll WFRMS 15439393,11059.16,16b50e5f-e937-4c48-9005-5dc5c58218f6,14759.51,credit,transfer,AU00000,2023-05-13T11:18:07Z
transaction,1a23776a-b73a-4202-b7a2-d18e02c2d47b,posted,CTRLINK CARERS Ref: 998R6789201610974V,-4676.75,a62d4f66-cbcf-40d9-84d1-6fa2e03df0f7,10082.76,debit,cash-withdrawal,AU00000,2023-08-08T12:43:59Z
transaction,44ce00e0-1714-4ebb-b5f9-b4a096bd733e,posted,Restaurant Dinner,-2841.13,eb116cbb-2191-49d0-a6fb-22ea4111e63d,7241.63,debit,bank-fee,AU00000,2023-11-08T05:06:36Z
transaction,f344dca5-2690-4ef0-9729-ba26532cd145,posted,Pharmacy Purchase,-4231.26,6b8239d7-f807-4f86-b6d5-558065a93214,14908.58,debit,cash-withdrawal,AU00000,2024-02-23T11:47:34Z
transaction,9434e654-c885-4215-b2a4-31c0e28ec487,posted,CTRLINK CARERS Ref: 998R6789201610974V,-1767.33,e23127fd-4c0c-41e6-bbb9-5cb65e66f9d9,13141.25,debit,payment,AU00000,2024-04-04T19:59:28Z
transaction,5e147301-c7f0-4c31-b55a-0a1dd40d39b7,posted,Movie Ticket Purchase,-2497.71,409a09c5-b300-4861-8e5f-62080e0ff06b,10643.54,debit,bank-fee,AU00000,2023-11-01T09:57:56Z
transaction,447fbf24-a997-49df-ad77-241779039469,posted,TRANSFER TO JOANNA SMITH CAMPING,-3013.61,ea346f43-7998-4210-a0d1-69c9ae8b3542,7629.93,debit,cash-withdrawal,AU00000,2024-02-22T00:24:09Z
transaction,0858de19-be4a-41be-855a-ddfeba7d50f9,posted,Payroll WFRMS 15439393,10444.08,48187d19-f4fc-48d7-b28f-7d90e478e5b4,18074.01,credit,transfer,AU00000,2024-01-31T08:02:45Z
transaction,03dbcde5-ee22-4e08-8547-4db3c5c94b68,posted,Pharmacy Purchase,-1964.61,ddee1554-0c2a-4b62-9d1f-10fff55faf21,16109.4,debit,cash-withdrawal,AU00000,2023-07-16T19:06:47Z
transaction,5490d60b-9355-4fa6-9c61-320d6464a301,posted,Netflix Subscription,-1194.58,63221b41-167b-4790-9433-d57d0b59dd26,14914.82,debit,payment,AU00000,2023-07-16T20:13:22Z
transaction,81304a23-528d-4fb6-87a1-bb61e193b6de,posted,Non Hooli ATM Withdrawal Fee,-1849.52,8e85bfd8-3952-4db8-b59b-88b74f15eb36,13065.3,debit,cash-withdrawal,AU00000,2023-08-29T02:42:54Z
transaction,04c10aae-64df-467a-8199-3ca12c30bdfa,posted,Online Gaming Purchase,-2121.02,b991fdca-45d6-4d5d-8898-0ab1130a111c,10944.28,debit,payment,AU00000,2023-06-20T12:51:41Z
transaction,ae97f39e-911d-40ae-8a20-65c3b1e7e4a2,posted,Home Improvement Store Purchase,-731.59,bbd79566-ece4-4324-a895-14d6457d48f2,10212.69,debit,bank-fee,AU00000,2024-04-08T23:58:53Z
transaction,7ba4d15c-0ef0-4af8-bf64-bc7bb560c2ab,posted,Transfer Platnm Homeloan 346454,-1719.95,398f3928-7626-413c-89b8-2d29e66b5f68,6202.88,debit,cash-withdrawal,AU00000,2024-02-02T16:54:51Z
transaction,bcb8c7bd-316f-43de-aba5-c14e8affe1a6,posted,Online Gaming Purchase,-3023.01,87f28c20-3458-4a66-b546-93581c900bbf,3179.87,debit,cash-withdrawal,AU00000,2023-11-16T11:54:22Z
transaction,dcecc1d3-b81d-4226-be9b-6760a66ed321,posted,Coffee Shop Purchase,-2840.17,287924ac-4497-4cd4-aa46-48f5a4184e5b,339.7,debit,cash-withdrawal,AU00000,2024-03-10T08:36:38Z
transaction,8e98b1c4-f526-4b1c-9a75-da3eb1973ca9,posted,Electricity Bill Payment,-4003.44,b556fb69-665e-43fd-b29b-d00388b2c95a,-3663.74,debit,cash-withdrawal,AU00000,2023-06-03T17:59:27Z
transaction,0e83657b-d8bb-4e4f-9ccf-bba669c9ad02,posted,Transfer Platnm Homeloan 346454,-3850.8,09ef3d76-6871-4182-b9cf-773e7d236994,-7514.54,debit,payment,AU00000,2023-08-02T07:58:04Z
transaction,2b51e5fe-c813-41c1-b83a-4ca582fbd0ae,posted,Coffee Shop Purchase,-4803.12,ecda0f24-0df6-4e47-9456-2817f18bc82a,-12317.66,debit,payment,AU00000,2023-09-04T22:20:50Z
transaction,4c3308de-f058-41ad-af1f-472eccc48b9b,posted,Clothing Store Purchase,-886.42,4fdaccc7-144c-4740-94a9-ddc7aa0960f9,-13204.08,debit,payment,AU00000,2023-05-23T05:10:39Z
transaction,1e459638-baa1-4705-a7ce-d4cc7163d5b0,posted,Clothing Store Purchase,-63.68,43bfaf36-a1f8-41ba-a491-1105c6ac469a,-13267.76,debit,payment,AU00000,2024-05-06T12:09:48Z
transaction,46503cc8-cb47-4aaf-95a7-7b2b9953333e,posted,Music Streaming Subscription,-1585.81,4d55a713-5c0b-4e77-9580-87963eb600ce,-14853.57,debit,cash-withdrawal,AU00000,2024-05-01T16:08:53Z
transaction,44a7676b-66db-41e4-9c75-a9d6261b4a53,posted,Gasoline Purchase,-385.28,54ed1381-fea2-41a1-9a9e-bb3e144f1d5a,-15238.85,debit,cash-withdrawal,AU00000,2023-08-29T11:50:19Z
transaction,475286be-b96e-4f71-ae30-3fcd320ed83b,posted,TRANSFER TO JOANNA SMITH CAMPING,-375.31,47058eeb-1ca2-4311-aae6-3ec8f0b3eb5d,5973.47,debit,payment,AU00000,2024-03-28T15:41:08Z
transaction,97054781-6e8c-43e8-b61f-2d5755a77762,posted,Uber Ride,-1728.74,044cb123-aedf-4bd8-abeb-aafe63d968b1,4244.73,debit,payment,AU00000,2023-12-28T07:38:11Z
transaction,d6ad18c4-51f6-4a3d-863c-22624f3edf05,posted,TRANSFER TO JOANNA SMITH CAMPING,-2436.77,fa379eae-8e0c-4fc9-8cc9-c0d4a96ed245,1807.96,debit,bank-fee,AU00000,2023-11-28T01:30:18Z
transaction,2d65c38a-795c-4c15-9038-26970dd091ec,posted,TFR Acc14000 TO 12389,-3154.25,31a743d0-086c-413d-86f3-afde43f7a1d2,-1346.29,debit,bank-fee,AU00000,2024-05-02T05:20:30Z
transaction,4d0f837e-298a-40d5-b4a9-f2090392662c,posted,Wdl ATM WESTPAC IGA BALGOWLAH BALGOWL AU,-1065.93,36ace08b-f9d2-4beb-a3ff-c73be87ebec8,-2412.22,debit,bank-fee,AU00000,2023-12-15T19:45:33Z
transaction,8ae36abe-84fb-4a66-b728-efda3ba31cfe,posted,Music Streaming Subscription,-4976.2,b5dd0b73-ca51-460b-ac73-7749259a9a72,-7388.42,debit,payment,AU00000,2024-02-10T14:35:08Z
transaction,fa2d9672-6ec1-4041-b213-75eff3cfb210,posted,Online Gaming Purchase,-2066.36,15a1a88b-22a7-46f5-ad6e-8708aca85bae,-9454.78,debit,cash-withdrawal,AU00000,2023-10-24T22:04:14Z
transaction,cdacd680-0915-4099-87b7-7653101d49cc,posted,CTRLINK CARERS Ref: 998R6789201610974V,-3504.13,68a5c953-e174-4baa-977b-279056dbd100,-12958.91,debit,payment,AU00000,2024-01-12T22:40:27Z
transaction,07162683-e0d7-4dfe-8fbe-8aa10d528357,posted,Bookstore Purchase,-3007.93,26aa470f-1ca6-40db-8da1-bcb9b6708ef2,-15966.84,debit,cash-withdrawal,AU00000,2024-04-07T08:35:13Z
transaction,e34cdd22-2b51-41fd-9934-5e3f52cac738,posted,Online Gaming Purchase,-3166.49,44079ced-8e28-4bfa-a7ca-8bac60324f8f,-19133.33,debit,bank-fee,AU00000,2023-09-17T13:41:19Z
transaction,5f1f2100-5cb0-4ba0-88f7-db6f0e44a486,posted,Restaurant Dinner,-631.73,15d9c08e-8bc2-46ef-9d91-35b6f525eac3,7480.07,debit,cash-withdrawal,AU00000,2024-04-20T17:49:04Z
transaction,44fc82ca-d603-4b34-9c8c-adfb751b2308,posted,Music Streaming Subscription,-3858.37,34f24be4-7462-4ed7-9646-fce2facc166e,3621.7,debit,bank-fee,AU00000,2023-10-12T07:06:13Z
transaction,ed089774-ea32-4c65-b0a7-3251e3a18488,posted,Restaurant Dinner,-1844.17,61e2d616-3b4d-4645-81bf-3b15db4d33d5,1777.53,debit,payment,AU00000,2023-11-08T18:17:43Z
transaction,8b4a20f7-363c-4c83-aa7a-adf2121a7833,posted,TFR Acc14000 TO 12389,-4990.12,23737f19-8c7f-415e-bd13-a20d88ad03db,-3212.59,debit,payment,AU00000,2023-08-29T13:13:48Z
transaction,7ec8860b-9acb-40b3-b6e8-97e89ccb9c84,posted,Amazon Online Shopping,-1974.12,272c88b9-ed18-4576-bb81-e318e870bc62,-5186.71,debit,cash-withdrawal,AU00000,2023-10-16T16:30:49Z
transaction,e62ac90f-eb40-494b-9f73-5037f865adf5,posted,Pharmacy Purchase,-832.19,01d8581b-85ed-4819-9bd1-4b0d49c4c143,-6018.9,debit,bank-fee,AU00000,2023-09-02T05:29:34Z
transaction,36244e63-1f8b-46bd-8121-38a38dea0607,posted,Coffee Shop Purchase,-4272.35,d90c5493-0183-47c0-8708-453b89942741,-10291.25,debit,cash-withdrawal,AU00000,2023-05-14T07:19:01Z
transaction,a48d9ed9-f021-418b-a0aa-c707b377ec3b,posted,Manly Maths Tutor Wages,-4450.67,7e879c0d-de8e-4879-917d-a581986cf292,-14741.92,debit,bank-fee,AU00000,2023-07-04T12:14:12Z
transaction,25d70278-c70a-405e-9dfb-5364b99a61af,posted,TRANSFER TO JOANNA SMITH CAMPING,-2601.26,224e3451-a44f-4e11-b07f-3b1d789297ce,-17343.18,debit,cash-withdrawal,AU00000,2023-11-19T08:33:28Z
transaction,9bbfcee6-6a10-4450-80ae-eb0d1851bc29,posted,Wdl ATM WESTPAC IGA BALGOWLAH BALGOWL AU,-2358.57,03523747-c933-400a-98c6-5e6d77d01317,-19701.75,debit,bank-fee,AU00000,2023-12-01T16:21:42Z
transaction,62d0e5f5-bab6-47a8-807f-033ce3d7f1eb,posted,Gasoline Purchase,-3688.77,275695e7-0f73-4f46-a08d-77bc70df1a8f,9251.36,debit,bank-fee,AU00000,2023-08-28T19:49:22Z
transaction,291b13c4-49c2-492b-9122-c01d4afdd5ae,posted,Gym Membership Fee,-3103.71,8294648a-208b-45cb-93d9-8924b0d10469,6147.65,debit,cash-withdrawal,AU00000,2023-05-28T12:50:13Z
transaction,d4a2da48-7c70-4213-bca1-74c5c565c877,posted,Car Maintenance Expense,-4384.88,8a16ffd3-17d3-42fe-ac4e-9213b9f9da49,1762.77,debit,cash-withdrawal,AU00000,2023-07-13T21:51:12Z
transaction,100c4cb8-3681-42b5-890b-ee2f0af5354e,posted,Home Improvement Store Purchase,-4354.25,b37eea22-a049-404a-aaa1-e50f893c7623,-2591.48,debit,payment,AU00000,2023-06-23T19:00:29Z
transaction,23ef3cd0-913c-48c3-89ec-e07b3adf88e4,posted,Clothing Store Purchase,-4168.33,9cb5c640-8f12-41dd-bb22-cd582cbd40a3,-6759.81,debit,cash-withdrawal,AU00000,2023-05-23T19:42:02Z
transaction,55c7ae7d-30f6-48fa-aa6b-f26cb0fe808e,posted,Public Transport Fare,-1006.96,180be8f4-48cd-4191-b755-226f57c76343,-7766.77,debit,payment,AU00000,2023-05-27T13:10:48Z
transaction,75511558-34dc-4148-9664-fa69df29c5f1,posted,Uber Ride,-2353.94,1da8c01d-1d9d-4130-bb92-5dca8d9ad170,-10120.71,debit,payment,AU00000,2023-08-29T04:45:08Z
transaction,6614aadf-dfb6-4edb-a6e1-eb0b58c35529,posted,Coffee Shop Purchase,-720.51,a7346328-911b-4b60-842b-56799ac4f8d6,-10841.22,debit,payment,AU00000,2023-05-20T15:56:54Z
transaction,cda9417f-befc-48f3-a14b-82d38d3da942,posted,Gym Membership Fee,-2193.68,0cb8a0d4-8be3-4a87-a380-1273efcff9dc,-13034.9,debit,bank-fee,AU00000,2024-03-22T18:12:56Z
transaction,2c43e37f-1ec7-4dc7-840a-28bfc7c46c11,posted,Restaurant Dinner,-666.08,89ea3914-aa64-4a27-84a3-9421fbb4ade5,-13700.98,debit,payment,AU00000,2023-10-24T11:40:13Z
transaction,ddf2dc9a-61c0-4b6c-9902-10f5db2f1c9e,posted,Restaurant Dinner,-1676.31,97a437c4-5017-4e1f-9aa0-ddc9d333adf9,14007.89,debit,payment,AU00000,2024-03-14T01:51:52Z
transaction,8a1aa891-43ab-4020-b832-eb7ea17ad27f,posted,Movie Ticket Purchase,-1496.11,777f41b6-a726-4438-a52f-b74b123f4344,12511.78,debit,cash-withdrawal,AU00000,2024-04-18T17:36:34Z
transaction,afe2ec6e-5b7e-442c-a2f2-66d6bad08f23,posted,Uber Ride,-1743.53,1f541aae-bd6f-419a-a20a-a9c93da87c4c,10768.25,debit,payment,AU00000,2023-05-12T04:47:39Z
transaction,90fd86f4-587d-4a7e-b88a-d4f5fd05e499,posted,Netflix Subscription,-2929.73,e6d3368a-3b05-4cdb-ad5d-d5274f45d799,7838.52,debit,bank-fee,AU00000,2023-06-12T00:09:36Z
transaction,80f56e10-d368-4ff1-be53-6c3c37a6e81d,posted,Electricity Bill Payment,-3044.08,0bfb49cc-9908-48a2-a095-072c61f2103d,4794.44,debit,payment,AU00000,2023-12-10T02:23:21Z
transaction,b77e0bff-0301-4986-8c94-96ada5ca8da2,posted,TFR Acc14000 TO 12389,-3591.13,f0049a1a-e0a7-4a1d-89be-32f0dbe31ff8,1203.31,debit,bank-fee,AU00000,2023-11-14T13:04:26Z
transaction,94bc2bf6-84ac-43a7-bed1-e5567c956dc4,posted,Clothing Store Purchase,-4258.83,bee8557a-8335-418b-9785-925e5fd83d52,-3055.52,debit,cash-withdrawal,AU00000,2023-08-15T18:10:35Z
transaction,53964ada-b26c-47d4-a815-a7ccd8f87a36,posted,Non Hooli ATM Withdrawal Fee,-4062.48,7d4e240b-f23a-4792-b4ce-fbd0140b9e1f,-7118.0,debit,cash-withdrawal,AU00000,2023-11-22T20:01:32Z
transaction,54c4d793-a4c3-41dc-9b05-6e2e791dc78c,posted,Clothing Store Purchase,-214.21,c1fb480e-f132-42db-b9bc-930f24efeff6,-7332.21,debit,payment,AU00000,2023-10-11T01:04:42Z
transaction,8555b48d-5052-44d1-9c42-e5dbfcef0090,posted,Payroll WFRMS 15439393,10082.74,2261dec4-3612-43a2-850a-9019c5215b96,2750.53,credit,transfer,AU00000,2023-12-15T07:44:57Z
transaction,ebeb48e7-9c80-44cb-ab24-9c275eafb06e,posted,Gasoline Purchase,-4063.11,c10d0bac-1766-4336-a6fb-5dd779a0f378,13355.99,debit,bank-fee,AU00000,2023-10-31T01:55:55Z
transaction,945e053f-6e39-4031-9347-25acf802f1f8,posted,CTRLINK CARERS Ref: 998R6789201610974V,-4499.47,6922ef9d-bb5a-4515-bd0c-1cced5a74739,8856.52,debit,cash-withdrawal,AU00000,2024-05-09T20:58:22Z
transaction,078d8841-d26d-4810-bcf6-e83173fc271d,posted,TFR Acc14000 TO 12389,-4627.93,6699e82f-f138-4667-8c73-8f60cdcde7ab,4228.59,debit,cash-withdrawal,AU00000,2023-11-12T20:01:04Z
transaction,f6dbc5cd-6109-4508-ab62-d5ad0939fea3,posted,Transfer Platnm Homeloan 346454,-4759.15,84acb733-963c-468a-a858-f93385e98edd,-530.56,debit,cash-withdrawal,AU00000,2023-07-21T23:53:51Z
transaction,81488b60-294b-4a97-a638-51491b44c7b7,posted,Gasoline Purchase,-1851.96,9581f7c5-5d15-4ab1-8049-221461cef712,-2382.52,debit,bank-fee,AU00000,2023-05-14T19:36:53Z
transaction,18392c67-347d-48d0-a47d-7f107e9e929e,posted,TRANSFER TO JOANNA SMITH CAMPING,-4947.74,0544bb54-b618-41f5-b987-20fffea2a3bd,-7330.26,debit,cash-withdrawal,AU00000,2023-07-20T22:00:00Z
transaction,16db04c8-29e4-4159-931a-fc84f7d934fe,posted,Online Gaming Purchase,-3712.64,4540994b-02cc-46f8-bec3-f4152ca1e3e2,-11042.9,debit,payment,AU00000,2024-03-30T16:22:11Z
transaction,391530bd-7a92-405d-9c09-d664d50500d5,posted,Hair Salon Appointment,-44.7,b67621f2-93de-4564-8be1-5e93eb41e0ea,-11087.6,debit,cash-withdrawal,AU00000,2023-09-26T03:45:08Z
transaction,5016425f-5b45-47e2-bf57-d8595c02ba7a,posted,Online Gaming Purchase,-4416.96,82c70ac4-1ff5-4343-b8b5-0a7ef29071c4,-15504.56,debit,cash-withdrawal,AU00000,2023-12-21T06:37:22Z
transaction,4a9dfacb-07dd-4b8c-b109-1510497a1a24,posted,Non Hooli ATM Withdrawal Fee,-4613.15,e19d4b6f-4893-4a7d-b26d-5fc3c6c1c2da,-20117.71,debit,cash-withdrawal,AU00000,2023-09-21T13:24:58Z
transaction,4f682f81-fd88-4288-87e2-21aaa8043e87,posted,Transfer Platnm Homeloan 346454,-2229.53,4bbe25f4-e6e5-4e63-9d09-e8a600fedb40,4090.11,debit,bank-fee,AU00000,2024-03-09T06:16:12Z
transaction,8c9ad7ea-24c7-4059-aeb4-0c64fcc97511,posted,Online Gaming Purchase,-2455.95,d97630db-9650-420f-b99d-e398d8400dac,1634.16,debit,payment,AU00000,2023-09-18T10:38:03Z
transaction,3302419d-8d86-47fc-8bca-4a6a2eb031be,posted,Electricity Bill Payment,-3501.29,ce996b1e-952a-42fd-b7be-b200299fffc5,-1867.13,debit,bank-fee,AU00000,2023-11-28T08:24:48Z
transaction,21093990-39a4-4012-96b2-9137553a5ce0,posted,AGL RETAIL ENERGY LTD (GAS),-4598.81,5198229e-8a52-447d-ada7-c4e27f226790,-6465.94,debit,cash-withdrawal,AU00000,2024-01-16T17:20:08Z
transaction,5a1919d5-697d-4ea6-b6e6-97b93f51d8af,posted,Non Hooli ATM Withdrawal Fee,-3096.9,a537d3da-dd64-42be-8e67-ef0812f85017,-9562.84,debit,payment,AU00000,2023-05-24T23:32:03Z
transaction,46f19376-94f7-49d0-95bb-533a6587c670,posted,Pharmacy Purchase,-1536.47,388f9e76-8add-41f5-96c1-711fd1b970c8,-11099.31,debit,bank-fee,AU00000,2023-07-04T02:25:51Z
transaction,e2ea655b-20e5-4820-86fd-780384be21ed,posted,Non Hooli ATM Withdrawal Fee,-4986.51,085a1985-1a44-4a39-8b5f-836fb0b7e121,-16085.82,debit,cash-withdrawal,AU00000,2024-03-31T14:07:19Z
transaction,6bb449bd-4bfd-47ca-91c8-b23345e41f07,posted,TRANSFER TO JOANNA SMITH CAMPING,-4706.59,39506108-dd77-4f78-bbdf-91986527a305,-20792.41,debit,payment,AU00000,2023-12-21T05:59:48Z
transaction,27ae90c0-50d5-440f-91af-257686eede71,posted,Movie Ticket Purchase,-47.04,e1d904ea-778a-4810-afe9-a9baa3193cc9,-20839.45,debit,bank-fee,AU00000,2023-10-03T16:23:44Z
transaction,b1f0e719-7eb3-4fcf-8213-b782de9d2c81,posted,Uber Ride,-2855.33,21419beb-c189-4ed6-b742-b1983c4f69dd,-23694.78,debit,bank-fee,AU00000,2023-10-17T22:14:14Z
transaction,847efcb7-bfb8-4b13-aee9-818ada7d0387,posted,Travel Agency Booking,-2339.22,0be9f177-307a-4320-86a8-28ed5413463e,10176.39,debit,payment,AU00000,2023-08-21T07:43:40Z
transaction,cf7963ef-8435-4569-8843-b49f3a8de708,posted,Coffee Shop Purchase,-3885.15,971a2203-27c3-4c70-81ee-9493ce9ae1d5,6291.24,debit,payment,AU00000,2024-03-12T19:56:23Z
transaction,762e79a4-a5ef-4a2f-9753-afc3bf0d821f,posted,Travel Agency Booking,-4289.56,1db815b2-2151-407b-8687-9bdc61875452,2001.68,debit,cash-withdrawal,AU00000,2024-01-21T07:33:27Z
transaction,ed3ffda9-1807-4a0d-8b5e-a6827127c5af,posted,Amazon Online Shopping,-3860.3,c5c601cc-77ee-496a-a4ef-873be0489389,-1858.62,debit,bank-fee,AU00000,2023-06-25T21:05:24Z
transaction,1d2ada48-dff6-49dc-9bb9-8d473673f9f9,posted,AGL RETAIL ENERGY LTD (GAS),-493.25,fa2f7948-3e98-4021-8802-9d47c44e6b02,-2351.87,debit,bank-fee,AU00000,2023-07-19T09:26:26Z
transaction,93114c1f-f6ba-4dbe-9a5a-9120da68d3ca,posted,TRANSFER TO JOANNA SMITH CAMPING,-4275.06,87ae3429-392d-453f-94c9-52b9a52e9bb9,-6626.93,debit,bank-fee,AU00000,2023-06-11T22:18:31Z
transaction,ea8ba839-2623-4b46-a7f8-62cb2500e9b4,posted,Gasoline Purchase,-747.29,577aae50-33eb-4eb4-8d87-8734b73d6c23,-7374.22,debit,bank-fee,AU00000,2023-12-10T11:24:29Z
transaction,1fcd2c3a-cc79-45e0-9c1e-6c80b3cd08ad,posted,Payroll WFRMS 15439393,11149.52,dc8b5f87-3e0f-486e-829f-3767d6b7ae20,3775.3,credit,transfer,AU00000,2024-03-29T06:05:06Z
transaction,58b0c23b-3d92-4f9b-bff8-21cb6e4fa7e2,posted,Transfer Platnm Homeloan 346454,-947.22,e15a1979-4bc5-4e2e-b102-505457e7dec7,2828.08,debit,bank-fee,AU00000,2023-11-21T00:57:34Z
transaction,865e956d-6796-4004-acdf-634e8ff68c4e,posted,Uber Ride,-4137.29,4a63a53d-ee5f-43e3-a669-065289363e90,-1309.21,debit,bank-fee,AU00000,2023-11-19T17:01:07Z
transaction,e14e632c-a1ff-4276-842e-204e20c8e8fa,posted,Wdl ATM WESTPAC IGA BALGOWLAH BALGOWL AU,-779.44,fd3e2cca-68e0-444b-8e64-9a44175c31ba,8509.39,debit,bank-fee,AU00000,2024-01-23T18:33:36Z
transaction,556601a7-9e71-492e-8e11-ef84bdf1520e,posted,TFR Acc14000 TO 12389,-3265.34,5c88bea5-0236-4818-8f0b-27b58ce9744d,5244.05,debit,cash-withdrawal,AU00000,2023-12-28T06:30:07Z
transaction,12a3a9ad-8ea8-48c6-a38f-e0d85b661848,posted,AGL RETAIL ENERGY LTD (GAS),-4794.43,673afb7e-c1ab-4b3e-a1ad-e8ee2c5872d3,449.62,debit,payment,AU00000,2023-11-03T10:04:27Z
transaction,e07e393c-6a35-4224-a69d-0e4d5b11f9dc,posted,Gasoline Purchase,-4463.98,9efe2e49-46a5-4b64-9251-299a0faf7571,-4014.36,debit,cash-withdrawal,AU00000,2023-05-23T23:50:30Z
transaction,3a7578f1-bb47-4ffa-a694-4b86fd70cf4e,posted,TFR Acc14000 TO 12389,-2414.93,a2c7c5a3-044a-40d0-a0f4-fc5b1b5955cc,-6429.29,debit,payment,AU00000,2024-04-22T17:46:46Z
transaction,3d7173d4-5d54-4245-a5c1-133d0b130f4e,posted,Payroll WFRMS 15439393,11516.27,90c2e5e9-eff6-4c2b-9209-55154e849a88,5086.98,credit,transfer,AU00000,2023-07-16T19:36:06Z
transaction,a397e155-5381-4bd7-9bb3-31a61b518359,posted,Travel Agency Booking,-4023.82,b8debf9c-07d2-43a1-9675-8a521c9a5d0a,1063.16,debit,payment,AU00000,2023-08-01T15:08:58Z
transaction,21379ead-72d2-42cc-ae0b-bd99396e1a33,posted,Car Maintenance Expense,-4007.7,e8610d4e-c346-4802-9167-7b12c50a77f0,-2944.54,debit,payment,AU00000,2023-07-30T11:43:25Z
transaction,f48b691a-3409-44bd-827f-b196eeb30cea,posted,Music Streaming Subscription,-3674.56,794c1fd0-0468-46be-9530-5cab6a7fb7c9,-6619.1,debit,payment,AU00000,2024-02-24T08:23:01Z
transaction,606b6daf-ff18-4090-a865-48074367fd0a,posted,Gym Membership Fee,-1419.53,aaab7eac-68d7-4b47-9580-b81d7b31f64a,-8038.63,debit,cash-withdrawal,AU00000,2023-08-18T04:55:37Z
transaction,b4cd7254-eaf1-4a07-8976-555d8fd7fb5e,posted,Payroll WFRMS 15439393,11583.29,aa0be9a6-875d-4b69-8a27-bfab863a27df,28159.74,credit,transfer,AU00000,2024-03-27T10:03:14Z
transaction,8f521166-74aa-4060-ba42-fe244042d7f4,posted,Netflix Subscription,-17.55,b16931d5-dcca-48f3-a6de-4037faee1155,28142.19,debit,bank-fee,AU00000,2023-12-16T03:52:50Z
transaction,fdb0a411-1ecb-4314-bb9e-4d2bffba7a53,posted,Manly Maths Tutor Wages,-2217.13,ec92699a-fa61-43ab-b418-da25c4239b23,25925.06,debit,cash-withdrawal,AU00000,2024-02-19T04:55:53Z
transaction,9627f179-44db-4e31-98c8-0cc203da9c1e,posted,Mobile Phone Bill Payment,-3295.54,5581a904-f0b4-455e-a96a-4a873df83054,22629.52,debit,bank-fee,AU00000,2023-12-06T14:47:10Z
transaction,05c3b428-71b8-4f63-9947-de41209b4172,posted,Wdl ATM WESTPAC IGA BALGOWLAH BALGOWL AU,-4807.38,a4dc2171-9550-4ade-b5b3-ab1faa2b9780,17822.14,debit,payment,AU00000,2023-12-25T08:41:20Z
transaction,3d21cb4d-4b65-4beb-bd55-6ff412bfab0d,posted,Hair Salon Appointment,-1188.94,22172cc8-e7b5-4f67-a907-7b750600f2cb,16633.2,debit,bank-fee,AU00000,2023-08-11T04:03:14Z
transaction,0f574222-0268-42d5-be78-e477458be30a,posted,Car Maintenance Expense,-4242.23,093b7c63-d37d-4514-b8f2-9a484f79e699,12390.97,debit,cash-withdrawal,AU00000,2023-09-27T18:31:16Z
transaction,fbec9886-bd2a-4e4e-b6c9-c97c25e21902,posted,Gasoline Purchase,-3930.93,8ea4444c-c8ce-487e-9cd3-da6a30f850e2,8460.04,debit,payment,AU00000,2024-05-05T19:35:05Z
transaction,555c1242-4b65-41b4-908a-15153e138a30,posted,Car Maintenance Expense,-2300.1,2cef95f1-5222-46a3-9d3a-007b24e0fb36,6159.94,debit,payment,AU00000,2024-01-26T13:27:31Z
transaction,58340a56-5898-441d-8c7a-f919ad06620c,posted,Amazon Online Shopping,-118.95,1900e5ee-7bc5-4ab0-b1f7-2e680553593d,6040.99,debit,bank-fee,AU00000,2023-06-20T20:27:04Z
transaction,53c0dd98-15bd-44e4-a8e2-47ab6b94fbff,posted,Amazon Online Shopping,-3440.08,39d0482a-a940-431b-b480-66a315b02de5,3264.23,debit,bank-fee,AU00000,2023-07-20T08:31:17Z
transaction,873ef3ef-f7ae-4cc5-bba1-8e69798ac4a2,posted,TFR Acc14000 TO 12389,-612.9,bd97bf96-5139-4740-a6d3-8a8215d7829b,2651.33,debit,cash-withdrawal,AU00000,2024-01-26T18:02:15Z
transaction,ebc958e6-6321-40ac-bdcc-a22ac16d1394,posted,Electricity Bill Payment,-2484.99,75b186aa-0bf4-472d-8171-12b80d654180,166.34,debit,payment,AU00000,2023-07-09T10:11:23Z
transaction,5f5af588-761f-409c-87f6-f7875974e2f7,posted,Travel Agency Booking,-2871.07,e026424c-5201-41db-8fe9-2d26556d3cc8,-2704.73,debit,payment,AU00000,2023-11-09T01:46:17Z
transaction,305fa199-bd68-4e7a-abe8-e31ca1c6bf7a,posted,Gym Membership Fee,-4987.7,5622fa4c-36e6-4001-bdd2-afc03894a2d4,-7692.43,debit,bank-fee,AU00000,2023-06-30T01:45:04Z
transaction,a374bea6-0655-4559-abd2-3e04df0d39e3,posted,TFR Acc14000 TO 12389,-4004.09,49c46ad7-88b4-4e1e-8a16-fd1d082b2ad7,-11696.52,debit,bank-fee,AU00000,2023-08-30T16:46:56Z
transaction,5bbc5f31-4444-453e-89fa-ce534895c9f5,posted,Clothing Store Purchase,-1297.91,a51ad0ac-a0d8-4fb9-a612-7b2a9f95e08a,-12994.43,debit,bank-fee,AU00000,2023-10-09T08:21:14Z
transaction,178e15c0-5bdd-45ef-819d-22d739f16882,posted,Pharmacy Purchase,-4502.96,010a8667-d32a-4106-8d21-d7b0c6246968,-17497.39,debit,payment,AU00000,2023-08-02T18:00:38Z
transaction,498edc4f-6821-42e6-8758-521158d20ab4,posted,Mobile Phone Bill Payment,-4784.91,47673a42-88d6-465e-874b-f8b12a24881e,-22282.3,debit,payment,AU00000,2024-04-29T22:37:34Z
transaction,cda6fad2-c0fa-400f-b26e-58d0187ae784,posted,Pharmacy Purchase,-4527.75,e87d5c97-3e06-44c9-b541-d87e09aee1f0,-26810.05,debit,payment,AU00000,2024-01-24T14:55:01Z
transaction,9105cb6c-5d74-4da5-9fe3-9cbbb8fd7397,posted,Clothing Store Purchase,-4779.72,e2a45108-98df-487c-b166-0251b916ffaf,13345.5,debit,cash-withdrawal,AU00000,2024-01-23T12:12:12Z
transaction,5e91112c-3df7-43c0-bcc0-61668184e954,posted,Hair Salon Appointment,-1013.67,54e8dd62-5055-44dc-ba9e-7d897663f5ba,12331.83,debit,bank-fee,AU00000,2023-08-18T01:02:23Z
transaction,8afece77-c3b7-46a0-8eb6-ef2e5d7b3e67,posted,Online Gaming Purchase,-1204.6,3350c73b-238b-4fb8-b6b8-16bb48441686,11127.23,debit,bank-fee,AU00000,2024-01-01T00:42:09Z
transaction,35cf9836-24f4-4926-b9a0-00155fdd6626,posted,Gym Membership Fee,-1398.58,83b2f4c5-175b-4063-8667-68961b20fd46,9728.65,debit,payment,AU00000,2023-09-13T18:03:47Z
transaction,8cd7e606-47d1-428f-9288-4cd22084e1eb,posted,Non Hooli ATM Withdrawal Fee,-1152.01,2a3aa5a1-127a-48c6-8e18-e28f3c0753ec,8576.64,debit,bank-fee,AU00000,2024-01-22T04:28:20Z
transaction,1ede2973-3385-423c-8c68-f5a5535d5895,posted,AGL RETAIL ENERGY LTD (GAS),-939.54,7a8aab7d-a335-45c7-8a7d-4519e8b0e27c,7637.1,debit,payment,AU00000,2023-10-12T07:15:11Z
transaction,d56530ba-e6e4-40f5-be0b-32cfc7ee77c8,posted,Public Transport Fare,-3151.05,50c83a20-9473-4cbb-a601-0ce32c6ab90e,4486.05,debit,payment,AU00000,2023-10-08T21:07:38Z
transaction,6a9a4e17-db22-4c22-a58d-9350a179cdcb,posted,Mobile Phone Bill Payment,-4864.17,2000bdf9-ffbf-4407-99db-6a50084451f3,-378.12,debit,bank-fee,AU00000,2024-02-22T06:23:09Z
transaction,7ab967ba-542f-4ac0-b2a8-e8797610ab56,posted,Transfer Platnm Homeloan 346454,-4798.1,a83d87df-e9c2-488b-9d69-536fca88a976,-5176.22,debit,bank-fee,AU00000,2023-06-06T22:50:20Z
transaction,3f1368a3-d914-4582-aba1-87f7c95ff1ec,posted,Coffee Shop Purchase,-253.94,676a6c07-4ff0-4747-a626-b082c4ebfb98,-5430.16,debit,bank-fee,AU00000,2024-05-10T13:53:56Z
transaction,1e9e0f27-a19a-4487-a37d-70d6a00424ef,posted,Payroll WFRMS 15439393,10070.41,3204304d-aa80-45c5-9409-1c820813863d,22910.14,credit,transfer,AU00000,2024-01-05T01:01:35Z
transaction,b98c18b8-edfb-45f9-ad5c-842cf541d52a,posted,Uber Ride,-2896.1,efe30f4c-0933-4a43-8dcd-0dbb3fe2abce,20014.04,debit,payment,AU00000,2023-05-12T20:59:32Z
transaction,fbcfed64-bbb7-45c5-bed4-aa44b42d3a15,posted,Online Gaming Purchase,-2166.98,c261fc45-d59a-478b-bafd-406339910e0f,17847.06,debit,payment,AU00000,2023-07-27T07:21:04Z
transaction,4dfbe1ee-bdb5-4585-aafa-3523181202d4,posted,Wdl ATM WESTPAC IGA BALGOWLAH BALGOWL AU,-3745.49,4b6d9ce4-9ceb-4115-818e-5c5a73cfdc7f,14101.57,debit,cash-withdrawal,AU00000,2023-11-09T01:58:24Z
transaction,4c08a40c-98b6-44a2-95fe-4be9b582b962,posted,Gym Membership Fee,-1775.18,9035b982-d3cb-44f1-b5f3-3da2c7390c02,12326.39,debit,payment,AU00000,2023-11-05T07:31:08Z
transaction,20db80e9-ea48-4763-8ffe-490896601142,posted,Mobile Phone Bill Payment,-2565.23,7cacba67-4c87-4f76-949c-57cb5bf0ed81,9761.16,debit,cash-withdrawal,AU00000,2024-01-29T13:23:45Z
transaction,8ae51dfa-8ebb-40b0-a139-e11b19ffd048,posted,Pharmacy Purchase,-2625.55,915067eb-8276-43c2-bb9d-b6770ce80b6d,7135.61,debit,payment,AU00000,2024-01-27T11:06:52Z
transaction,2458193f-daaa-4428-8b77-a07de6005c92,posted,Online Gaming Purchase,-1253.08,e5c63906-fa5c-4f6d-aef5-35c43981e70e,5882.53,debit,cash-withdrawal,AU00000,2023-12-20T01:49:32Z
transaction,55550f1e-6720-47b7-9f2d-8f1197ea81bb,posted,Bookstore Purchase,-1735.27,9bc172ee-df78-4ac1-80ba-f8a4a2423ec4,4147.26,debit,payment,AU00000,2023-07-09T17:54:26Z
transaction,802d92b1-59f5-46b4-b832-75c63838485f,posted,TRANSFER TO JOANNA SMITH CAMPING,-2652.7,0e1f77df-ca0c-4af0-98e1-aa09d0ca8704,1494.56,debit,payment,AU00000,2024-03-05T12:08:47Z
transaction,eeb262e3-3296-45e7-9c6b-037f2bb86bed,posted,Music Streaming Subscription,-4297.8,4b1ccd62-66c6-44f4-9a23-89579afea6bb,6903.55,debit,bank-fee,AU00000,2023-08-30T14:37:07Z
transaction,87566877-7678-41e3-b1c5-cd49d890d325,posted,Home Improvement Store Purchase,-572.2,ecb4c933-8389-42f1-88c1-eaaa3f05c41c,6331.35,debit,payment,AU00000,2023-11-28T01:32:54Z
transaction,df5c02da-3920-405d-903d-5424ef8864e9,posted,Manly Maths Tutor Wages,-2972.53,fd654d22-2991-4832-b911-20a4071723af,3358.82,debit,cash-withdrawal,AU00000,2023-06-05T00:13:22Z
transaction,a1deeb80-d04f-4c76-b173-87232aac22c4,posted,Online Gaming Purchase,-822.19,2f69ddcc-149a-48ba-b88a-f0be98ec8a2c,2536.63,debit,cash-withdrawal,AU00000,2023-08-30T04:44:56Z
transaction,2f21cbad-74a1-469d-8630-8ab6f65a3048,posted,Gym Membership Fee,-145.7,bf8f87c1-91c2-4202-b0a6-fa7f25eda6ac,2390.93,debit,payment,AU00000,2023-07-21T15:27:25Z
transaction,1c1ed5cc-df17-4f22-b1b0-350e172755be,posted,Manly Maths Tutor Wages,-943.78,4f1b413a-ff03-4af4-9ac0-7020ec515180,1447.15,debit,bank-fee,AU00000,2024-04-05T10:49:18Z
transaction,7dc141d5-a196-4e78-abf9-a150bd44138d,posted,Amazon Online Shopping,-4000.36,ec44466f-8188-4597-8ab2-0d9ca35cbe83,-2553.21,debit,payment,AU00000,2024-02-01T04:41:23Z
transaction,e41bc781-6538-441c-ae7d-9f4c034d82e5,posted,Bookstore Purchase,-176.35,a11111d3-bc26-4e97-b912-341993de2151,-2729.56,debit,bank-fee,AU00000,2023-11-01T13:57:01Z
transaction,f490c866-da1e-4084-9e7a-2f801df9378f,posted,Clothing Store Purchase,-771.11,9e61aed7-8c65-4b98-8e96-64248227785f,-3500.67,debit,cash-withdrawal,AU00000,2023-07-11T23:30:23Z
transaction,bcbb974d-b927-41fe-8e14-ccedcf6c62a3,posted,Car Maintenance Expense,-2051.29,670b9045-522c-4e39-a30e-26dd02e57f38,-5551.96,debit,cash-withdrawal,AU00000,2023-05-27T19:01:52Z
transaction,5fcad441-49a4-45cc-bccd-f7ba2a3e481b,posted,Netflix Subscription,-2842.93,12fc056a-53e9-4e2b-a44c-b84aa66d1e45,5725.61,debit,bank-fee,AU00000,2024-01-03T03:26:14Z
transaction,f7592993-dcab-46aa-9785-5cc1b3d3d0b5,posted,AGL RETAIL ENERGY LTD (GAS),-497.38,5287d86a-33e8-4b33-bdfe-6c43fb18c470,5228.23,debit,bank-fee,AU00000,2024-01-04T02:01:54Z
transaction,aa22dd7f-44c6-44ad-8b75-866574fa16c3,posted,Electricity Bill Payment,-3327.27,dfa3782d-a08c-4256-b9cf-a5b27658a141,1900.96,debit,bank-fee,AU00000,2023-09-18T13:27:30Z
transaction,9edd244a-894a-4fbe-8f48-2f47c2cc4dc4,posted,Gym Membership Fee,-451.28,d1b7dcd8-d74d-4fa4-8e7a-a4d73c3fe0de,1449.68,debit,bank-fee,AU00000,2024-01-30T05:25:01Z
transaction,0f8f96a5-0249-44a6-8aef-fbc7b2142d99,posted,Clothing Store Purchase,-1682.62,102dda39-8f5c-4f42-92b9-2af3fa418e90,-232.94,debit,cash-withdrawal,AU00000,2023-07-05T01:46:04Z
transaction,b79abfb1-e001-4797-83f4-b8a66655ca18,posted,Amazon Online Shopping,-3683.57,0527bec6-e97e-4535-b10d-f17409d9d5bc,-3916.51,debit,bank-fee,AU00000,2024-02-22T04:17:29Z
transaction,e250312d-096a-4074-be77-3b4b1e3a68c6,posted,Amazon Online Shopping,-1560.43,64224911-f16c-4645-90d2-3653d2f4742b,-5476.94,debit,payment,AU00000,2023-12-26T04:20:32Z
transaction,13ad99d3-f432-41be-a712-dbd11ed8c4d5,posted,Hair Salon Appointment,-1590.12,7391305b-cf42-4651-9153-b52489e387c3,-7067.06,debit,cash-withdrawal,AU00000,2023-09-22T21:06:15Z
transaction,a4af0ae6-12c2-432c-8417-8fbbec8c132c,posted,Car Maintenance Expense,-2356.58,eb0948a8-5f1c-4239-b5db-fb859c4f607c,-9423.64,debit,payment,AU00000,2024-03-17T00:17:55Z
transaction,7d9f460e-d48c-4762-83a4-ff944690777e,posted,Payroll WFRMS 15439393,11871.13,744a4829-df36-46b7-9069-39d0a163116b,2447.49,credit,transfer,AU00000,2023-12-02T10:58:18Z
transaction,a0a6975a-ad52-4d18-984a-8c1ecfb00157,posted,Wdl ATM WESTPAC IGA BALGOWLAH BALGOWL AU,-3762.78,47199c37-37e0-4a42-9193-3576538439e8,1837.95,debit,payment,AU00000,2023-11-29T08:14:45Z
transaction,454e529a-8423-4d71-b266-0db5ca6bfcad,posted,Clothing Store Purchase,-3925.82,626432e4-3cfe-49b5-a9ed-8594cd14ba56,-2087.87,debit,payment,AU00000,2024-05-07T16:43:27Z
transaction,9431607f-22a8-4161-bd09-67b036737381,posted,Manly Maths Tutor Wages,-2594.0,eeaacce9-65ab-4c46-9846-4319fefdba60,-4681.87,debit,bank-fee,AU00000,2023-05-15T09:52:14Z
transaction,feeee853-d1c1-4ecf-89b1-4557dbd3d4db,posted,Travel Agency Booking,-2589.11,7781caf9-233a-4296-839d-c26352d70bad,-7270.98,debit,bank-fee,AU00000,2024-05-03T10:31:39Z
transaction,bc08b807-d8a4-43b2-a4a4-55dbef000b91,posted,Restaurant Dinner,-1284.9,9fca7b4e-d260-44f3-8190-030a586508e2,-8555.88,debit,payment,AU00000,2023-11-17T04:51:14Z
transaction,034e68db-0869-40e5-be23-1237d23e74ea,posted,Restaurant Dinner,-742.93,e40b6718-ab65-43db-b880-a9a1a0ea1cf4,-9298.81,debit,payment,AU00000,2024-01-23T03:00:53Z
transaction,259a06a6-5c40-414b-a805-e28709a43b05,posted,Hair Salon Appointment,-1764.86,2b2e3fb1-0c9b-4c17-a92c-dfb1f9c4ba26,-11063.67,debit,payment,AU00000,2024-03-03T10:46:23Z
transaction,830463c6-8ed0-4f48-8db6-a43d369446a7,posted,Movie Ticket Purchase,-545.43,8c11e07e-7147-49e6-8073-4822c6a929ec,-11609.1,debit,payment,AU00000,2023-10-20T09:29:28Z
transaction,dd6f7878-bd1d-4303-802a-60a6b1a0080b,posted,Amazon Online Shopping,-2427.68,7256e398-b0cc-4b27-ab12-13a5b6612758,-14036.78,debit,cash-withdrawal,AU00000,2023-09-08T09:47:02Z
transaction,c9171b30-8902-4d27-951b-404f5c3e219f,posted,Public Transport Fare,-2283.76,e6de9c46-8372-4987-95b7-21c738938d43,-16320.54,debit,payment,AU00000,2023-06-07T10:07:54Z
transaction,d4370934-3d3b-4ed6-bbf4-8f8002af11e5,posted,Non Hooli ATM Withdrawal Fee,-3948.41,5c87d968-ce74-4110-aed6-54401fd89b1a,10932.26,debit,cash-withdrawal,AU00000,2023-05-21T23:45:39Z
transaction,0b3fcf40-5836-4be4-8765-ffce1d63ea74,posted,Gym Membership Fee,-4596.68,5c5acd32-7f58-44e9-b8e8-795def697b06,6335.58,debit,bank-fee,AU00000,2023-09-14T02:16:44Z
transaction,1b2f7e06-03bc-404e-b0cd-eba6d226ddf7,posted,Car Maintenance Expense,-3285.43,4bce6edb-e73e-4f34-ba41-fa25c9f2f61a,3050.15,debit,bank-fee,AU00000,2024-03-15T20:46:08Z
transaction,68238048-b243-4eff-a41f-62862b2457bf,posted,TFR Acc14000 TO 12389,-2733.44,376d7969-9f98-4e92-849c-063767c854f9,316.71,debit,bank-fee,AU00000,2023-12-12T04:17:33Z
transaction,f4b21a9f-a07a-4b9b-9754-d842156a0863,posted,Wdl ATM WESTPAC IGA BALGOWLAH BALGOWL AU,-152.99,ea8c3ae7-65eb-4680-b972-db900f216535,163.72,debit,payment,AU00000,2024-04-25T17:08:31Z
transaction,8930b2e9-1116-43a2-88b0-ca3292d03532,posted,Hair Salon Appointment,-4669.94,b6c55998-8f3e-4958-a02f-4eedf9ef53f9,-4506.22,debit,bank-fee,AU00000,2023-08-24T03:16:45Z
transaction,449c18a0-b4c4-4f98-b375-966fdb2b1122,posted,Manly Maths Tutor Wages,-656.01,df76f535-dec5-46dc-8089-71c32bcbb3a2,-5162.23,debit,payment,AU00000,2023-09-24T14:42:47Z
transaction,26d9c9c2-1e2d-482f-90e3-73e717beb514,posted,Movie Ticket Purchase,-1404.92,75b351dd-9180-4168-ba10-3bceab934a13,-6567.15,debit,bank-fee,AU00000,2023-10-08T18:20:31Z
transaction,467e1287-3fbc-439f-83b9-b0a5b2c62b43,posted,Travel Agency Booking,-2940.85,3e6796cd-2623-497d-b7a7-c78d9ee3e74a,-9508.0,debit,bank-fee,AU00000,2024-03-06T22:30:35Z
transaction,f99cc56c-93cf-4fd4-a316-8581b4312221,posted,Netflix Subscription,-4719.72,32a9227d-a268-43f4-83c5-fd86bf5398b5,-14227.72,debit,cash-withdrawal,AU00000,2024-02-08T03:44:33Z
transaction,59012885-a7c3-43fa-a834-817b401a3b70,posted,Transfer Platnm Homeloan 346454,-4961.82,4b7270f5-1ec9-47dd-bb14-93dc05b581e4,8277.18,debit,payment,AU00000,2024-01-06T08:34:57Z
transaction,2a490cec-c78b-4630-a60c-f7a4ced9dfef,posted,Pharmacy Purchase,-3067.75,c142a719-a8c1-4db4-b395-ea44f69320a2,5209.43,debit,bank-fee,AU00000,2023-07-29T04:12:15Z
transaction,5d135148-a613-4535-b34f-0b14bd40b111,posted,Wdl ATM WESTPAC IGA BALGOWLAH BALGOWL AU,-4544.23,9a028034-ce37-4fe9-b3b2-7ea573b30d6e,665.2,debit,bank-fee,AU00000,2023-08-06T23:59:02Z
transaction,1e48cf98-23fd-4e4c-9658-d41c38f42eb8,posted,Amazon Online Shopping,-4626.23,5202cd79-78b3-4cdd-8a55-da738be36ed2,-3961.03,debit,cash-withdrawal,AU00000,2024-02-01T17:39:15Z
transaction,a77d5672-add7-492a-9e6b-bf572d3c88d3,posted,Gym Membership Fee,-4231.83,13aca504-667f-4b11-9221-227bb73edaf0,-8192.86,debit,payment,AU00000,2023-12-14T04:44:00Z
transaction,5ae9fb47-a14d-4b45-b1d2-39be38e1fa59,posted,Electricity Bill Payment,-3847.53,3eb6b709-c003-4438-acb6-e90221a799ca,-12040.39,debit,cash-withdrawal,AU00000,2023-10-03T05:13:57Z
transaction,6ecc5798-a31c-4307-9b86-ac944f1c84aa,posted,Manly Maths Tutor Wages,-3756.27,801275c5-6616-4f05-8b1c-7306526500bb,-15796.66,debit,bank-fee,AU00000,2024-02-27T18:51:23Z
transaction,20bc534d-68f9-4152-a28b-0e44aada5abf,posted,AGL RETAIL ENERGY LTD (GAS),-2321.16,889857d3-0d6e-430e-973a-a9bf9007870d,-18117.82,debit,payment,AU00000,2023-11-26T02:59:15Z
transaction,724dcd7c-4984-4720-b43a-11e522caf157,posted,Manly Maths Tutor Wages,-4733.93,a2625418-38aa-4b35-b36f-847d17a85a64,-22851.75,debit,bank-fee,AU00000,2024-03-20T17:52:33Z
transaction,3918e378-6186-4d68-9d7c-eed7c1f6654b,posted,Music Streaming Subscription,-4807.81,f2ba0bef-771b-47d6-a5b4-613bc689bf9d,-27659.56,debit,cash-withdrawal,AU00000,2023-08-31T22:52:31Z
transaction,71e3961b-dbb3-4036-a0fd-4f9594bf3d75,posted,Restaurant Dinner,-4909.72,460a9cc0-af59-4da2-bff8-7b4bfcb774bd,7306.08,debit,payment,AU00000,2024-03-24T16:21:36Z
transaction,8e65879f-9d82-4726-9341-48d543b391e7,posted,TRANSFER TO JOANNA SMITH CAMPING,-2958.09,5397476b-af70-4d52-b99a-4dcdb4ddb3c8,4347.99,debit,bank-fee,AU00000,2023-07-07T17:48:25Z
transaction,466295e3-4a41-4d94-8b2d-a5bb6d39d257,posted,Wdl ATM WESTPAC IGA BALGOWLAH BALGOWL AU,-4786.23,ad58ef14-ea12-4242-9edb-3fe4e3e8bff5,-438.24,debit,cash-withdrawal,AU00000,2023-08-24T19:57:42Z
transaction,7606e805-2943-4527-a9dc-3a77c123dd30,posted,Restaurant Dinner,-122.09,b753f3d6-fb78-4d64-a7bf-cbd3213abbc8,-560.33,debit,bank-fee,AU00000,2023-09-09T01:29:15Z
transaction,219c0e2f-ed67-45a8-8f9c-e45e5f2dc7fc,posted,Transfer Platnm Homeloan 346454,-954.91,cfbae97a-e0b4-4ddf-8187-8ecddbf601ea,-1515.24,debit,cash-withdrawal,AU00000,2024-02-10T14:14:12Z
transaction,aa8baadc-a665-4ecf-a128-e690bc82df9c,posted,Payroll WFRMS 15439393,11508.08,a7a87a11-4c14-4aa9-83bf-9061808fe345,9992.84,credit,transfer,AU00000,2023-08-18T22:13:13Z
transaction,cca813df-18db-485f-93c2-d918533be0b6,posted,Movie Ticket Purchase,-173.85,6ff31fc2-6ea2-4cf5-a662-6eda90693490,9818.99,debit,bank-fee,AU00000,2023-06-04T19:10:57Z
transaction,10c2cb60-1047-4797-9a77-07f3f3e6c5c5,posted,Travel Agency Booking,-4712.48,e57a0ecf-270b-4de3-ac23-04479618289d,5106.51,debit,payment,AU00000,2024-02-17T09:10:10Z
transaction,54e19e96-679c-45dc-b7b0-09b0cb730820,posted,Netflix Subscription,-1764.47,5ee65656-04cd-45bc-a9a9-d156956dcc2d,3342.04,debit,cash-withdrawal,AU00000,2023-09-14T02:06:18Z
transaction,6f89e801-484e-4c1a-a92e-b8a9f86cae6d,posted,TRANSFER TO JOANNA SMITH CAMPING,-2603.86,0bb6540e-e9a4-4bd4-8357-d7873a89ad11,738.18,debit,bank-fee,AU00000,2023-11-03T12:28:29Z
transaction,2bdd82a7-9193-4fe5-a3d8-ae0f457be713,posted,Netflix Subscription,-312.35,c4c43ca0-ca21-464f-85ab-3e56b5d39dc5,16549.94,debit,payment,AU00000,2024-04-10T13:55:04Z
transaction,20f044a6-f925-440b-908a-2e363e76c53f,posted,Mobile Phone Bill Payment,-2459.68,34fa8158-bbe7-471d-94a5-3d640f442f02,14090.26,debit,cash-withdrawal,AU00000,2024-03-31T23:50:10Z
transaction,fdefc907-d324-49bd-8a5b-7fc635e4cee3,posted,Wdl ATM WESTPAC IGA BALGOWLAH BALGOWL AU,-3768.25,6133f0cc-fa75-4112-946a-5f223dc62ce6,10322.01,debit,payment,AU00000,2023-06-03T12:20:41Z
transaction,bb0c0e5f-27c0-48eb-9265-ca69e5a8a8c5,posted,AGL RETAIL ENERGY LTD (GAS),-2302.14,e4a29e93-07f6-4f10-9ebb-e5d92e83eb78,8019.87,debit,bank-fee,AU00000,2024-01-03T22:59:54Z
transaction,b034bf90-0ac1-4201-8853-196d21074979,posted,Mobile Phone Bill Payment,-4502.25,01c7a2b5-f115-49ce-b0fd-6d591efea471,3517.62,debit,payment,AU00000,2023-11-27T21:12:11Z
transaction,099127a8-bb3d-45f4-9ebd-7ea67b3dd078,posted,Movie Ticket Purchase,-2806.76,68f8e090-f77d-4280-9781-372fafb3f303,710.86,debit,bank-fee,AU00000,2024-01-17T11:42:26Z
transaction,22a0c1d7-9513-45dd-a20d-33032bdc6792,posted,Gym Membership Fee,-2968.4,7fce2a1d-d1ba-40e9-8e39-294100689647,-2257.54,debit,cash-withdrawal,AU00000,2023-06-21T08:04:29Z
transaction,ba546e8f-a3d1-49d6-9842-165f79bda710,posted,Netflix Subscription,-1821.46,0a13498e-1edc-42d4-97a2-0c1cd3c09a43,-4079.0,debit,bank-fee,AU00000,2024-01-21T20:27:17Z
transaction,1eab5950-71fc-4696-84c9-e91d879f9390,posted,CTRLINK CARERS Ref: 998R6789201610974V,-1086.99,90fe4694-a387-423b-b0a5-3240b2a8b700,-5165.99,debit,payment,AU00000,2024-03-13T13:06:39Z
transaction,3d8cdfc5-f452-4d55-bc93-7148e0ff2c12,posted,Pharmacy Purchase,-3697.21,8cb2a1bb-d300-48e8-b1d1-27a35cf0e6e6,-8863.2,debit,payment,AU00000,2023-07-18T09:47:07Z
transaction,9904f90e-09e4-465b-bb76-f76ece1ff0d4,posted,Coffee Shop Purchase,-3709.62,e845ae09-5a74-49b4-9408-49b52b372444,2754.3,debit,cash-withdrawal,AU00000,2024-03-07T02:37:07Z
transaction,ace2fb77-4488-43a0-8c40-31c33c30792f,posted,Mobile Phone Bill Payment,-1568.53,1c683a46-3b11-42c4-9c6f-bdfac4351779,1185.77,debit,bank-fee,AU00000,2023-10-05T16:57:53Z
transaction,6624bd96-1811-41e3-abeb-8158e0af3f07,posted,Non Hooli ATM Withdrawal Fee,-4692.49,ca7c5ed1-dda7-47e5-963b-2c7c6d7effad,-3506.72,debit,bank-fee,AU00000,2023-10-28T02:26:47Z
transaction,e668c0e9-5792-4b06-8d42-5166823bb0bf,posted,Electricity Bill Payment,-2539.2,e8f8a4d4-a11d-437c-8e99-36251580eecb,-6045.92,debit,bank-fee,AU00000,2023-10-17T20:48:47Z
transaction,9012ad19-0a69-44a9-a7e5-c06150706250,posted,Netflix Subscription,-411.93,babc38ed-e9f2-4d3b-8c65-2b8983f202c6,-6457.85,debit,payment,AU00000,2024-05-09T19:26:11Z
transaction,11fbbafa-b1ea-49f2-9e80-cde7f52591fe,posted,Gasoline Purchase,-3744.8,9839300e-acb1-4c97-873b-5ed9c9c673f0,-10202.65,debit,bank-fee,AU00000,2024-01-06T01:16:57Z
transaction,3a66745d-d9a0-4e87-948b-230dc8564479,posted,Car Maintenance Expense,-4357.93,c14102a0-eadd-48c5-bebe-701a890ee77f,-14560.58,debit,cash-withdrawal,AU00000,2023-07-03T17:10:13Z
transaction,07a4cd17-b0f5-4086-a3e3-be10ce0d4ad5,posted,Electricity Bill Payment,-4746.45,eb28702c-b452-4249-a798-dba28715ca90,-19307.03,debit,bank-fee,AU00000,2023-07-04T02:17:03Z
transaction,f5a6df85-7cba-4e91-b6ff-ff27dd890482,posted,Transfer Platnm Homeloan 346454,-4512.51,af41a6e2-03e5-4272-a93d-e8372049bf41,-23819.54,debit,cash-withdrawal,AU00000,2023-08-10T22:31:20Z
transaction,a610048d-6ac4-447d-accc-7c05981064cd,posted,AGL RETAIL ENERGY LTD (GAS),-1148.14,c23889be-2269-4f99-90de-54c1c098f7da,-24967.68,debit,cash-withdrawal,AU00000,2023-09-06T06:56:33Z
transaction,0a1bad01-46fc-4215-9c2a-13578ccab9ac,posted,Gym Membership Fee,-4280.07,c7547337-8f5b-4af3-8de2-8930018b6dfa,13296.74,debit,payment,AU00000,2023-06-28T17:14:12Z
transaction,48b1fcf0-56f1-41b4-a3d9-022e17d4f946,posted,TFR Acc14000 TO 12389,-256.67,e84a2062-78cb-440c-b0bf-6f9fdc7a244b,13040.07,debit,payment,AU00000,2023-11-10T21:21:40Z
transaction,838df206-3ce1-4804-8567-4d9f71e23662,posted,TFR Acc14000 TO 12389,-2696.36,1a7270ec-1356-4e16-85eb-ce07458bfb6c,10343.71,debit,payment,AU00000,2023-06-08T16:56:08Z
transaction,7b5ae4ee-f24d-472e-9622-b33c0d282336,posted,Restaurant Dinner,-1181.8,40410017-552c-42ef-982f-020e1d10bb23,9161.91,debit,bank-fee,AU00000,2023-09-29T12:47:55Z
transaction,bf2e5cdd-a440-453c-bfe8-d710e43051e2,posted,Payroll WFRMS 15439393,10243.32,0d36364e-9ec2-45e9-bdd6-76e40ba2a3e1,19405.23,credit,transfer,AU00000,2023-06-11T14:07:55Z
transaction,fa176891-747c-460f-868c-695583f7c17e,posted,Uber Ride,-2792.07,f9db514c-e739-4415-9d8b-e845f92acdbe,16613.16,debit,bank-fee,AU00000,2023-09-03T20:18:22Z
transaction,b7051dd8-d0ab-43e6-aca7-fdace7039c6e,posted,Amazon Online Shopping,-4025.2,bd554f72-9fed-48dd-9dbf-646dc2d93f8e,12587.96,debit,payment,AU00000,2023-06-16T01:46:44Z
transaction,418292fd-21cf-438f-bd55-f2e4bd4afcf7,posted,Electricity Bill Payment,-799.6,bcb1ee73-851c-488c-bd5e-fcb183bb4090,11788.36,debit,bank-fee,AU00000,2023-11-16T17:24:00Z
transaction,97fedf45-0a7b-46b6-bf7f-9069022eeaec,posted,TRANSFER TO JOANNA SMITH CAMPING,-4113.63,86f6c70e-a979-488a-bacb-e1296f19b824,7674.73,debit,cash-withdrawal,AU00000,2024-01-25T23:30:55Z
transaction,c3185fe5-ba76-40ec-b2e1-cbe0fd3b19f6,posted,Netflix Subscription,-2688.21,31ef4035-1845-4700-b1f3-b8e51acbf52b,4986.52,debit,bank-fee,AU00000,2023-06-26T15:38:50Z
transaction,7b8f61a3-10ea-420a-b6dd-a0497966d375,posted,Public Transport Fare,-281.63,840204f5-b958-44ac-bbab-72e31f5e8912,8649.5,debit,cash-withdrawal,AU00000,2023-05-26T01:46:37Z
transaction,4f1e3c60-7f22-4686-902f-9f97ceb0f4ef,posted,Mobile Phone Bill Payment,-4216.68,6a9c0ea4-3048-4511-822c-47947b717b78,4432.82,debit,bank-fee,AU00000,2023-05-17T12:50:39Z
transaction,703b3d17-04be-4de2-bfa8-88b9b31a1834,posted,Music Streaming Subscription,-494.65,6d22cb92-a452-4a2e-ab3b-cd2870851bc7,3938.17,debit,payment,AU00000,2023-12-27T13:39:07Z
transaction,24dcc375-d339-44c3-a2e1-5e7101ef5e5d,posted,Restaurant Dinner,-830.29,0186592e-8910-4280-85d8-0702e0fb6d48,3107.88,debit,cash-withdrawal,AU00000,2024-04-06T13:01:12Z
transaction,8824dc10-a837-4f9a-b5cc-3fe78b1e76c2,posted,Gym Membership Fee,-4071.97,e09e44e4-8426-4044-b7ea-d407d843e6cb,-964.09,debit,bank-fee,AU00000,2023-10-28T08:43:29Z
transaction,628981e2-5c4f-493d-9a24-47e1ec0fc14e,posted,Gym Membership Fee,-3128.86,121e25e7-d7e9-4159-86b5-42a848f5e066,-4092.95,debit,cash-withdrawal,AU00000,2023-08-26T22:39:38Z
transaction,eb6ce37a-62af-4f15-b22f-10fcefd473f4,posted,Home Improvement Store Purchase,-2796.13,087908a8-9365-4ae6-b5b5-78479701a4b8,-6889.08,debit,bank-fee,AU00000,2024-04-28T06:38:35Z
transaction,f6b169ec-9c5f-4cc7-80a8-e694d40c849a,posted,TFR Acc14000 TO 12389,-60.69,ca9d2f19-bd53-45e8-a0c9-a2cb0a3f0793,-6949.77,debit,payment,AU00000,2023-11-11T07:50:54Z
transaction,ba592a7c-2473-4d6c-8ed2-3568a20f0f21,posted,Mobile Phone Bill Payment,-1643.5,a6d4ef5a-6c1f-4503-a5d2-2fc733308a66,-8593.27,debit,bank-fee,AU00000,2023-12-12T08:19:01Z
transaction,6215bf34-43f7-4267-8fb4-79ee6ae97ae8,posted,AGL RETAIL ENERGY LTD (GAS),-4338.31,ce38a15e-562f-420d-becf-d2ae3c694dc6,-12931.58,debit,cash-withdrawal,AU00000,2024-04-23T13:05:21Z
transaction,ed4080cc-4544-48a2-9a83-3a172fe8b1d3,posted,CTRLINK CARERS Ref: 998R6789201610974V,-60.48,081ae362-8de3-4b13-898a-6d037fa65baa,15674.84,debit,cash-withdrawal,AU00000,2023-12-15T05:23:40Z
transaction,55ab0fe8-33c5-441d-a846-e876841b4638,posted,Car Maintenance Expense,-937.73,25940e10-e842-412d-8dae-5740e3c4c7b2,14737.11,debit,bank-fee,AU00000,2024-02-07T01:42:50Z
transaction,cfae2810-4b78-4d61-b8bf-6ba66bea356b,posted,Public Transport Fare,-2832.93,0d1887a3-8dc1-4856-9eb7-12e8903a0cba,11904.18,debit,cash-withdrawal,AU00000,2023-08-03T15:26:19Z
transaction,c8a30f45-679e-46dd-8ac6-29bb3cf1a34b,posted,Movie Ticket Purchase,-1596.83,5772673f-f170-4b2d-82ae-458211378e89,10307.35,debit,cash-withdrawal,AU00000,2023-08-23T13:01:01Z
transaction,5b9e54d5-110e-4623-9b08-239b744ff37b,posted,CTRLINK CARERS Ref: 998R6789201610974V,-979.59,c9c343ad-c31d-4b0b-b3c1-f38a65dbe7bf,9327.76,debit,bank-fee,AU00000,2023-10-17T22:54:03Z
transaction,26b8f0af-ec71-4ba5-9a23-b67a6e8751a0,posted,Electricity Bill Payment,-1068.49,da7e7460-5b10-4dc0-83c9-4af77b8d0b95,8259.27,debit,payment,AU00000,2023-11-10T01:07:33Z
transaction,0671d0f4-e3c3-4b42-b183-4507b64a768e,posted,Hair Salon Appointment,-2126.8,573a8fc9-2dfb-48c6-8226-4d07fbe5d116,6132.47,debit,payment,AU00000,2023-06-01T16:45:14Z
transaction,c4c9e8b5-a29b-48eb-b831-6ff4cbe40fe0,posted,Clothing Store Purchase,-690.21,bbc79479-dd5c-4188-ab40-5900eaae362d,5442.26,debit,cash-withdrawal,AU00000,2023-05-23T23:32:51Z
transaction,715d7254-d6db-4573-a210-af162ef02c52,posted,Pharmacy Purchase,-719.71,35605768-eda0-4ed6-b2bd-3d5f7d92b26e,4722.55,debit,payment,AU00000,2024-02-26T03:48:34Z
transaction,cbb85acd-748e-4ce8-a121-43d019731cc4,posted,Transfer Platnm Homeloan 346454,-3324.81,15c1943b-3aae-47a4-9113-ad93a94977e1,1397.74,debit,payment,AU00000,2024-05-07T11:10:57Z
transaction,a87ea8f2-22f1-4146-8687-a0f7eb236fa4,posted,AGL RETAIL ENERGY LTD (GAS),-1814.63,aebbc75b-748e-49a3-8b5c-068e28ddc4f2,9330.69,debit,bank-fee,AU00000,2023-08-13T09:24:43Z
transaction,e088a9fe-765a-469d-9c4d-28a690a2b8ce,posted,Coffee Shop Purchase,-1417.46,c70bd1f7-ce4c-4da7-9e58-c0025afc9928,7913.23,debit,payment,AU00000,2023-12-20T12:39:11Z
transaction,fdbd2d41-3035-4c1d-b3e4-4f12e62a4751,posted,Payroll WFRMS 15439393,10134.53,7d8ab273-98dc-4275-b4a9-7d962736ec7c,18047.76,credit,transfer,AU00000,2024-05-10T01:39:00Z
transaction,ecee337a-37b0-4563-af24-495631fe08c8,posted,Home Improvement Store Purchase,-204.04,2b2c8be3-046f-4adb-8c36-9e6a190e72ac,17843.72,debit,bank-fee,AU00000,2023-09-09T01:37:12Z
transaction,5c1a00ee-fc70-4819-a684-76cdc2888bd5,posted,Mobile Phone Bill Payment,-4667.59,5729643b-5b95-4feb-9a30-49645920efb3,13176.13,debit,cash-withdrawal,AU00000,2023-08-29T17:21:24Z
transaction,2aa1b619-b12f-4d54-83cf-343c25aa3c4a,posted,CTRLINK CARERS Ref: 998R6789201610974V,-1793.79,e9066b01-b318-4698-8273-da11a1234835,11382.34,debit,bank-fee,AU00000,2023-08-23T06:05:42Z
transaction,a6c09d42-b439-425c-b328-b8a1683abead,posted,Uber Ride,-3972.34,91d924f1-0707-41f9-8612-5986da2dd216,7410.0,debit,bank-fee,AU00000,2023-09-04T22:57:20Z
transaction,537f5ad1-77fd-454a-9fd8-7bce8b993bf1,posted,Manly Maths Tutor Wages,-1113.65,e4217408-e80b-4b80-b89b-aeabda0cbf79,6296.35,debit,payment,AU00000,2023-12-22T18:06:16Z
transaction,eacc54df-4abe-4309-bb94-c5612954c26b,posted,Electricity Bill Payment,-1236.59,7ed5e2e8-665a-442d-a0ef-6747b83a980c,5059.76,debit,payment,AU00000,2024-03-11T08:14:39Z
transaction,d06adf2c-c1ab-4363-acf5-1aed546374cd,posted,Uber Ride,-1102.31,d14d4d38-6915-470e-95a5-45e4a89023f3,3957.45,debit,cash-withdrawal,AU00000,2024-05-03T03:15:01Z
transaction,9c89fd95-5b5f-4529-a51d-a282476588b7,posted,Pharmacy Purchase,-1685.31,954ebb95-4afd-42e1-ba3c-372f81ff05f9,17548.27,debit,cash-withdrawal,AU00000,2023-06-17T23:35:52Z
transaction,47a788cf-e482-4b7c-b100-98600bfdf982,posted,AGL RETAIL ENERGY LTD (GAS),-2035.86,51a1e5ed-a572-4b82-b322-5cdd6e3c9426,15512.41,debit,payment,AU00000,2024-01-14T22:06:59Z
transaction,9555be38-2688-4816-b66d-6789f8b3c275,posted,Home Improvement Store Purchase,-309.0,1a03c1ba-6937-4e54-9a87-dccc5bbb018f,15203.41,debit,cash-withdrawal,AU00000,2023-12-31T01:10:07Z
transaction,24a97564-aa8a-407f-9627-11dcfb1968c9,posted,Car Maintenance Expense,-3993.42,97846447-882f-4d49-ad9f-d4661e7c37af,11209.99,debit,cash-withdrawal,AU00000,2023-06-25T09:25:08Z
transaction,cc1496e5-4243-477c-80e3-dd188fa84964,posted,Restaurant Dinner,-743.71,c4842bca-99d3-44c6-aa4a-ccb62952e55e,10466.28,debit,cash-withdrawal,AU00000,2023-07-01T19:31:58Z
transaction,8cc4431b-fc05-46e8-aa11-3322566a575d,posted,Pharmacy Purchase,-1655.43,725f92d9-70bd-4fff-8f88-91cf6a05eb55,8810.85,debit,cash-withdrawal,AU00000,2023-09-12T19:23:29Z
transaction,9ed44122-f032-408a-ac8f-6c738c0896bc,posted,TRANSFER TO JOANNA SMITH CAMPING,-3671.99,b39de8b2-4957-4ea8-b68d-78adfbd72657,5138.86,debit,payment,AU00000,2023-10-30T21:25:20Z
transaction,599dbb8e-d7aa-44aa-a989-553c8215f32e,posted,Netflix Subscription,-3786.11,87e7563d-27ff-4e11-bbe5-fc28524ee62e,1352.75,debit,bank-fee,AU00000,2024-02-10T04:40:49Z
transaction,e41eaa07-d881-4f02-91dd-108b97f28a0e,posted,Home Improvement Store Purchase,-1516.25,46f7f25e-e7a1-411d-938b-6c72375d7d88,-163.5,debit,payment,AU00000,2024-01-04T22:12:43Z
transaction,b3de1b68-f285-4a84-958f-61da0a852c5a,posted,TRANSFER TO JOANNA SMITH CAMPING,-644.0,4acf4faa-b127-451e-ac39-5fc9be76b440,-807.5,debit,cash-withdrawal,AU00000,2023-07-17T11:10:38Z
transaction,d70d54a3-6f51-4bf3-8e63-f70a3e85b15e,posted,TFR Acc14000 TO 12389,-2067.12,50d5d85a-6a2e-4d5a-8086-1800527bf29d,12730.15,debit,payment,AU00000,2024-01-07T13:06:37Z
transaction,1936342c-43ca-4859-99b8-b6693b71195c,posted,Electricity Bill Payment,-3248.11,275d234d-b13b-4a05-bec6-041a2149e485,9482.04,debit,cash-withdrawal,AU00000,2024-01-09T04:55:30Z
transaction,04ae09d2-47aa-4079-88e8-c5417a49119c,posted,Electricity Bill Payment,-4141.53,5672f2a3-53d6-4ebe-953d-f711dcd286ec,5340.51,debit,cash-withdrawal,AU00000,2023-07-02T15:15:17Z
transaction,14396f62-f005-4abc-8ca5-8862dbf7c960,posted,CTRLINK CARERS Ref: 998R6789201610974V,-2402.36,60b1c008-37cc-4bce-a637-ce0ece4e43ee,2938.15,debit,bank-fee,AU00000,2024-04-07T11:31:33Z
transaction,433e8fbb-c927-4931-b73d-5c5162a468aa,posted,Wdl ATM WESTPAC IGA BALGOWLAH BALGOWL AU,-4919.34,eff40edb-1ec3-4a27-9f17-48c7041044c6,-1981.19,debit,cash-withdrawal,AU00000,2024-01-04T01:27:49Z
transaction,51114259-2f1a-4199-8114-424a129b8753,posted,CTRLINK CARERS Ref: 998R6789201610974V,-4941.87,69af2e5a-ca84-4938-b166-089f9e5340be,-6923.06,debit,payment,AU00000,2023-10-26T22:13:11Z
transaction,69c830d2-0875-47ce-8ab9-71f93c4b6599,posted,Amazon Online Shopping,-4108.07,d3ed1a3c-c669-47e9-854f-722acb092d6d,-11031.13,debit,cash-withdrawal,AU00000,2024-01-19T16:15:50Z
transaction,a3441701-c73b-4d7c-952b-94164c290805,posted,Mobile Phone Bill Payment,-1218.68,bb35ed72-7115-4ebb-b65a-a80ad56ce7af,-12249.81,debit,payment,AU00000,2023-12-04T13:09:37Z
transaction,3b19e01a-f93a-4f93-9733-0a77cc6dd4a7,posted,Gasoline Purchase,-3900.74,e764aaea-3fcf-4467-866f-e2f96003cb4c,-16150.55,debit,payment,AU00000,2023-10-06T08:07:50Z
transaction,4b0f5f9c-8b75-4eaf-8fe4-850935721bc0,posted,Home Improvement Store Purchase,-890.01,fd670559-0cd2-48ff-b140-5f978a6e2c80,-17040.56,debit,bank-fee,AU00000,2023-09-13T08:46:37Z
transaction,b4ab8e34-8157-4bb5-b010-fbcb57ef09cf,posted,Public Transport Fare,-1693.26,4d3ac0a8-547f-49a3-b4fa-9c3476557759,14688.62,debit,payment,AU00000,2024-01-18T22:07:23Z
transaction,bd15580c-9603-4e56-8837-877d09971622,posted,Pharmacy Purchase,-3418.03,8eb85105-8308-47da-afc0-e2428a072ee2,11270.59,debit,bank-fee,AU00000,2024-04-27T08:43:07Z
transaction,9527e9a0-921a-4c00-98de-3365448ede9c,posted,Coffee Shop Purchase,-1212.98,01401d05-0a61-4a89-8061-1bf5f0cd654e,10057.61,debit,bank-fee,AU00000,2023-11-03T02:25:12Z
transaction,3c27ec27-fdd6-433b-9fb9-b26ee2b395fa,posted,AGL RETAIL ENERGY LTD (GAS),-250.48,8a51e30c-95b0-42da-9d97-db3a3b296101,9807.13,debit,payment,AU00000,2023-12-23T13:08:20Z
transaction,d659296c-f1c6-44cc-961a-0b849a2fec40,posted,TRANSFER TO JOANNA SMITH CAMPING,-3090.83,be8ee306-aa72-4a72-b99d-44c67cf704d5,6716.3,debit,payment,AU00000,2024-03-10T06:06:56Z
transaction,e7fbc171-19a1-4571-ba04-d3a9a645c9b8,posted,Hair Salon Appointment,-115.11,c1ea036f-9ae3-4f13-b2a7-9235a8945de9,6601.19,debit,payment,AU00000,2023-08-09T13:17:10Z
transaction,c2ed9dcf-2862-4fc7-8d92-520331babb68,posted,Electricity Bill Payment,-1134.18,442752ef-daa1-4cc3-b4a8-21f98bae3bae,5467.01,debit,cash-withdrawal,AU00000,2023-06-27T03:34:59Z
transaction,1adbdc5c-fe34-4dc5-bd2a-a22d7c1b4c1b,posted,CTRLINK CARERS Ref: 998R6789201610974V,-3132.95,aa5021f0-0d90-49d2-ad62-fce3079c800d,2334.06,debit,bank-fee,AU00000,2024-01-08T19:55:25Z
transaction,2509c506-c2a9-4dd4-9b16-2d02239b08be,posted,Gym Membership Fee,-2138.29,50fa3125-bf40-4641-9015-e6838536b9a3,195.77,debit,bank-fee,AU00000,2023-06-05T01:25:51Z
transaction,ca40bdb5-c278-4beb-981d-a5770e88190e,posted,Online Gaming Purchase,-4287.21,f23da0c6-f918-4365-8562-85a22e785f74,-4091.44,debit,bank-fee,AU00000,2024-03-27T10:00:21Z
transaction,af7a1501-7563-4d57-bfaa-9f3abc22f073,posted,Restaurant Dinner,-3325.58,3ac27919-a9f8-4d0c-97e0-28b45da5c89f,15336.41,debit,bank-fee,AU00000,2024-04-29T10:23:41Z
transaction,bc21b3ab-73bc-4e8f-b1be-55bf3fdfb5b2,posted,Mobile Phone Bill Payment,-3005.38,39906d20-6624-48d4-b5de-6aa27185fd1f,12331.03,debit,bank-fee,AU00000,2023-12-14T23:11:13Z
transaction,1ae15e9e-ea73-4e7e-8cba-dd24738f66de,posted,AGL RETAIL ENERGY LTD (GAS),-1329.88,0d85abb7-e345-46fc-aa17-fe2bd75cade4,11001.15,debit,payment,AU00000,2023-12-13T08:14:28Z
transaction,13aa5d67-6f15-46be-9a78-69b1e68a12b2,posted,Restaurant Dinner,-353.41,6d04d4a1-80d2-4fc2-8cd5-12c24addbdfb,10647.74,debit,bank-fee,AU00000,2024-01-17T08:38:24Z
transaction,50475851-7563-45ed-b4cb-483d735d5020,posted,Online Gaming Purchase,-4140.06,75bcfc1f-d134-45a2-b417-42e37c0622b9,6507.68,debit,cash-withdrawal,AU00000,2023-10-13T14:53:30Z
transaction,1c134241-1b26-4e58-a928-a968ebff40e1,posted,Car Maintenance Expense,-4257.26,4736c112-ddef-4e77-8208-4cc089c67d13,2250.42,debit,bank-fee,AU00000,2023-11-13T09:29:33Z
transaction,5d85e414-300b-4329-b186-35410abe2566,posted,Home Improvement Store Purchase,-3457.85,da39dc17-3daf-4da0-8dcd-a778c1bbd5a8,-1207.43,debit,cash-withdrawal,AU00000,2024-01-11T20:59:42Z
transaction,4c52f56c-0275-4d66-8884-8e6d12833a1b,posted,Mobile Phone Bill Payment,-789.8,3886555a-218d-4caa-9450-d4c63a92fd3e,-1997.23,debit,cash-withdrawal,AU00000,2023-08-20T20:47:59Z
transaction,21e6d34e-639a-4b36-bf0c-af66f955215a,posted,Wdl ATM WESTPAC IGA BALGOWLAH BALGOWL AU,-4341.67,18408ce2-1c46-4eea-907b-24689ce02451,-6338.9,debit,cash-withdrawal,AU00000,2023-10-29T17:16:01Z
transaction,f37cdaea-58f4-4feb-9271-137e5e81f4e6,posted,Restaurant Dinner,-2875.09,9d103f4d-ab27-44e9-a5b4-e1ff4337c003,-9213.99,debit,bank-fee,AU00000,2023-08-23T18:16:34Z
transaction,8d52c8ab-8dcc-4b9a-b5e9-d50ce52e6ba8,posted,Clothing Store Purchase,-1143.76,fefb0106-cfd4-4b52-beb8-9859869d7208,12613.68,debit,payment,AU00000,2024-01-15T18:32:34Z
transaction,be61ad3a-3d9a-410c-ad1a-184addb8237f,posted,Home Improvement Store Purchase,-3752.35,2b7a7953-9b10-4ccc-b1e9-8c6aaf614855,8861.33,debit,payment,AU00000,2023-08-28T15:52:51Z
transaction,7257657c-7755-41ac-8e53-d44a403e39ad,posted,Gasoline Purchase,-612.91,f5ede909-201e-4d7e-9e6d-e3b793de2caa,8248.42,debit,payment,AU00000,2023-06-29T05:20:21Z
transaction,c392b600-8941-4941-9625-5183949741cc,posted,Coffee Shop Purchase,-69.26,eb3a8eae-18df-4f31-a82d-8111b0259ef3,8179.16,debit,payment,AU00000,2023-07-01T00:01:54Z
transaction,b148abf0-fe60-426c-a336-db43d1a7e21f,posted,TRANSFER TO JOANNA SMITH CAMPING,-100.29,c463d37b-1f90-47d7-8646-275e9c782b04,8078.87,debit,bank-fee,AU00000,2024-01-11T18:05:09Z
transaction,c028b5f5-f24f-47d1-87b6-967389271a4f,posted,Wdl ATM WESTPAC IGA BALGOWLAH BALGOWL AU,-979.98,cb803bbe-30aa-40f1-9933-57975fa7ba79,7098.89,debit,bank-fee,AU00000,2023-06-21T22:50:53Z
transaction,48261b7f-aaf4-401f-904c-cbfa77c37b07,posted,Transfer Platnm Homeloan 346454,-12.5,c4e53059-1df3-4981-8373-9b3819a2e144,7086.39,debit,payment,AU00000,2023-07-30T03:08:12Z
transaction,42b6f516-f6d5-4ce7-8336-ccf05296c08a,posted,Netflix Subscription,-2790.46,8446ea95-355e-4041-bece-5a44ddb6c387,4295.93,debit,bank-fee,AU00000,2024-01-25T03:13:15Z
transaction,bdf7150f-77b0-43cc-ab9b-19c976b0246f,posted,Pharmacy Purchase,-2558.15,4cd8f36e-3204-45cc-8174-1e2724639150,1737.78,debit,payment,AU00000,2023-12-09T14:43:33Z
transaction,ca741916-1ba7-402d-aef3-c326c87501a2,posted,Public Transport Fare,-1911.53,3a88dbb7-6462-4c44-b554-4af35264acb0,-173.75,debit,bank-fee,AU00000,2024-04-01T06:12:54Z
transaction,f3d2c4f1-6d32-4b2a-8069-5c217af87800,posted,Mobile Phone Bill Payment,-3854.65,23cb9a87-5d94-46fd-9fea-0e1751e5afa5,10763.8,debit,payment,AU00000,2024-01-01T14:55:52Z
transaction,3bcfe5fc-b067-41c0-b681-66c4bffebd73,posted,Amazon Online Shopping,-1726.28,9419c376-2c63-46b6-b83e-eb1f20b0caf7,9037.52,debit,bank-fee,AU00000,2023-07-24T03:23:18Z
transaction,21b330c3-1d51-439c-9501-8a44b7b0bfca,posted,Movie Ticket Purchase,-3669.52,71a278a5-c4cf-449d-b698-c011abd5927e,5368.0,debit,cash-withdrawal,AU00000,2023-08-05T12:35:55Z
transaction,886f4a65-b04d-45e3-aef6-1c4a0a189aaa,posted,Online Gaming Purchase,-4700.23,7c73bf7b-59e1-4685-ab7a-95ec05cf1678,667.77,debit,payment,AU00000,2024-03-12T05:32:49Z
transaction,ecdceb4b-3f23-4b72-ad7e-78be5b9f33c8,posted,Music Streaming Subscription,-1833.65,8847fb56-a96c-4bea-a6bc-4f625c7339fc,-1165.88,debit,bank-fee,AU00000,2023-11-07T23:07:55Z
transaction,28b13b36-0e0e-47d9-bf17-116cf27a4cb4,posted,Restaurant Dinner,-4734.15,1ab4a681-8500-4615-9228-58ce36d34af9,-5900.03,debit,bank-fee,AU00000,2023-09-22T10:35:36Z
transaction,ebfd5b87-d8a8-42f7-bc23-27e6ccdc3430,posted,Movie Ticket Purchase,-1545.69,8c27d6f8-b4fd-49a5-b453-1e779d681239,-7445.72,debit,payment,AU00000,2024-01-19T18:58:26Z
transaction,1d5e1de8-8e1d-4853-a091-9061c408704f,posted,Coffee Shop Purchase,-1525.1,650babf4-c822-4973-bea3-e16778b39b48,-8970.82,debit,payment,AU00000,2024-04-06T15:03:11Z
transaction,92a539ee-a221-4d7f-b08c-b88fa0d88c2a,posted,Online Gaming Purchase,-3038.97,6ff7cfbd-a873-4202-9183-25a72ea80ff3,-12009.79,debit,payment,AU00000,2023-05-15T12:35:10Z
transaction,4632ef1c-67b2-49c2-a1ff-b1d3c75d7886,posted,Bookstore Purchase,-4610.64,d7967a38-d183-4a8d-be3d-dc4889e208c1,-16620.43,debit,payment,AU00000,2023-09-04T16:18:46Z
transaction,7cbf3a3b-a2e5-4db3-995b-4c83ebe0d5eb,posted,Coffee Shop Purchase,-88.17,2d1ea6b3-9190-406e-9223-959b41fa4966,7600.33,debit,cash-withdrawal,AU00000,2024-05-09T10:44:11Z
transaction,edba9cec-2dfb-4e8c-ae5d-7d860fefa84d,posted,Clothing Store Purchase,-1357.61,589a3a1c-d472-4b83-8f2e-2e9a27cd17c6,6242.72,debit,bank-fee,AU00000,2023-10-21T14:53:36Z
transaction,e9b5e62f-946c-45ac-ab9c-5ae6fea63475,posted,Mobile Phone Bill Payment,-2439.85,695a13a6-b04b-4b9a-ac93-de12a4de6a8f,3802.87,debit,cash-withdrawal,AU00000,2023-07-25T10:37:06Z
transaction,fd5d4bc7-f758-42d4-bbd8-427fb6dc9754,posted,Music Streaming Subscription,-3981.58,d576a1f3-75aa-4cf9-b7d5-b9df7ee83b50,-178.71,debit,cash-withdrawal,AU00000,2024-03-29T23:21:13Z
transaction,582a67b1-a2d1-4a09-8a64-4f4f713baeea,posted,Travel Agency Booking,-3633.52,a98cfacf-fd1b-4fa7-ae1e-f4350898cb8a,-3812.23,debit,payment,AU00000,2024-04-13T11:12:58Z
transaction,a56a71a8-f5fd-4171-9e77-6b395015fa86,posted,Online Gaming Purchase,-4138.4,9ab9158c-953f-4690-b5c9-085dfe0ff5a3,-7950.63,debit,payment,AU00000,2023-11-24T00:52:40Z
transaction,39271d23-5bd0-404c-85e0-06296df7f767,posted,Transfer Platnm Homeloan 346454,-2064.96,f02ef705-e135-421b-bc88-5e97f94ea7c6,-10015.59,debit,bank-fee,AU00000,2024-01-05T17:12:27Z
transaction,8859aefe-e13b-454b-b32b-3009ddd7e3c5,posted,Music Streaming Subscription,-2240.15,1e789dac-16cd-4d4e-8314-461ecbd0bae2,-12255.74,debit,payment,AU00000,2023-06-21T09:44:09Z
transaction,20c2c50c-00f3-4e9d-a989-f4f07d4e8aa4,posted,Manly Maths Tutor Wages,-1800.01,17266a04-ce85-4883-aa51-c9b45d172d6b,-14055.75,debit,bank-fee,AU00000,2023-05-13T20:36:52Z
transaction,f21934dc-04f7-4645-a9e1-44621c89adaf,posted,Coffee Shop Purchase,-824.64,c324443e-280f-40cb-8c1f-4ba3915703d3,-14880.39,debit,payment,AU00000,2023-11-21T18:55:04Z
transaction,e6dfb808-4554-480c-aa0c-d2ba687d2318,posted,AGL RETAIL ENERGY LTD (GAS),-3516.67,8b2db0c7-6376-454c-a8ab-eb41a0fabe1e,8062.85,debit,cash-withdrawal,AU00000,2023-10-04T00:20:04Z
transaction,ac68aa8e-72e2-4655-a0fa-73d9edb7decc,posted,CTRLINK CARERS Ref: 998R6789201610974V,-4782.74,32197974-d38c-4cd2-9589-3712a36bfa61,3280.11,debit,cash-withdrawal,AU00000,2024-01-06T21:29:02Z
transaction,f5ad7063-9637-4d0b-8978-7a83447c655b,posted,AGL RETAIL ENERGY LTD (GAS),-2582.12,f4fb8cbc-9171-46b1-a087-53a86dc18ffc,697.99,debit,payment,AU00000,2024-02-29T16:22:58Z
transaction,03864e9a-4631-4573-b1b6-75c68e9c3507,posted,Coffee Shop Purchase,-3358.7,5b6f27c9-0114-45df-bc32-a9bf37625f2f,-2660.71,debit,cash-withdrawal,AU00000,2023-06-06T17:45:49Z
transaction,ddf3e40d-6224-4c8b-aecb-020c05c57734,posted,Car Maintenance Expense,-3049.06,4499f51a-16cc-4809-a5a0-bb115c118a59,-5709.77,debit,bank-fee,AU00000,2024-03-10T14:08:31Z
transaction,207222dc-0464-409c-bfc3-c72c2c5dc2a8,posted,Payroll WFRMS 15439393,10817.07,91dda47f-b5ee-4c89-9990-5a13eb44ff14,5107.3,credit,transfer,AU00000,2024-03-13T15:59:45Z
transaction,3448ae68-ba81-4684-ae02-229812be3807,posted,Payroll WFRMS 15439393,11504.15,7890108c-af8e-4743-8b83-146ad199c25e,16611.45,credit,transfer,AU00000,2023-06-26T12:24:49Z
transaction,2fc5e8de-9f7f-4acd-a37b-04e92e9d9f01,posted,Travel Agency Booking,-2867.96,010207fc-710b-4bac-b1ab-c5062169d4ae,13743.49,debit,bank-fee,AU00000,2024-04-22T07:19:51Z
transaction,2835480a-5352-4329-9378-7cf7f75d77e3,posted,Gym Membership Fee,-1840.18,2d8faa24-e21f-45a2-b5af-3c1efa8d6fbf,11903.31,debit,bank-fee,AU00000,2023-11-18T05:06:44Z
transaction,0979ab9f-297d-4a34-ab6b-4c3eaa5665ae,posted,Netflix Subscription,-2454.29,2af185b4-286a-4779-8ac1-203cd2b82cfd,9449.02,debit,bank-fee,AU00000,2023-10-25T08:22:08Z
transaction,68646950-b79e-4525-8579-beb1324ba3de,posted,Public Transport Fare,-323.25,24f1f62d-5876-4b64-9136-b75571e1cf9e,5904.72,debit,payment,AU00000,2023-08-03T16:14:37Z
transaction,6978fc5c-2dac-4749-aabd-2b1ad99835b6,posted,Gym Membership Fee,-2814.99,5cc005d5-54b5-4a3d-be78-2b447b452aa0,3089.73,debit,bank-fee,AU00000,2024-05-01T13:36:59Z
transaction,1d152063-bc56-4d24-82d9-5dec217baf61,posted,Wdl ATM WESTPAC IGA BALGOWLAH BALGOWL AU,-3298.87,a873490c-3e8c-40d3-8f2c-da22b194e113,-209.14,debit,bank-fee,AU00000,2024-01-09T11:06:42Z
transaction,17192973-ecba-4238-ade7-6b502728673d,posted,TFR Acc14000 TO 12389,-1212.35,4f14f4ff-0efc-4f69-a68a-7b3df23b234b,-1421.49,debit,bank-fee,AU00000,2023-05-19T22:55:40Z
transaction,d0345b39-3158-40d0-b973-1622932463d9,posted,Electricity Bill Payment,-2377.33,0f7f2afe-8874-4bf3-914c-0057b0105ca4,-3798.82,debit,bank-fee,AU00000,2023-10-31T14:06:19Z
transaction,bc8b364f-d2fa-491f-b82f-26eb934020e4,posted,Clothing Store Purchase,-372.04,e65454cb-b733-4b3a-89f9-457898bcd0eb,-4170.86,debit,bank-fee,AU00000,2024-03-10T07:25:01Z
transaction,6155c231-40f1-4e1a-bdca-cb54a66d8ac7,posted,Coffee Shop Purchase,-4487.67,80f143b8-16b4-4289-aa56-d2fe5faa0322,-8658.53,debit,cash-withdrawal,AU00000,2023-07-15T19:17:15Z
transaction,1719fc46-8130-439b-ad36-30fc2edb6627,posted,Coffee Shop Purchase,-780.12,b04730ae-6964-42db-82b0-94c76637384d,-9438.65,debit,bank-fee,AU00000,2023-11-28T21:10:13Z
transaction,74b263e6-6a8c-4c7b-ab61-151646525962,posted,AGL RETAIL ENERGY LTD (GAS),-4665.89,c875baf8-7a82-4ff5-a88e-3ed7e55039c7,-14104.54,debit,cash-withdrawal,AU00000,2023-09-02T20:42:32Z
transaction,21715026-857f-426c-aea5-4187acc79acd,posted,Travel Agency Booking,-1809.15,dcdcec51-4543-43f6-b12a-cbbc605c7ad2,-15913.69,debit,cash-withdrawal,AU00000,2023-12-26T12:11:27Z
transaction,1c768bee-ac21-45b2-bd4b-d4aaae1d87ff,posted,Pharmacy Purchase,-38.97,9fc7b936-34d7-42c1-886a-3055b72036c9,14300.47,debit,payment,AU00000,2023-08-10T15:25:29Z
transaction,32c3eb19-d97d-4969-8c8a-eca71dbb5a84,posted,Transfer Platnm Homeloan 346454,-525.67,fc822ec2-1ed3-4634-9399-693faada5858,13774.8,debit,cash-withdrawal,AU00000,2023-06-07T18:52:58Z
transaction,8ceab5ce-5b57-4bc4-952a-c3d9f0548e0b,posted,CTRLINK CARERS Ref: 998R6789201610974V,-2432.3,43d71599-ecd5-4ced-993e-2feb652e1546,11342.5,debit,payment,AU00000,2023-10-18T14:39:36Z
transaction,30963167-6856-4daf-99f8-f7878751f4e4,posted,Public Transport Fare,-4656.44,f7f8eb9e-651b-4bb3-bfb2-2e6be9d7d4ff,6686.06,debit,bank-fee,AU00000,2024-03-26T23:12:26Z
transaction,79958210-0918-4210-aea5-5412875dd436,posted,Manly Maths Tutor Wages,-667.58,ae6c06fc-7b2f-4902-afca-5e7070523576,6018.48,debit,payment,AU00000,2024-03-17T23:10:34Z
transaction,e4e61b64-68c8-45b5-86fa-309082d1fae3,posted,Electricity Bill Payment,-241.87,040124e5-06a4-4558-8d22-7f3be9b0f716,5776.61,debit,bank-fee,AU00000,2024-04-16T05:15:16Z
transaction,dffd2b4e-95e2-4fa6-8a0b-96b690e3c18a,posted,Public Transport Fare,-2917.07,ee5be371-2d95-45a8-98ec-1370a76826a7,2859.54,debit,cash-withdrawal,AU00000,2024-01-20T17:15:58Z
transaction,7c8f5001-3c55-47ac-a2f3-828096511294,posted,Hair Salon Appointment,-4096.84,cc26f29b-14c2-4156-8c95-86b8db6e2cd9,-1237.3,debit,cash-withdrawal,AU00000,2023-12-27T14:24:37Z
transaction,c3b78b34-ce1c-4b75-af22-e83f47fea83c,posted,Payroll WFRMS 15439393,11418.43,46f3f2c1-72fa-44dc-a092-7a442c9ce67b,10181.13,credit,transfer,AU00000,2023-07-30T11:34:16Z
transaction,8cf4e900-16db-47ee-a472-a933db4c6f0e,posted,Mobile Phone Bill Payment,-1008.85,d1981ad6-b6d5-4f05-b636-50107f9801a6,9172.28,debit,bank-fee,AU00000,2024-04-16T15:15:32Z
transaction,53931d5e-413a-489f-bafc-e9f89a196ffd,posted,Netflix Subscription,-1185.96,6ae5e55e-c6c6-45d4-9846-a9c19cb53f09,12042.01,debit,payment,AU00000,2023-10-13T04:43:12Z
transaction,1edaa65a-b9a4-4269-950d-a1b9691ba285,posted,Movie Ticket Purchase,-3741.05,303cdd1c-af66-4cd6-ac6b-c159d087011d,8300.96,debit,cash-withdrawal,AU00000,2024-01-18T10:34:39Z
transaction,7be052b8-d051-4d44-8be0-5b46aff06daf,posted,Online Gaming Purchase,-1785.98,d2104614-8864-4329-8e66-089228f14f34,6514.98,debit,payment,AU00000,2023-09-08T20:31:08Z
transaction,129c6c89-aebf-476f-be88-45c9fc4c67e8,posted,Non Hooli ATM Withdrawal Fee,-4712.5,51a4a8d1-0f8a-440b-b987-686972e03e0b,1802.48,debit,payment,AU00000,2023-12-02T04:07:06Z
transaction,6b9303f4-c31b-4f4d-81b1-dadb2ac91403,posted,Hair Salon Appointment,-1072.96,e091295f-d843-44b6-8ad0-e1f5e5393e42,729.52,debit,cash-withdrawal,AU00000,2023-10-03T19:31:10Z
transaction,b38574f3-3eb5-4856-857e-b6db23af4228,posted,Home Improvement Store Purchase,-2586.27,549eadf8-14b6-4025-8f3a-e6d100666ce0,-1856.75,debit,cash-withdrawal,AU00000,2023-12-09T05:00:48Z
transaction,c4e94c6e-91a1-4964-b49c-b5ba5918727c,posted,Bookstore Purchase,-1128.99,be76fd95-6196-4bab-8ae7-9459a9aadec2,-2985.74,debit,payment,AU00000,2023-12-05T13:19:56Z
transaction,30a59eb8-940d-4afc-a822-a629aff91a35,posted,Payroll WFRMS 15439393,10801.84,481a6f4b-59e7-4f90-b927-442f865eb783,7816.1,credit,transfer,AU00000,2023-05-22T10:02:35Z
transaction,fa094888-0f3a-4ee2-bc17-6938bd85caf5,posted,Gasoline Purchase,-3778.74,7458e435-0fd9-4d58-995c-277b71995c38,4037.36,debit,cash-withdrawal,AU00000,2023-10-26T01:10:23Z
transaction,0e901866-1189-4e56-87e9-8cf36d71f835,posted,AGL RETAIL ENERGY LTD (GAS),-2917.24,67a48ff1-0db7-4884-b49b-5c34188895fc,1120.12,debit,payment,AU00000,2023-10-29T20:39:12Z
transaction,24ca6217-44e7-401a-ae9e-a2b0150b80d7,posted,Bookstore Purchase,-400.55,6b6268bd-9853-482f-b7a4-3c1574ab2d99,17901.94,debit,payment,AU00000,2023-06-11T07:48:35Z
transaction,ba2af8df-9660-4d79-be03-1a546661ddc0,posted,Public Transport Fare,-4678.51,2849b146-f597-4881-ac7a-1669cb8256ce,13223.43,debit,payment,AU00000,2023-09-26T11:01:24Z
transaction,053b2c52-1b00-45fb-9c25-c6358e22edd6,posted,Electricity Bill Payment,-3057.38,4a98e91d-9f1a-471d-8db6-23517aa27b3c,10166.05,debit,payment,AU00000,2024-01-05T10:03:16Z
transaction,57662104-ec1d-4907-b663-6510dacca41d,posted,Gym Membership Fee,-4075.81,81dafdbe-d3c6-4534-8f74-ed12dcdc3351,6090.24,debit,bank-fee,AU00000,2024-05-03T22:19:16Z
transaction,201416c8-2a3e-4c55-b6f9-2284dc3ae774,posted,Manly Maths Tutor Wages,-3807.1,9f4e6383-4141-45c4-9880-250b1f7553a0,2283.14,debit,cash-withdrawal,AU00000,2024-01-23T19:55:55Z
transaction,39045e54-bda2-4aca-ae78-909b2468f44e,posted,Non Hooli ATM Withdrawal Fee,-3571.85,0fdf1a32-47ed-4a54-882c-9ac088a647fd,-1288.71,debit,cash-withdrawal,AU00000,2024-01-01T03:11:19Z
transaction,d41ca893-7b2e-4ce8-a495-96ef87403359,posted,Public Transport Fare,-4138.35,7395c25a-7d10-4b03-9528-f41e8863601b,-5427.06,debit,cash-withdrawal,AU00000,2023-11-02T00:37:52Z
transaction,a2d649c4-0161-49b3-9fdf-1580be3a05b5,posted,Movie Ticket Purchase,-267.29,295a6c4e-06aa-4f78-92ab-1c14d9c46c97,-5694.35,debit,cash-withdrawal,AU00000,2023-10-14T16:15:37Z
transaction,e6d898b8-57cb-4975-aa61-52f5adf56eb5,posted,Home Improvement Store Purchase,-3495.02,fbcfaa24-9cc0-4982-8114-b04ba8e681fd,-9189.37,debit,payment,AU00000,2023-10-21T05:29:09Z
transaction,3751cd9d-6e0b-4e27-b7cd-ba5351cf7eaf,posted,AGL RETAIL ENERGY LTD (GAS),-2339.95,ad552530-f7dc-468e-9686-fbca1784a666,-11529.32,debit,cash-withdrawal,AU00000,2023-08-19T20:37:53Z
transaction,957f697d-abef-4ac8-8ddc-2f22ec356f0b,posted,Restaurant Dinner,-3941.7,c257f0f6-b35f-45a6-b123-2d85fa1b9e46,4298.17,debit,bank-fee,AU00000,2023-12-09T21:55:38Z
transaction,bc56cfd0-aa4d-45d1-a293-54c207914b1f,posted,Car Maintenance Expense,-3703.2,4c46f6d1-aace-4745-8394-c87a36448923,594.97,debit,cash-withdrawal,AU00000,2024-04-14T10:54:01Z
transaction,0657ea02-5e04-4049-ba43-4b03caf55f76,posted,Bookstore Purchase,-2802.58,f63d5605-1311-4163-aaa8-98c39b7fd753,-2207.61,debit,bank-fee,AU00000,2023-08-14T10:04:09Z
transaction,9f2aa2cd-e4d7-4c89-a3a2-a0b9957055b9,posted,Gasoline Purchase,-1663.68,54208356-6c6a-4f66-8fd5-07883d0ff3e3,-3871.29,debit,payment,AU00000,2024-01-20T14:17:55Z
transaction,1972289f-6c66-4f17-8b66-ad977b3655eb,posted,CTRLINK CARERS Ref: 998R6789201610974V,-4853.77,1b448f56-8d71-4f57-bb95-eca2953c6bc8,-8725.06,debit,cash-withdrawal,AU00000,2024-03-11T22:53:12Z
transaction,c5b4b8ed-2e08-45a7-b06b-880d75df08dc,posted,Uber Ride,-1112.2,3bbb0465-8cd7-4da5-84b4-58d3c1c93de6,-9837.26,debit,bank-fee,AU00000,2023-07-27T02:06:25Z
transaction,0bead5bb-88f9-406c-b8f6-06283508a889,posted,Amazon Online Shopping,-3669.09,4187fd9b-c544-45aa-836b-d5177c5326c4,-13506.35,debit,bank-fee,AU00000,2023-06-14T23:31:11Z
transaction,eebdbb96-f20c-428c-bac1-cc1298b2b04d,posted,Restaurant Dinner,-4977.85,39f2ef02-a526-42d9-906e-f55fea68a08c,-18484.2,debit,cash-withdrawal,AU00000,2023-09-08T12:00:05Z
transaction,7142fbf9-dd11-4982-892d-dec6644a097c,posted,Clothing Store Purchase,-2552.79,6cdbbd22-f767-4bf1-ba2b-73c28fbb507c,-21036.99,debit,bank-fee,AU00000,2023-08-29T13:13:27Z
transaction,5839a294-9d20-481d-ab1f-1321a03e1d35,posted,Manly Maths Tutor Wages,-4030.17,07c4a553-23ed-4129-8842-62d253ef3500,-25067.16,debit,bank-fee,AU00000,2023-06-19T10:05:04Z
transaction,18f7b7a9-5fd6-434e-96b7-edccc2fd2259,posted,Non Hooli ATM Withdrawal Fee,-3249.5,e33d13f0-2c56-41d0-b0fb-601e82a772f1,3680.82,debit,payment,AU00000,2024-04-28T04:55:35Z
transaction,12fe9156-e6b4-4e96-86aa-b6230916d830,posted,Car Maintenance Expense,-2972.82,f6e760ad-a178-49cb-8b81-ea4c5fbbcac4,708.0,debit,bank-fee,AU00000,2024-02-15T16:55:50Z
transaction,88f40519-c63d-4739-b4f8-8bdb8c63021c,posted,AGL RETAIL ENERGY LTD (GAS),-609.42,b4420b5e-fc7a-4f1c-bbb0-50d11814a6b2,98.58,debit,cash-withdrawal,AU00000,2023-06-12T09:07:04Z
transaction,f37fed6a-3277-43e3-b375-d9552017463d,posted,Car Maintenance Expense,-148.52,d8d12112-399e-45f4-9d3c-19177497dd66,-49.94,debit,cash-withdrawal,AU00000,2024-03-16T03:27:20Z
transaction,bac6eb82-b6b2-40c5-a6f4-2f115dab4da6,posted,Public Transport Fare,-2900.47,e1b9705b-e31f-425f-a4f0-d67f3579f718,-2950.41,debit,cash-withdrawal,AU00000,2023-07-13T13:27:54Z
transaction,a8fb351a-dc38-4ea8-beab-acbb3dc07987,posted,Public Transport Fare,-2295.63,8c471837-4b24-4145-b570-cfd2d5d697f1,-5246.04,debit,bank-fee,AU00000,2023-11-21T06:14:38Z
transaction,fbbe4e98-3823-45f8-9f69-680f9584e1d8,posted,AGL RETAIL ENERGY LTD (GAS),-3040.93,04a72392-dfc1-4302-9e2a-a0dd4d4ed4d4,-8286.97,debit,bank-fee,AU00000,2023-06-05T02:49:39Z
transaction,40739f7b-3197-4f48-ac12-ab834ee60347,posted,CTRLINK CARERS Ref: 998R6789201610974V,-3053.29,eaf6d68c-5d9b-4442-88cc-58697c2a75c7,-11340.26,debit,bank-fee,AU00000,2024-02-22T09:27:24Z
transaction,187bd0f3-9bc3-426b-9b51-9b1ea71c7ed8,posted,Gym Membership Fee,-846.22,d30deb6e-dd71-4a54-b80d-2e1956ded51a,-12186.48,debit,cash-withdrawal,AU00000,2023-09-07T00:08:05Z
transaction,1fadbac5-785e-45c3-9229-76dee2b74d00,posted,Car Maintenance Expense,-1671.11,e384a5d1-b9d6-4f07-8277-e13a33cefe55,-13857.59,debit,payment,AU00000,2024-03-06T07:34:46Z
transaction,58d9b3e2-1cc8-47b0-8c21-4d7447fa742a,posted,Electricity Bill Payment,-361.28,693f65f4-c471-40cc-a68c-2b62de97fd83,10779.12,debit,bank-fee,AU00000,2023-11-04T02:58:30Z
transaction,d9df5302-bd73-4c85-9d07-fc8fb90720c9,posted,TRANSFER TO JOANNA SMITH CAMPING,-1930.62,1e220ac8-a589-4bfc-8289-c6918bde3eba,8848.5,debit,payment,AU00000,2024-03-09T14:57:16Z
transaction,cc7ab3b8-4927-478b-8f15-010c477a9792,posted,Restaurant Dinner,-1062.35,789471ff-7da1-4ca7-814e-b55d651be124,7786.15,debit,bank-fee,AU00000,2024-05-03T03:00:36Z
transaction,93630d7a-504c-4001-8c09-d6770be29e30,posted,Wdl ATM WESTPAC IGA BALGOWLAH BALGOWL AU,-2155.81,b642cb35-23bf-4f13-b389-918edcd69d1b,5630.34,debit,cash-withdrawal,AU00000,2023-09-30T13:16:18Z
transaction,b6c0f350-faf5-4ac0-a4b7-70dc349070bf,posted,Amazon Online Shopping,-3588.15,7b4bd53f-8369-4b08-bf6d-39358ad1fa2f,2042.19,debit,payment,AU00000,2023-05-26T00:51:39Z
transaction,29aab26c-d881-4fc3-87ed-1274198e9597,posted,AGL RETAIL ENERGY LTD (GAS),-2661.32,167f5540-8fa1-4659-b392-ae0879d31d35,-619.13,debit,payment,AU00000,2024-01-11T06:59:38Z
transaction,3dec2ddf-b6eb-4088-a6b6-40a2da62d464,posted,Wdl ATM WESTPAC IGA BALGOWLAH BALGOWL AU,-1690.63,463634cf-df22-4eab-aa53-f1776a5ec4a2,-2309.76,debit,bank-fee,AU00000,2023-11-19T10:48:18Z
transaction,4a5c4aa8-4fb9-44e5-aaed-eca044fd1c3b,posted,TRANSFER TO JOANNA SMITH CAMPING,-548.02,7e799b13-23c1-486a-898c-46bb9df8f0b3,-2857.78,debit,payment,AU00000,2023-05-13T17:03:27Z
transaction,5ff5b494-3f97-4fc0-953f-5f62a9ff5059,posted,CTRLINK CARERS Ref: 998R6789201610974V,-2545.72,de56d22d-71ff-4fd3-9640-eec37920d216,-5403.5,debit,bank-fee,AU00000,2023-11-30T00:52:35Z
transaction,f4326b66-9d46-4831-baec-6413de5e23f6,posted,Gasoline Purchase,-3160.2,3eec10eb-7e0d-42d7-a05b-d576dc3d4d2d,-8563.7,debit,payment,AU00000,2024-02-11T22:13:19Z
transaction,5707f610-99ae-489d-a6c5-345e72d8c96b,posted,AGL RETAIL ENERGY LTD (GAS),-771.14,5eea8b83-ae4a-41f8-905f-2bee18c78bae,7396.16,debit,bank-fee,AU00000,2023-12-24T23:36:32Z
transaction,6c252691-46ac-48dc-aa49-3edf7087666d,posted,Online Gaming Purchase,-2968.24,524d17c3-a48d-47b4-ae52-149a0a49968c,4427.92,debit,cash-withdrawal,AU00000,2023-08-04T16:00:31Z
transaction,efc03da0-43e8-459d-928b-7da6f2822a65,posted,Manly Maths Tutor Wages,-1651.03,0b9f87a8-62cb-4c40-939b-fce6d85c3936,2776.89,debit,bank-fee,AU00000,2023-08-11T15:09:45Z
transaction,68d4cdfb-cc30-44a7-8369-4e53cb4d03cf,posted,Electricity Bill Payment,-328.03,2b1923d0-ba81-441a-a3b8-21aebc4ea5a4,2448.86,debit,cash-withdrawal,AU00000,2024-02-10T13:07:21Z
transaction,5f19652b-8931-4045-863e-6250e01ef47e,posted,Music Streaming Subscription,-671.59,51b6e443-8971-4f82-8a93-084e3494d6a7,1777.27,debit,cash-withdrawal,AU00000,2024-02-26T03:34:44Z
transaction,56c46eb1-c523-4429-a500-f514cddf3e3a,posted,Gasoline Purchase,-3983.68,ab5d6aa9-6129-43b7-a9c5-dca8e4b9303d,-2206.41,debit,cash-withdrawal,AU00000,2023-10-19T00:59:14Z
transaction,23778ba5-c95e-4602-873a-806a986257b7,posted,AGL RETAIL ENERGY LTD (GAS),-4220.09,204b96b7-0d22-4a7e-87c4-3a0650fe3fde,-6426.5,debit,bank-fee,AU00000,2024-04-27T23:01:52Z
transaction,7edeebaa-0976-43a8-ba71-5345a51bee41,posted,Coffee Shop Purchase,-4089.99,121db477-6881-49c1-b843-2c9428123e29,-10516.49,debit,payment,AU00000,2023-05-26T13:15:18Z
transaction,f5e82234-bfa6-4a82-ac1d-6b5fd6ea4505,posted,Car Maintenance Expense,-764.22,07e4c213-57cf-4791-a055-f318c7a9b4b9,-11280.71,debit,payment,AU00000,2023-07-17T16:43:02Z
transaction,19343c5b-14f7-4bd7-a28c-05b580cdbd92,posted,Music Streaming Subscription,-1450.19,94cfc921-4957-48bd-945a-fea536916438,-12730.9,debit,cash-withdrawal,AU00000,2024-03-16T15:31:46Z
transaction,e60e05c1-0da1-4620-8750-a63c89ce1943,posted,Payroll WFRMS 15439393,10690.03,08708a3d-01f2-4866-9462-c0e983894108,18020.99,credit,transfer,AU00000,2023-09-01T09:22:35Z
transaction,3947fe5c-9e78-4c06-b35d-1b29f1434df6,posted,Amazon Online Shopping,-2490.77,deb32624-933a-4acd-89dc-3d4aafe48dae,15530.22,debit,payment,AU00000,2024-03-15T08:14:26Z
transaction,1b41be2e-9a4e-41c8-b1fa-400bab003f85,posted,Uber Ride,-320.24,3e433a07-3424-4dc5-b0f5-6abf93e4a8b2,15209.98,debit,payment,AU00000,2024-04-02T16:47:18Z
transaction,89102cdd-15b9-489d-b6b9-3e051abbc879,posted,Restaurant Dinner,-834.71,8b383d94-9838-4505-8c7f-95edcd7599eb,14375.27,debit,payment,AU00000,2024-01-05T02:21:22Z
transaction,5b700ac4-3ea3-4a41-be35-e032decafa00,posted,Hair Salon Appointment,-3920.42,f44d799a-7f99-40a8-ac9b-1545506e1395,10454.85,debit,payment,AU00000,2024-01-31T03:07:56Z
transaction,d5bb6a44-eb97-495a-a4ca-fbd54b50b760,posted,Netflix Subscription,-2498.38,e406a717-e3a9-4867-a7bf-ef7e46c82a69,7956.47,debit,payment,AU00000,2023-12-05T00:03:59Z
transaction,84d8d4f2-1b45-44a8-9d54-8b622b1b2d6a,posted,Car Maintenance Expense,-721.09,aa44034d-52b4-485d-8eea-fdc0250d75c8,7235.38,debit,bank-fee,AU00000,2023-11-21T20:30:09Z
transaction,2d52507d-7548-4263-858f-6f031226ce52,posted,Amazon Online Shopping,-4435.76,65db463d-dd0b-409e-88a3-7f9836c93b29,2799.62,debit,cash-withdrawal,AU00000,2024-04-02T08:45:21Z
transaction,a21f76b1-a8da-409a-a7db-71d83b9eb4fc,posted,Electricity Bill Payment,-4026.67,1935d802-c79b-4c6c-a661-206fbca5c450,-1227.05,debit,bank-fee,AU00000,2023-10-17T18:48:48Z
transaction,bd8b1bde-76e6-4430-bd47-56252cb8a346,posted,TRANSFER TO JOANNA SMITH CAMPING,-1947.66,ebda8579-aab7-4dcc-97fd-1306fbc36fde,-3174.71,debit,cash-withdrawal,AU00000,2023-10-27T05:05:04Z
transaction,917f8faf-e5e9-4dae-80ba-a359ae945123,posted,Home Improvement Store Purchase,-4970.8,94618212-97f2-4437-b7b0-98bbc5d11aac,9393.24,debit,cash-withdrawal,AU00000,2023-11-25T09:47:54Z
transaction,766beb7b-391e-4693-994b-eae2d485a0d2,posted,Music Streaming Subscription,-4461.56,b4503fb5-d58a-45d0-9c63-1d0a4d32ae8f,4931.68,debit,payment,AU00000,2024-01-30T09:43:39Z
transaction,d5efdb48-621f-4cfa-8c4e-50333fecd544,posted,Movie Ticket Purchase,-1764.0,50ca3642-6e05-4c82-a058-04f95a11877a,3167.68,debit,payment,AU00000,2024-04-23T07:29:14Z
transaction,b1978751-2a9c-4817-890d-26c23b064606,posted,Non Hooli ATM Withdrawal Fee,-3554.94,86b47635-de38-43c8-9c5c-6f3648681f5d,-387.26,debit,bank-fee,AU00000,2023-11-28T07:22:38Z
transaction,62d541b0-b413-46f9-a3a7-1aa77e8151c0,posted,Travel Agency Booking,-1948.66,3a41e8af-187a-4888-8044-06989238c68e,-2335.92,debit,cash-withdrawal,AU00000,2023-06-24T03:30:47Z
transaction,d37d737e-efa7-4be0-9282-d684a406a4d3,posted,Online Gaming Purchase,-3221.49,d588b28c-7260-4a27-bcd2-e426cf528406,-5557.41,debit,payment,AU00000,2023-09-17T23:59:05Z
transaction,89d07d4d-41ee-4d3d-bf25-c3dbbc69e99d,posted,Public Transport Fare,-813.36,8edfccbe-2a47-4e0f-897b-1a53a04b27cb,-6370.77,debit,cash-withdrawal,AU00000,2023-11-06T19:28:16Z
transaction,a41e6d6b-3a53-4a48-8b93-27c05df6776b,posted,Netflix Subscription,-4209.42,011bd540-941d-4898-a190-0687b278b66f,-10580.19,debit,payment,AU00000,2024-03-26T16:12:06Z
transaction,801c39ce-e639-4b38-aa8b-10fcdb700203,posted,Netflix Subscription,-4395.97,c30050c2-6834-440e-afb4-0f1c546c589c,-14976.16,debit,bank-fee,AU00000,2024-03-09T20:10:41Z
transaction,82793100-c091-48d5-b1ed-55205a02cf98,posted,Public Transport Fare,-4602.75,b39bc71f-094a-4462-a8e4-c956f3c9710f,-19578.91,debit,cash-withdrawal,AU00000,2023-11-11T14:36:04Z
transaction,4ca91f48-f78d-469b-8b29-848acd5460a1,posted,TRANSFER TO JOANNA SMITH CAMPING,-4295.34,9620809e-15cf-48a9-8202-f18041d25330,3236.63,debit,cash-withdrawal,AU00000,2023-08-02T02:08:21Z
transaction,7fd4787e-1db5-4b96-a7b4-36dcd8660911,posted,Movie Ticket Purchase,-301.99,b43346f8-30b3-4546-bddb-a6a67456abe5,2934.64,debit,cash-withdrawal,AU00000,2024-04-02T14:08:25Z
transaction,a27bd6d2-6b81-4c06-b3f8-6a45b9c0b046,posted,Gasoline Purchase,-747.78,ab27b9e6-5efc-419f-9ebb-9cd917bd8430,2186.86,debit,bank-fee,AU00000,2024-01-14T23:51:00Z
transaction,8400a5b5-f9e2-43fd-837e-1b8eecb49dce,posted,Mobile Phone Bill Payment,-3513.0,4a6aad09-bd29-48a1-a300-4ee9a2e18300,-1326.14,debit,payment,AU00000,2024-03-07T18:16:57Z
transaction,ec9370a7-8803-49db-a977-8afbbd8155a1,posted,Public Transport Fare,-4922.29,1cccaa9f-5910-4a25-a4e9-fbe676957acb,-6248.43,debit,bank-fee,AU00000,2023-07-22T09:47:06Z
transaction,3fbdec6c-a654-4b83-8697-51e5257e4f3a,posted,Pharmacy Purchase,-4004.23,12cb561c-a5be-4ef1-9236-43353eef19c7,-10252.66,debit,payment,AU00000,2023-05-23T17:15:15Z
transaction,e340003a-7b6d-4785-b321-f854b0c3bcf0,posted,Manly Maths Tutor Wages,-1874.2,74d0493c-e88d-412f-932c-24348d83b55d,-12126.86,debit,bank-fee,AU00000,2023-09-07T12:38:10Z
transaction,34f6b4f7-b9c9-4d67-af27-8b51eb5eb4a9,posted,Non Hooli ATM Withdrawal Fee,-3337.09,1bb97b7a-58a9-4270-adac-f470d263d23c,-15463.95,debit,bank-fee,AU00000,2023-09-02T18:39:21Z
transaction,4fce1e7f-b439-4335-ab0f-cbe2ba95558b,posted,Online Gaming Purchase,-125.16,439bd44c-64c6-430e-8662-0d2117caf223,-15589.11,debit,cash-withdrawal,AU00000,2023-05-12T22:11:34Z
transaction,7b715b9e-3c6f-4418-8719-3c372c683c36,posted,Restaurant Dinner,-4916.86,afe37b3c-d4a0-4072-8c9c-aa4d996d9d0e,-20505.97,debit,cash-withdrawal,AU00000,2023-08-05T16:11:13Z
transaction,804c6359-6013-460f-831c-00140f0dc6bb,posted,Hair Salon Appointment,-3242.03,baff0680-2a02-43d1-8393-099ee5588dc6,14435.46,debit,payment,AU00000,2023-11-07T15:43:25Z
transaction,b592c963-1d4a-4913-a74a-ae86156fea2f,posted,Non Hooli ATM Withdrawal Fee,-3423.79,7fa45499-c450-4e2c-ad90-ca865d2adde4,11011.67,debit,payment,AU00000,2024-03-13T10:25:19Z
transaction,86332e54-3411-461d-bfa4-416024955bd4,posted,CTRLINK CARERS Ref: 998R6789201610974V,-1421.11,9db6b180-40dd-4811-8d21-225467fa88aa,9590.56,debit,bank-fee,AU00000,2023-12-17T00:00:17Z
transaction,c019c2f2-a434-4869-b917-789451e5d08d,posted,Pharmacy Purchase,-1346.15,77064c1a-0922-479f-a9e2-4afef3ab3880,8244.41,debit,cash-withdrawal,AU00000,2024-01-30T11:11:48Z
transaction,31da3642-0007-4594-a7e6-8e238753d108,posted,Home Improvement Store Purchase,-2385.69,41ae8783-4946-4e6e-8437-b5f576342363,5858.72,debit,cash-withdrawal,AU00000,2024-05-05T20:50:03Z
transaction,a6b263c2-4847-4820-8532-e8a61fec059d,posted,CTRLINK CARERS Ref: 998R6789201610974V,-4633.86,321cf894-392a-40ac-8e47-c237f23e0f81,1224.86,debit,cash-withdrawal,AU00000,2023-09-08T20:53:06Z
transaction,c59ccb6e-6643-4129-8600-8caca15b3062,posted,Gasoline Purchase,-2834.58,4675a86f-4145-47f3-a3ac-e28e2b7b0c65,-1609.72,debit,bank-fee,AU00000,2023-07-03T07:25:27Z
transaction,0d41a11d-c735-4daf-9963-edbc34b193f6,posted,Home Improvement Store Purchase,-2090.32,0c322cbd-7485-4ccf-8ded-d115074db608,-3700.04,debit,cash-withdrawal,AU00000,2023-08-05T00:57:33Z
transaction,fb711d7a-8f79-47e8-8592-07278f59d71d,posted,Bookstore Purchase,-4170.3,0c8aa34b-a7f0-4462-845b-87682544b331,-7870.34,debit,bank-fee,AU00000,2024-03-13T10:49:34Z
transaction,704b9368-1309-457f-989c-72726333dcc3,posted,Movie Ticket Purchase,-3147.56,ec860e2f-43d6-4c36-b75e-f1a868b2acc4,-11017.9,debit,bank-fee,AU00000,2023-11-14T21:51:50Z
transaction,83e22d3d-7484-4a01-bec6-f30c6a17bb5d,posted,Amazon Online Shopping,-2860.27,02d61089-4ed0-489a-9934-59501943e10a,8986.34,debit,cash-withdrawal,AU00000,2024-03-11T19:48:06Z
transaction,33639af6-8d28-4ae1-97f9-572308357e7b,posted,Bookstore Purchase,-3639.59,85a8ed6f-4833-4ad5-a4c8-1ef69d4fba7a,5346.75,debit,bank-fee,AU00000,2023-06-24T01:39:55Z
transaction,f4277258-ea40-4d39-84d0-f9d266fe1e9f,posted,Music Streaming Subscription,-1314.58,5ffc4d7b-d2c7-4ea1-8d25-7947924d2167,4032.17,debit,bank-fee,AU00000,2023-12-12T08:10:28Z
transaction,cb4e3e37-f4e9-4af9-8d6b-b23f58884416,posted,Manly Maths Tutor Wages,-3570.87,abaae4dd-e661-4060-908d-c5d750d5e2f4,461.3,debit,cash-withdrawal,AU00000,2023-08-08T23:59:43Z
transaction,dbede637-7bb3-4f4d-9dc6-7ca34b6dc465,posted,TFR Acc14000 TO 12389,-2943.07,a5a35f67-f36d-4a7f-a66b-fe3272365361,-2481.77,debit,cash-withdrawal,AU00000,2024-01-05T13:28:23Z
transaction,7994ddac-d055-4ec0-a6fc-d1b9145a35f0,posted,Wdl ATM WESTPAC IGA BALGOWLAH BALGOWL AU,-3449.21,b51323c6-9d00-4b0e-8954-075e08d9b498,-5930.98,debit,bank-fee,AU00000,2023-07-04T02:02:44Z
transaction,bae44ed3-50b9-4071-8503-dbb1d8741122,posted,Clothing Store Purchase,-2490.89,b29a8e1d-f688-464c-8bcd-b0b46d8a2c55,-8421.87,debit,bank-fee,AU00000,2024-02-11T18:16:05Z
transaction,17a67792-4a00-4696-9ea8-5af218cf2b02,posted,Gasoline Purchase,-830.58,0842ec03-5af0-49d0-8b8a-2b1b9ff211dd,-9252.45,debit,cash-withdrawal,AU00000,2023-06-26T11:17:14Z
transaction,e448d54a-8528-4edf-b770-e945b654acc7,posted,Home Improvement Store Purchase,-3443.87,60590f3d-8d2c-4c60-8b68-42801c3f1a10,-12696.32,debit,cash-withdrawal,AU00000,2023-12-30T01:09:04Z
transaction,73695950-da46-4468-b7ce-fa43deb40fe3,posted,Car Maintenance Expense,-603.07,a158baa8-d446-4c8a-9448-3f4495d19b53,-13299.39,debit,bank-fee,AU00000,2024-04-06T01:19:05Z
transaction,5ad7faf3-60a6-421d-9888-ee1cec38d803,posted,Gasoline Purchase,-4388.08,f9969e16-ba27-4008-83fb-66f23219791e,8615.88,debit,bank-fee,AU00000,2023-06-26T15:32:37Z
transaction,7c29f923-9f50-4a41-90c1-a00b36e11958,posted,Coffee Shop Purchase,-263.63,d79df7e3-d98b-4bae-abcf-8e12f1d3eca4,8352.25,debit,payment,AU00000,2023-07-31T20:38:21Z
transaction,64ab5637-2aee-4b0d-8fa9-a85f7d324c05,posted,Home Improvement Store Purchase,-2848.41,c9391e8e-3356-408d-af5d-eb174d67da9f,5503.84,debit,payment,AU00000,2023-06-25T23:36:24Z
transaction,037c38e6-196d-4071-ab7e-0f51406d6609,posted,Non Hooli ATM Withdrawal Fee,-1244.08,9eeb61e5-63d3-49a0-bebe-4040aad50d71,4259.76,debit,cash-withdrawal,AU00000,2023-12-25T12:32:33Z
transaction,48353966-1fea-490c-9e99-cf29afeac1d7,posted,Home Improvement Store Purchase,-2466.9,c2f29e94-9b16-48c9-93df-d8f74415041f,1792.86,debit,cash-withdrawal,AU00000,2024-03-12T23:29:48Z
transaction,42875b40-3326-4fa4-bf7e-332774472dba,posted,Clothing Store Purchase,-2528.32,1781dab1-b28b-415f-b5b9-66ec2091d6d7,-735.46,debit,bank-fee,AU00000,2024-04-02T12:44:02Z
transaction,b716e21a-88c0-49f2-bf22-d57ce23f5933,posted,Hair Salon Appointment,-2206.85,1cc27812-6704-48fd-8f6a-6e5fa09060e1,-2942.31,debit,bank-fee,AU00000,2023-10-23T18:58:02Z
transaction,ee6dbb52-6f00-423c-8917-40618913cbca,posted,Manly Maths Tutor Wages,-3766.28,4674af55-1de7-4682-a8bd-826699765f0a,-6708.59,debit,cash-withdrawal,AU00000,2024-02-27T19:24:35Z
transaction,59b5bcdb-1d1d-4eaa-972a-fbd3207a9aa8,posted,TFR Acc14000 TO 12389,-2967.13,c502a63d-9fee-4e7d-b0b4-d33c50e34c63,-9675.72,debit,bank-fee,AU00000,2023-09-07T22:18:44Z
transaction,fa8f9612-eca6-44d5-96e8-68b678b68692,posted,Restaurant Dinner,-1543.17,ef198c9e-8dc1-4a8f-a90e-1ed06ddc9062,-11218.89,debit,payment,AU00000,2023-09-05T16:08:14Z
transaction,6a2bb261-2b38-4105-a349-18b44522318e,posted,Manly Maths Tutor Wages,-4093.02,eeaa6509-bea1-412c-bd0e-b700975bf9e9,7531.27,debit,cash-withdrawal,AU00000,2023-06-06T07:04:48Z
transaction,8c180327-ac2b-460e-800e-0bacb3052b2e,posted,Mobile Phone Bill Payment,-1571.84,7a74acfc-07a4-4d6c-b634-54bd7b6d6823,5959.43,debit,cash-withdrawal,AU00000,2023-06-04T12:29:11Z
transaction,d112eeb6-6c05-4a8e-895d-b693d6484d0b,posted,Public Transport Fare,-977.53,11a4d11a-d247-4267-8f0f-37f1c7b37819,4981.9,debit,bank-fee,AU00000,2024-05-06T04:27:19Z
transaction,d2b0d87e-fabc-4487-8d02-971503f5776a,posted,Car Maintenance Expense,-1907.25,d83d1d28-193a-4b95-b2cd-806454451318,3074.65,debit,cash-withdrawal,AU00000,2024-05-02T18:55:04Z
transaction,61fa03c9-880d-42dd-8aa7-c079e4f7957f,posted,Car Maintenance Expense,-2.17,ba6ad4ba-7be3-4160-b50a-ba8d65bac250,3072.48,debit,payment,AU00000,2023-06-25T12:22:22Z
transaction,602d4641-812c-449e-9f49-0a44689afa5b,posted,Wdl ATM WESTPAC IGA BALGOWLAH BALGOWL AU,-4464.44,a8b55bf9-837c-4352-9385-e138236efc94,-1391.96,debit,bank-fee,AU00000,2023-10-28T20:51:34Z
transaction,3a9eda73-064b-4007-b1c9-c9931f7b41f1,posted,Gasoline Purchase,-2545.63,c11fcc31-aaab-41e6-a64a-5882e1628f09,-3937.59,debit,bank-fee,AU00000,2024-03-18T08:18:17Z
transaction,f0fea129-5f72-43d1-a7c8-f089c8ee55ed,posted,Netflix Subscription,-3947.15,7c47ee9f-d5a4-4f48-a4e0-cb1572d59aef,-7884.74,debit,payment,AU00000,2024-01-27T13:21:31Z
transaction,58cfc38b-847f-4625-b227-08e4fb351717,posted,Music Streaming Subscription,-1440.07,21a24624-f037-4cc4-9427-86544795d787,-9324.81,debit,payment,AU00000,2023-12-29T09:04:20Z
transaction,71259149-3e2d-4bfe-b594-528d19165bf6,posted,Netflix Subscription,-802.44,efc6511a-b1c1-4e26-9e62-f43a3835a96b,-10127.25,debit,bank-fee,AU00000,2023-05-27T03:51:43Z
transaction,eb30d913-69a5-4c2d-be45-a53b844413c2,posted,Pharmacy Purchase,-1085.73,163a150d-1b8e-455d-91dc-1558375e2a45,18282.25,debit,payment,AU00000,2024-01-25T00:24:36Z
transaction,88ae1f80-b9b0-4fb7-8359-1796be62f58e,posted,Non Hooli ATM Withdrawal Fee,-3074.53,9737f85e-4d6e-4e5b-8326-bfec5e67d792,15207.72,debit,payment,AU00000,2023-12-02T12:57:25Z
transaction,8c22dc80-10e1-4739-87c3-f3779fd2deb9,posted,TFR Acc14000 TO 12389,-3637.14,f04da67b-9dfa-4af3-959d-3a787d14c4d7,11570.58,debit,bank-fee,AU00000,2023-05-26T08:21:16Z
transaction,c264bf8e-a667-4733-8d88-ae25e4b50bc5,posted,Music Streaming Subscription,-4976.35,43d5a5eb-39d5-42db-ba8f-1c626f57e1ad,6594.23,debit,payment,AU00000,2023-12-27T16:09:45Z
transaction,cd8f3691-5a7c-4921-b509-0b6a3649e807,posted,Hair Salon Appointment,-4416.82,c640abb9-8bcd-4d32-b225-ed8a64ee042f,2177.41,debit,payment,AU00000,2023-07-20T21:11:11Z
transaction,0274d7f7-e1be-4e4c-9ff1-41f03c14429d,posted,AGL RETAIL ENERGY LTD (GAS),-245.72,c6c24d16-7c08-43ff-9041-a6b496bbb1d1,1931.69,debit,bank-fee,AU00000,2024-04-27T11:46:38Z
transaction,28bc8be0-1635-402e-954e-0d98b831a364,posted,Uber Ride,-4708.09,aba2e02c-6efa-4d8e-8ead-1597cc1552f1,-2776.4,debit,cash-withdrawal,AU00000,2023-11-15T10:56:51Z
transaction,032c78ba-1ac4-4853-9016-4db698f035ff,posted,Non Hooli ATM Withdrawal Fee,-4859.07,1b92f02c-0abb-4e63-9b8e-a9be4f8dc77c,-7635.47,debit,payment,AU00000,2023-08-06T21:13:15Z
transaction,2377ebff-e520-4fa0-8386-93773a46ab30,posted,Non Hooli ATM Withdrawal Fee,-522.84,0a805602-7d6e-457a-b430-f3b72f32ffd4,-8158.31,debit,cash-withdrawal,AU00000,2024-02-29T20:22:25Z
transaction,30a9e1d7-dcb3-42e8-90e7-de3ab5881c5b,posted,Music Streaming Subscription,-375.13,4d790c19-8077-4a75-862a-0f0ca03dd724,-8533.44,debit,payment,AU00000,2024-01-23T03:56:15Z
transaction,73db269b-e1c2-4bc0-8c47-2f73a65919e2,posted,Gasoline Purchase,-31.35,c3924d83-667f-4fd2-ab79-e1bc27f46178,17323.18,debit,bank-fee,AU00000,2023-07-13T13:50:54Z
transaction,2bbb9332-ffbd-450b-8b90-e5102de6f941,posted,Clothing Store Purchase,-2659.82,519fcb58-5586-43ba-a3e8-e2086a0faccd,14663.36,debit,payment,AU00000,2024-02-08T06:36:55Z
transaction,fd89de4c-1213-40bc-8c62-84f7f06c00ca,posted,Non Hooli ATM Withdrawal Fee,-1528.42,51624f3b-2586-4be9-a927-28bb7e03afce,13134.94,debit,cash-withdrawal,AU00000,2024-01-29T03:07:04Z
transaction,93489de5-0c99-40d9-8357-2aa0981ecbb7,posted,Hair Salon Appointment,-4829.4,d807a292-af8c-465b-90ca-b77561a87289,8305.54,debit,bank-fee,AU00000,2024-01-24T08:24:49Z
transaction,b8160c60-3b8b-49e2-8a60-c34b11f8ad63,posted,Gym Membership Fee,-1604.58,8dbc45da-1955-4e7c-b7d7-87b6c63b815d,6700.96,debit,cash-withdrawal,AU00000,2023-09-22T07:52:21Z
transaction,e9612217-fad3-433e-9b96-17b4021ac952,posted,Car Maintenance Expense,-1599.88,9ab1ef16-f2d6-44af-bcf8-f8c169134bc3,5101.08,debit,bank-fee,AU00000,2024-01-27T00:31:26Z
transaction,09de0d60-7065-4f52-b7aa-bc15f004e21a,posted,AGL RETAIL ENERGY LTD (GAS),-2428.49,8a6c1cec-b0df-4f43-80a2-ba79197f81d5,2672.59,debit,payment,AU00000,2024-02-11T22:38:21Z
transaction,5c953d48-2b30-43a6-8504-5d705e021086,posted,Gym Membership Fee,-1593.54,35893c5f-4097-4dbc-8546-27391e8b6cbf,1079.05,debit,payment,AU00000,2023-07-13T20:21:33Z
transaction,046b58f9-23e5-4b53-9d17-f9bb88e9efe8,posted,Mobile Phone Bill Payment,-1642.75,76f79e16-fdb0-4f78-a569-479c163096e7,-563.7,debit,cash-withdrawal,AU00000,2023-11-15T16:36:44Z
transaction,115fb9ba-1489-477e-bf16-33dabbbcf08a,posted,Online Gaming Purchase,-3493.81,d190c971-8448-4166-9daa-03b690a51702,-4057.51,debit,bank-fee,AU00000,2024-02-08T00:09:49Z
transaction,2384d4c9-30cd-42e2-90d2-1577ad4ae383,posted,Home Improvement Store Purchase,-4583.93,fd00543e-7b14-4e01-9d08-1794d6f48466,4126.19,debit,bank-fee,AU00000,2023-09-17T22:55:41Z
transaction,1365ed12-d5e4-4371-81f6-943c634c017c,posted,Mobile Phone Bill Payment,-2421.92,81dc2980-5e10-4022-9321-3526f169ec82,1704.27,debit,payment,AU00000,2023-08-28T11:25:11Z
transaction,9517d819-bcd7-41ca-84db-645ade9eb04c,posted,Movie Ticket Purchase,-665.01,3cd74e6e-7153-4ce7-a33d-2114bbf9f992,1039.26,debit,payment,AU00000,2023-06-09T10:05:35Z
transaction,e6b0b7f5-02a9-4cdb-99df-a1053bbef01c,posted,Travel Agency Booking,-3101.15,3bf41a7b-6475-4796-b695-a7ca56cf7022,-2061.89,debit,bank-fee,AU00000,2023-06-16T20:03:27Z
transaction,5c6e785b-daaa-456d-9fb6-b8f3e51ada46,posted,Netflix Subscription,-3451.49,b22c1343-f358-4d78-8d56-5e2ddd1d381c,-5513.38,debit,payment,AU00000,2023-08-18T08:02:20Z
transaction,cef5576f-fae3-4584-a8ad-1c2b672924c7,posted,Transfer Platnm Homeloan 346454,-2021.11,bfeb32bc-a0b9-4be5-bbd8-32270ff3f449,-7534.49,debit,bank-fee,AU00000,2023-05-14T23:28:26Z
transaction,5658a5d9-aa30-4027-be65-1a7eda38cfa1,posted,Clothing Store Purchase,-192.25,38adbd96-fb8c-4502-ab46-bb501d3593d1,-7726.74,debit,payment,AU00000,2024-03-20T04:20:45Z
transaction,63b3e0ef-6595-434c-aae9-79383ff3e5f9,posted,Home Improvement Store Purchase,-4744.86,7dd94a9b-b9cb-4d84-b13b-4f96229c6e30,-12471.6,debit,cash-withdrawal,AU00000,2023-09-13T00:31:20Z
transaction,9ac141c9-26c9-4f17-b41d-1536a107ab94,posted,Electricity Bill Payment,-3007.4,1892ea73-663f-459a-b234-1a9f37f7fd2d,-15479.0,debit,payment,AU00000,2023-11-20T21:25:16Z
transaction,1c4b3e6f-18a0-433d-90d1-4dfcca34fb55,posted,Hair Salon Appointment,-1941.25,91d89513-6422-4811-90c5-99866925e26b,-17420.25,debit,payment,AU00000,2023-07-19T14:19:14Z
transaction,853b961a-f7fa-4ac5-8476-55d51ef95524,posted,Bookstore Purchase,-2842.05,7f12c16a-cc35-4e4d-896c-66e7d2f06b46,16100.28,debit,cash-withdrawal,AU00000,2023-08-27T10:11:08Z
transaction,42bdf0df-0d8d-428f-b2cc-c2f884857248,posted,Transfer Platnm Homeloan 346454,-2901.28,f45c455c-6edc-444c-a470-f07e74bd6b62,13199.0,debit,payment,AU00000,2024-03-30T09:45:01Z
transaction,256cb729-e400-4909-9f8d-294f0a2a8983,posted,Travel Agency Booking,-4301.42,d3b9b57e-9431-4ec4-991d-35609304e0d1,8897.58,debit,cash-withdrawal,AU00000,2024-02-12T18:41:42Z
transaction,bcb1fcdd-3158-4c1b-9adb-f2c9afa174b7,posted,Amazon Online Shopping,-3213.21,325c92cc-ca75-49a3-8e9a-a173cee9e5ad,5684.37,debit,payment,AU00000,2023-08-30T13:52:48Z
transaction,1ec9e0c3-097a-4691-87dc-4d03427909c3,posted,Gym Membership Fee,-1974.36,40dc3b8c-518f-423a-8fed-9326fc8613ff,3710.01,debit,cash-withdrawal,AU00000,2024-04-27T12:40:22Z
transaction,0f8b9c03-b366-498c-85e0-a498fafab79f,posted,Travel Agency Booking,-1407.69,8e6bbf0c-3098-49ad-a7c0-58715c11347d,2302.32,debit,payment,AU00000,2023-06-20T15:56:19Z
transaction,5106e02a-c2b4-49d5-8448-335e64625c0a,posted,Electricity Bill Payment,-3610.26,ecab198f-765b-4c22-a0c2-a9c2c1690aab,-1307.94,debit,payment,AU00000,2023-11-18T13:35:12Z
transaction,d050ad4f-eeea-4a37-a694-f3852126ff2e,posted,Coffee Shop Purchase,-3615.16,118a58c7-0987-4cdc-998e-f2b14f7732c2,-4923.1,debit,cash-withdrawal,AU00000,2024-02-24T10:47:58Z
transaction,bb802d2a-a254-4ccf-8351-bb87d2d8772c,posted,Non Hooli ATM Withdrawal Fee,-4055.05,b0d961b2-ea81-4eae-8177-5d2d882b8bd5,-8978.15,debit,cash-withdrawal,AU00000,2023-08-17T09:46:03Z
transaction,73f6c6a3-ec62-426a-8a65-8349be23a226,posted,AGL RETAIL ENERGY LTD (GAS),-1705.28,e1d97548-3fb3-4cf5-8462-693a8b837ef0,-10683.43,debit,bank-fee,AU00000,2024-04-22T11:00:09Z
transaction,4724d9ca-0645-44cb-a424-ed1ae1807fab,posted,Clothing Store Purchase,-1257.32,8c8c585c-8e33-4f04-a3d6-0047db678795,5646.73,debit,bank-fee,AU00000,2024-04-09T19:48:29Z
transaction,ed93f9b7-be7f-45a5-83f9-7e3f84c5f2fd,posted,Bookstore Purchase,-1467.74,56071cdf-ca86-4017-8509-370a3deffd09,4178.99,debit,cash-withdrawal,AU00000,2023-12-30T01:59:09Z
transaction,d4ef9c04-470a-4439-b87a-f5c632f75535,posted,Clothing Store Purchase,-4757.62,0d81c0fe-3326-4632-855b-c246d7b573ca,-578.63,debit,bank-fee,AU00000,2023-10-30T07:30:04Z
transaction,90fe2de2-645e-481d-9d40-87d647f05e52,posted,Car Maintenance Expense,-2903.46,43823f9a-1325-4f5d-958f-9bb339e988a8,-3482.09,debit,bank-fee,AU00000,2023-11-26T04:45:47Z
transaction,ac0b2b90-28b9-4f68-af11-b1befbb53f45,posted,Public Transport Fare,-1910.66,ae0cd1b7-a1d8-439f-9c3d-aee8edaf73b1,-5392.75,debit,payment,AU00000,2024-01-19T12:12:30Z
transaction,8d4be72b-4179-4f77-aa29-b3f8bd581282,posted,Amazon Online Shopping,-64.93,35173da4-eec6-41b5-ae60-acc281b3f479,-5457.68,debit,bank-fee,AU00000,2023-11-27T06:12:01Z
transaction,5bdb12db-00c5-4375-a7f6-3a33ef5cba42,posted,Netflix Subscription,-731.43,a1f3cfa9-f988-40c5-b63d-c70f94c6bc3c,-6189.11,debit,bank-fee,AU00000,2024-03-18T09:37:25Z
transaction,c288e886-7cf2-4374-8083-aa4e7a6944df,posted,Non Hooli ATM Withdrawal Fee,-1529.56,ba67bb8d-c637-454d-8701-75cba9bbecc3,-7718.67,debit,bank-fee,AU00000,2024-03-07T11:39:59Z
transaction,579912c4-1d09-4b43-908f-07b4963553e1,posted,Movie Ticket Purchase,-3807.01,99df7498-2fc7-456c-844c-c3215af1d0fd,-11525.68,debit,cash-withdrawal,AU00000,2023-10-27T13:48:22Z
transaction,bdb2e830-db22-465a-8513-d92ee52c4838,posted,Coffee Shop Purchase,-2795.71,81373b31-11b2-49df-8860-7640e991513a,-14321.39,debit,payment,AU00000,2023-12-26T22:02:18Z
transaction,5eb8a05c-bf80-4190-b8a4-c89cf8b5fc20,posted,Transfer Platnm Homeloan 346454,-1018.1,429a5ed0-f15b-4d14-811f-4bd01bf4a199,5344.69,debit,cash-withdrawal,AU00000,2023-10-31T01:58:26Z
transaction,a0cacdc3-063d-4735-b1ab-a47ce5c371cf,posted,Hair Salon Appointment,-1988.96,a0d4d03c-d4ac-4d48-9448-863ba003cc71,3355.73,debit,cash-withdrawal,AU00000,2023-06-26T17:34:31Z
transaction,70e089eb-ce23-4c59-94dc-4fd5f870d998,posted,Music Streaming Subscription,-3713.26,d11dc76e-b99b-404c-9b1e-5a6148f3d112,-357.53,debit,payment,AU00000,2023-12-13T19:53:40Z
transaction,16fcb455-c47c-493a-a645-f922b6682fc4,posted,Wdl ATM WESTPAC IGA BALGOWLAH BALGOWL AU,-2181.75,82db02d7-2c56-453c-8149-f651bb3939b5,-2539.28,debit,bank-fee,AU00000,2024-04-25T16:12:01Z
transaction,cbf6af6f-2dcd-4aed-abb1-4ffa3a2c1567,posted,Pharmacy Purchase,-224.38,7a379301-4528-4250-96c1-01cc19d54625,-2763.66,debit,bank-fee,AU00000,2024-04-13T13:46:43Z
transaction,9bac5f48-3a35-4221-9eb3-3c14958d1a72,posted,Car Maintenance Expense,-3782.44,b12ce408-cca2-427d-a92b-1c04713fe149,-6546.1,debit,payment,AU00000,2024-04-07T10:03:21Z
transaction,3e9ca4cb-8f16-4b3b-85e3-2ec5ec1a9caf,posted,Wdl ATM WESTPAC IGA BALGOWLAH BALGOWL AU,-547.31,27f34af6-15df-4d70-a208-311529bbef57,-7093.41,debit,bank-fee,AU00000,2023-07-01T03:34:41Z
transaction,79e04bbf-b1ac-4ed1-856a-46a48602a18b,posted,Electricity Bill Payment,-3290.15,a4f5f43a-c88c-4afb-bdf7-d0c721386998,-10383.56,debit,payment,AU00000,2023-09-09T19:30:25Z
transaction,c33470ba-c27f-4745-be1d-b1d5e24dc68f,posted,Home Improvement Store Purchase,-1746.52,c5368c95-5850-4da7-be91-3b2bd9abf62e,-12130.08,debit,payment,AU00000,2023-07-03T02:40:30Z
transaction,55399c8c-08e8-4f82-b8e8-e48c0e1aa847,posted,Online Gaming Purchase,-1613.29,aa1a9b68-0597-4555-a414-da2f5bf8396f,-13743.37,debit,bank-fee,AU00000,2023-12-15T19:33:38Z
transaction,ea5dc9ed-735d-4805-a1ea-739225ea51da,posted,TFR Acc14000 TO 12389,-4883.19,8998e65a-351e-4303-b3e7-485d8387d0b1,7588.93,debit,payment,AU00000,2023-11-26T08:54:34Z
transaction,da84bb4d-0158-4a4c-bb26-683cd95c51b9,posted,Public Transport Fare,-4171.17,61a6d667-e8cc-42b0-bb6e-d943286b39dc,3417.76,debit,payment,AU00000,2024-03-29T13:38:15Z
transaction,3283d36f-ec25-4c60-8ba2-5871716456b0,posted,AGL RETAIL ENERGY LTD (GAS),-2873.55,5402ae4a-abc3-4b58-9225-7c9c3559e839,544.21,debit,payment,AU00000,2024-02-24T05:01:31Z
transaction,a684b87a-54ac-489d-bce7-07f58d63b504,posted,Mobile Phone Bill Payment,-1912.77,c1e4cef3-33c1-4d2d-bc41-8458c8942ca3,-1368.56,debit,bank-fee,AU00000,2023-11-05T16:00:03Z
transaction,9ee14eeb-3413-4898-a5c3-8e0b8f3cf327,posted,AGL RETAIL ENERGY LTD (GAS),-1724.33,b090cf91-1497-46c2-903a-21a03db93502,-3092.89,debit,payment,AU00000,2023-07-23T10:00:42Z
transaction,a547c8c2-24fb-4843-92cc-41acdce6f97d,posted,Pharmacy Purchase,-3578.7,ae4906ed-1ae8-4c5b-b3e5-92be3ab2bd0f,-6671.59,debit,bank-fee,AU00000,2024-02-05T08:59:30Z
transaction,315bca9f-dfdc-4864-bee5-8eee3fd52b53,posted,Travel Agency Booking,-3913.64,5eed859c-a563-42f6-951b-d1ba92eac049,-10585.23,debit,cash-withdrawal,AU00000,2024-05-06T05:37:39Z
transaction,a6a5c74c-24e5-4ed7-b2d8-82710c1823da,posted,Wdl ATM WESTPAC IGA BALGOWLAH BALGOWL AU,-547.62,e0aa6a63-5873-46b8-97c7-75e4171e9d0a,-11132.85,debit,payment,AU00000,2024-03-14T22:08:24Z
transaction,c60abb3d-aa4d-40e8-acb5-fb8757447f48,posted,Wdl ATM WESTPAC IGA BALGOWLAH BALGOWL AU,-2566.79,3588ec3f-4955-4548-bdd3-6a516f87c9c2,-13699.64,debit,payment,AU00000,2023-09-26T22:37:47Z
transaction,9ec62627-4179-4d82-a94d-03a923a4e8b4,posted,Movie Ticket Purchase,-1023.38,32d156b9-0106-4cc1-9ba4-7a0be676f3c8,-14723.02,debit,bank-fee,AU00000,2023-11-20T16:14:04Z
transaction,faff4f41-f693-4358-817d-0530d7468800,posted,Gasoline Purchase,-2894.14,cb0421ba-2e7f-4085-86c7-ff2394e884ed,10422.8,debit,bank-fee,AU00000,2023-08-21T01:46:37Z
transaction,62dbad90-85be-42f5-887b-ca22ac9f52db,posted,Coffee Shop Purchase,-4078.64,62107d19-23d3-4704-9ea6-877d752f5d7d,6344.16,debit,payment,AU00000,2024-05-01T09:24:48Z
transaction,5bf5a18b-922a-4952-b067-130e4dc021cc,posted,Home Improvement Store Purchase,-1236.61,a3439025-1f84-4510-b313-0ad018d5f697,5107.55,debit,bank-fee,AU00000,2023-09-24T11:19:36Z
transaction,d3647ff8-4eb2-4f13-a609-d5f48fd197c1,posted,CTRLINK CARERS Ref: 998R6789201610974V,-4675.83,7964cdd6-bc33-417a-9747-dae7fbb59abc,431.72,debit,cash-withdrawal,AU00000,2024-04-17T10:21:33Z
transaction,1ccded21-2a46-4f6b-9e3e-7e7362f8a47c,posted,Music Streaming Subscription,-3208.81,21988c83-4f6a-4de9-9734-e0309a331497,-2777.09,debit,payment,AU00000,2024-02-03T10:19:52Z
transaction,a2b98a5a-fe12-4a01-bfbd-7ac3186b264e,posted,Pharmacy Purchase,-3076.81,2297b11b-0361-433f-8571-5f02d6dbd4de,-5853.9,debit,bank-fee,AU00000,2023-09-10T17:52:02Z
transaction,385722c2-5b37-46ae-817c-1c678717d282,posted,Pharmacy Purchase,-4434.28,97eedc8f-b920-4268-a63a-bc666407b82e,-10288.18,debit,cash-withdrawal,AU00000,2024-05-08T13:23:31Z
transaction,ca792826-713f-496a-b34e-1c06d267a280,posted,Bookstore Purchase,-3640.08,4d40d649-93a3-4b30-99fe-004d8ebd473b,-13928.26,debit,bank-fee,AU00000,2023-12-24T23:13:07Z
transaction,e2820e78-70f6-47bb-a08d-38c6b3a17a22,posted,Netflix Subscription,-1731.62,a6157f53-c7b1-4693-9737-909f14805e39,-15659.88,debit,payment,AU00000,2023-05-28T05:23:18Z
transaction,4c773164-636d-4dac-a6dc-3653cc68d149,posted,Travel Agency Booking,-1052.84,5493d48f-4c46-424b-a06e-7da934de82ab,-16712.72,debit,cash-withdrawal,AU00000,2023-10-25T04:08:57Z
transaction,54e2a227-4109-43b5-9a11-31cefed21fa2,posted,TRANSFER TO JOANNA SMITH CAMPING,-4484.46,d5596c4b-e17b-4eec-bf45-b75f4d721bf6,12249.46,debit,cash-withdrawal,AU00000,2024-03-29T17:16:18Z
transaction,da5c9d51-b4f2-481c-a30f-0ac391b0c46a,posted,Home Improvement Store Purchase,-33.59,cdad9dde-5319-4287-9d60-0d31ccfb2d0b,12215.87,debit,payment,AU00000,2024-01-29T18:25:23Z
transaction,6aedd42d-648b-46b2-b428-d8b933c8a962,posted,AGL RETAIL ENERGY LTD (GAS),-4479.55,25776612-a4b5-4165-a132-93d360fa5fae,7736.32,debit,payment,AU00000,2023-07-06T07:41:06Z
transaction,abc0aed4-3787-46af-949b-667bf3c515cb,posted,Manly Maths Tutor Wages,-1331.19,4534be6a-cd9a-442c-be0d-b3b9f79877f7,6405.13,debit,payment,AU00000,2023-12-11T13:07:32Z
transaction,75f8d3fd-0c84-43bd-a148-908dd62aafe8,posted,Netflix Subscription,-3119.21,9c3658bc-2738-47ab-869b-ee6540417f50,3285.92,debit,payment,AU00000,2024-01-27T11:01:34Z
transaction,589d5354-a23a-4311-89c2-e0a9b7360c66,posted,Non Hooli ATM Withdrawal Fee,-1095.55,325d7b6c-2a10-4767-b549-8b5d88205494,2190.37,debit,bank-fee,AU00000,2023-09-12T08:21:59Z
transaction,a549d654-13b2-4b9d-94da-2f8417015419,posted,Clothing Store Purchase,-4808.81,039e55c5-75ba-40c3-97a5-1b397df3d3f7,-2618.44,debit,payment,AU00000,2023-08-29T22:34:35Z
transaction,ca375945-9191-468c-a3f3-300f557f4d85,posted,Hair Salon Appointment,-3025.77,c88aa839-a076-4b2d-8aa8-72a1f7fa4467,-5644.21,debit,cash-withdrawal,AU00000,2024-04-06T03:57:37Z
transaction,39f0c6e3-c676-4df1-82d8-bb69ef647afe,posted,Public Transport Fare,-506.93,eaa3a06b-e674-439e-b48a-6af2c3692f26,-6151.14,debit,bank-fee,AU00000,2023-10-28T10:50:10Z
transaction,66abeb9f-0006-44dd-9543-902076f29991,posted,Non Hooli ATM Withdrawal Fee,-640.45,a572f8d6-ccdf-4789-bfef-1e5f6c6d9131,-6791.59,debit,bank-fee,AU00000,2024-03-27T10:33:42Z
transaction,12cc123b-db3d-4f25-bbbf-3038f62a7279,posted,Wdl ATM WESTPAC IGA BALGOWLAH BALGOWL AU,-4570.0,3ffb8ef9-bbb2-4012-bb8b-f833fc950cd1,10363.2,debit,cash-withdrawal,AU00000,2023-12-04T10:19:08Z
transaction,550e461c-12bb-4a99-b584-ca887bd8556e,posted,Uber Ride,-1874.32,b5102d36-10f5-43be-9e17-9cd732cb16ed,8488.88,debit,cash-withdrawal,AU00000,2023-10-20T09:17:46Z
transaction,4d8cff0b-3df9-4bc5-9e64-08bb0df1378f,posted,Public Transport Fare,-3902.24,49f9e5a3-1601-405c-acb9-4948728345d4,4586.64,debit,cash-withdrawal,AU00000,2023-09-20T23:08:45Z
transaction,5df7a1f3-85cb-4a35-ab51-037c4b06d3fd,posted,TFR Acc14000 TO 12389,-2091.78,91bd695b-686a-4050-9121-03e7a60e5174,2494.86,debit,cash-withdrawal,AU00000,2024-04-30T08:56:30Z
transaction,bb3fb110-4329-484c-ae77-3f639f120bd3,posted,Coffee Shop Purchase,-4965.56,03aaabf0-578e-4941-b13f-47839147ce9d,-2470.7,debit,payment,AU00000,2024-01-14T06:13:43Z
transaction,d4238cb3-8110-4818-ad87-a300d89d6bcc,posted,Wdl ATM WESTPAC IGA BALGOWLAH BALGOWL AU,-4295.04,216d3599-56d2-49d1-9a48-390c21e0c86a,-6765.74,debit,payment,AU00000,2023-08-05T10:54:11Z
transaction,5392a169-6043-4d54-8f05-64c3baafeecf,posted,Amazon Online Shopping,-2258.89,7e8a90c1-9bb1-4b75-a51f-dda38a1295d3,-9024.63,debit,cash-withdrawal,AU00000,2023-11-25T16:08:34Z
transaction,c5687b8c-003e-40c1-a2ad-36cd6461d47e,posted,Car Maintenance Expense,-4080.82,853444c4-e432-4473-9712-eac53b96d4d2,-13105.45,debit,bank-fee,AU00000,2023-08-23T07:58:38Z
transaction,d91586fb-d478-4760-b769-1716de40b625,posted,Manly Maths Tutor Wages,-1930.25,4a69512a-c0ab-4185-add0-4c0c11fdf14a,-15035.7,debit,payment,AU00000,2024-03-27T13:28:10Z
transaction,7cdbc752-cdf0-432d-9759-cb027e143454,posted,AGL RETAIL ENERGY LTD (GAS),-1661.57,5cdb549d-5c6f-4d32-b5d9-deeb3b344338,-16697.27,debit,cash-withdrawal,AU00000,2023-07-18T22:28:54Z
transaction,f021330d-584c-48a2-9e60-a87b5713118e,posted,Amazon Online Shopping,-3702.2,beb58cd4-4554-49a8-8755-39938e0ae72b,12247.83,debit,bank-fee,AU00000,2023-08-04T02:40:56Z
transaction,abe4534c-2111-4320-8347-6585a98cd834,posted,Gasoline Purchase,-2167.17,c6d59bfb-daae-47b1-9457-89970978a594,10080.66,debit,cash-withdrawal,AU00000,2023-05-20T04:29:54Z
transaction,93f78427-9e7e-4391-a206-3f8550d66128,posted,Bookstore Purchase,-3019.63,5c8b8737-5713-422a-969a-9c22433ebd5c,7061.03,debit,cash-withdrawal,AU00000,2023-09-30T16:22:56Z
transaction,c281e1a9-5122-4bdc-a841-b6aa4c9bc955,posted,AGL RETAIL ENERGY LTD (GAS),-1220.39,57530c8c-0bba-45f4-8192-1b7376f30057,5840.64,debit,payment,AU00000,2023-10-28T06:08:33Z
transaction,e2ec3631-3a89-4d28-8a7a-f7495656ecc3,posted,Netflix Subscription,-4253.36,e4af0847-b559-4054-89d8-5d74a2d87dda,1587.28,debit,payment,AU00000,2024-02-07T06:06:57Z
transaction,d979c57e-fc38-44ff-adb3-51eed75305ce,posted,Electricity Bill Payment,-2257.89,24c55247-f4d3-4452-8701-ec7b667de19c,-670.61,debit,cash-withdrawal,AU00000,2023-08-13T23:26:32Z
transaction,4967b8fc-32c1-4bad-b8c2-26bafa47d742,posted,Hair Salon Appointment,-1268.43,ddd10273-d359-49e8-9ea9-35fbf7a11e96,-1939.04,debit,payment,AU00000,2024-01-26T22:35:42Z
transaction,9718a39a-131b-4e38-b438-bcca58edd2c6,posted,Mobile Phone Bill Payment,-4618.27,cd6c6a93-418e-408d-9113-a87309d7f6dc,-6557.31,debit,payment,AU00000,2024-05-10T09:49:45Z
transaction,1edcbbea-ea7e-4385-933e-2b89936b8230,posted,Wdl ATM WESTPAC IGA BALGOWLAH BALGOWL AU,-3341.91,7c4635bc-e452-4c00-a0e2-648b13223388,-9899.22,debit,payment,AU00000,2024-04-14T02:55:54Z
transaction,5bc76241-ccd3-4ffe-a9ec-0fdb17fb880d,posted,Amazon Online Shopping,-472.05,f770ecb5-3b4f-4b80-99d6-e9d211112ac8,-10371.27,debit,payment,AU00000,2023-09-22T03:23:22Z
transaction,79910760-46ef-4903-b3b9-78c1a41183a5,posted,Netflix Subscription,-4314.39,a992e3db-ad70-4535-9029-4fbe3a22dca3,8291.64,debit,cash-withdrawal,AU00000,2023-06-29T19:58:00Z
transaction,0df10d92-f044-4a33-9692-135f9fb39b74,posted,Uber Ride,-1422.16,853e904f-e30a-49c1-82d4-7378e8aee62b,6869.48,debit,cash-withdrawal,AU00000,2024-02-11T15:17:38Z
transaction,41f8345c-e41f-4dff-8622-08fce82cd5c0,posted,Mobile Phone Bill Payment,-652.29,ce829cc5-2d51-4abf-b386-a3ee3a2d4d54,6217.19,debit,cash-withdrawal,AU00000,2024-04-13T09:25:41Z
transaction,116baa08-f9b1-4144-9236-f6d5aad935e0,posted,Car Maintenance Expense,-4047.48,432931f8-97aa-4f2d-a748-6d111d1911ce,2169.71,debit,cash-withdrawal,AU00000,2024-01-23T21:56:01Z
transaction,b35b9251-c2b3-4800-af3b-98388fc84e64,posted,Restaurant Dinner,-1265.01,46bc745b-8356-4f8e-84b8-291ca5662b23,904.7,debit,cash-withdrawal,AU00000,2024-03-10T22:56:19Z
transaction,5f2f4619-6b3f-42ad-bef0-f3915dc6ee2c,posted,Mobile Phone Bill Payment,-4625.37,007a1aa3-81ec-40ae-b9a3-bdcd07f98949,-3720.67,debit,bank-fee,AU00000,2024-04-09T13:07:49Z
transaction,d9392d1f-cd86-4c40-b168-9474ed6df054,posted,Netflix Subscription,-4139.51,5ad38075-c98c-47f4-ad15-8f79946c40ac,-7860.18,debit,cash-withdrawal,AU00000,2023-12-02T07:25:42Z
transaction,25c57735-e09b-4eb7-9268-05e82ebcb7fd,posted,Online Gaming Purchase,-1065.49,b1a7d23e-4860-4b3f-ac55-705f05f6cce3,-8925.67,debit,bank-fee,AU00000,2023-11-11T22:46:05Z
transaction,62892071-a518-4527-a8eb-39d3990eb623,posted,TFR Acc14000 TO 12389,-3774.02,6ee57f4d-6fd3-4507-927d-31738186a07b,-12699.69,debit,cash-withdrawal,AU00000,2023-06-12T16:35:46Z
transaction,0409b47b-de1c-48c0-8ab5-a3b0f6e2e281,posted,Non Hooli ATM Withdrawal Fee,-663.54,3ec6fcc9-ecad-418c-8c25-9b5ad744e47c,-13363.23,debit,payment,AU00000,2023-12-05T12:40:59Z
transaction,0553e0e3-b32d-4871-bcd7-16889fed2152,posted,Gym Membership Fee,-4559.41,8097c13c-ec2e-4b93-b0f8-09eb32ed6db2,3181.87,debit,bank-fee,AU00000,2024-02-11T15:54:30Z
transaction,4ee45e05-155a-468e-9ade-08ec1805a350,posted,Gasoline Purchase,-3914.15,883bdb2c-a7d5-404c-96d5-0a285d3d3ec9,-732.28,debit,payment,AU00000,2024-03-31T14:43:24Z
transaction,68c4c6b7-50d9-4cc2-942e-b7639b419cc8,posted,Restaurant Dinner,-577.01,5d1dd662-42d8-4d4b-811b-17f4db74b76f,-1309.29,debit,bank-fee,AU00000,2024-03-12T05:48:03Z
transaction,05221c96-dac7-496e-b286-34f76735e478,posted,Online Gaming Purchase,-2081.06,962abd64-ea53-4cb6-ba1a-ff5e4896b234,-3390.35,debit,cash-withdrawal,AU00000,2024-01-25T13:20:37Z
transaction,372b84af-5770-480a-b390-1ac17cd332cd,posted,Amazon Online Shopping,-4149.0,1a3c30df-4f91-448a-9bf4-942c4d09f713,-7539.35,debit,bank-fee,AU00000,2023-08-24T05:18:00Z
transaction,ca4fd22c-b7aa-432b-85ff-e04c0fd88fb2,posted,Travel Agency Booking,-2840.97,18375662-463e-4814-807d-d1bd569b5cff,-10380.32,debit,cash-withdrawal,AU00000,2024-04-23T04:25:25Z
transaction,174c227e-b36e-4661-9d9c-ee2f2f99cb20,posted,Netflix Subscription,-4014.27,bbbbde13-710f-4630-acef-f525b5f71c5d,-14394.59,debit,payment,AU00000,2023-12-03T06:39:08Z
transaction,fd8c3099-9eef-4722-9ca6-eb4320977d31,posted,Coffee Shop Purchase,-1950.22,6d58ba10-26db-45ea-a5d5-274712fa6b5f,-16344.81,debit,payment,AU00000,2024-03-21T03:51:09Z
transaction,874eddc1-efb5-4913-80d0-4004d5cb0cf6,posted,Transfer Platnm Homeloan 346454,-4143.99,bb0d5443-1b84-4917-958c-01bca349df4c,-20488.8,debit,cash-withdrawal,AU00000,2024-03-17T19:24:25Z
transaction,2b7e2d95-17e9-4658-b2c1-5a82d2cccb0b,posted,TFR Acc14000 TO 12389,-2892.18,abedefd0-9661-4703-bd67-2c6d056f0367,-23380.98,debit,payment,AU00000,2024-04-25T19:10:36Z
transaction,3d497efd-b48a-43ea-9073-55903a2552c7,posted,CTRLINK CARERS Ref: 998R6789201610974V,-4876.57,b3890c1e-5aa4-4e01-ace1-eda98cca7628,8706.94,debit,payment,AU00000,2024-03-17T02:09:48Z
transaction,2fa65651-c07b-41d9-b64e-96a54f6df996,posted,Clothing Store Purchase,-1875.94,2b51b69f-6e27-43e1-b733-dc4ab44b64f6,6831.0,debit,bank-fee,AU00000,2024-05-08T11:52:54Z
transaction,867bb886-1268-4fba-be85-b0204c1a7e6c,posted,Uber Ride,-3550.94,a16122c3-f6a6-4b77-97c9-d9eeb0d9e5df,3280.06,debit,payment,AU00000,2023-08-17T10:25:49Z
transaction,91c0dbdc-ec21-486a-92e0-7952ccbd2a1d,posted,CTRLINK CARERS Ref: 998R6789201610974V,-179.58,f77aa973-382b-4c7f-87bd-12cc9e9a297d,3100.48,debit,cash-withdrawal,AU00000,2024-03-09T13:16:14Z
transaction,a57f3942-df70-4379-ba68-6bde6234c677,posted,AGL RETAIL ENERGY LTD (GAS),-599.51,e007c908-6436-4f58-8944-ec4f39062504,2500.97,debit,bank-fee,AU00000,2023-05-29T10:58:27Z
transaction,607e5f79-84d1-493d-95ed-85b895095405,posted,Payroll WFRMS 15439393,10038.57,fa5b074d-ab34-4c57-a323-c27a0586c85d,12539.54,credit,transfer,AU00000,2023-10-02T09:26:14Z
transaction,d89f6515-fed4-4a0a-b4b9-37336c9cf640,posted,Netflix Subscription,-174.98,31f752a4-2608-40bb-8e12-6d1894863c10,12364.56,debit,bank-fee,AU00000,2023-08-20T15:32:12Z
transaction,a0daeba8-a45e-4893-ba1c-f39d9c73e05d,posted,Online Gaming Purchase,-2001.37,bcb0a48b-c34b-4c4b-9baa-e9b49ea28fd8,10363.19,debit,payment,AU00000,2023-06-24T21:04:14Z
transaction,3dc92bed-fb48-4348-a7ef-402bc43d3705,posted,Wdl ATM WESTPAC IGA BALGOWLAH BALGOWL AU,-2878.18,ac01dcb7-a653-4fcc-bffd-3f5334cd4604,7485.01,debit,bank-fee,AU00000,2024-02-12T20:23:56Z
transaction,919c8958-083b-4b93-8e41-11a31322b517,posted,Amazon Online Shopping,-57.08,dbe82eb0-233c-4a29-b021-17b1da547070,7427.93,debit,cash-withdrawal,AU00000,2023-09-07T08:06:19Z
transaction,7b530331-283f-409e-a4de-94f9fc1d185e,posted,Payroll WFRMS 15439393,11001.39,69f4def3-d03a-41ab-b5cd-a7ad90723c38,21828.06,credit,transfer,AU00000,2023-08-12T06:49:35Z
transaction,dbf63511-b861-417f-9389-289b74f8a6eb,posted,Non Hooli ATM Withdrawal Fee,-3301.41,951b3cae-ea6b-4bba-b0d3-bcef08bd8333,18526.65,debit,payment,AU00000,2024-04-28T20:13:27Z
transaction,e99cefa8-d4d7-4969-9329-b9a4e6576b44,posted,Gym Membership Fee,-2761.64,8229310f-469d-46bc-abfe-4321f92c7a2f,15765.01,debit,bank-fee,AU00000,2024-01-18T13:27:51Z
transaction,5bba8179-5734-4f8e-9aac-bdd50c7dd5e4,posted,Mobile Phone Bill Payment,-4684.26,35ed77b1-7523-400f-9a60-610c2188d170,11080.75,debit,payment,AU00000,2023-06-01T00:58:57Z
transaction,66c5c954-a3e3-49e5-a1d4-53851a0532f3,posted,Uber Ride,-2419.98,09791b55-13eb-4c7e-b8c3-99cd08e10e9a,8660.77,debit,cash-withdrawal,AU00000,2023-07-13T11:01:05Z
transaction,e04b8913-f1d7-4788-adf4-357d2abe1014,posted,Mobile Phone Bill Payment,-1152.63,9ce2b3fb-f5f5-401f-b658-5f995cc9e6cc,7508.14,debit,cash-withdrawal,AU00000,2023-06-05T22:08:10Z
transaction,e17cab37-e8fe-4255-b1a0-ecbcb30c6fcb,posted,Electricity Bill Payment,-2572.28,5106ad0e-97fd-4972-8f31-eb022f840c4c,4935.86,debit,payment,AU00000,2023-07-29T08:38:13Z
transaction,c825d882-4e09-4331-8b0e-410e947ac6cc,posted,Home Improvement Store Purchase,-1863.62,c1e69223-545a-47ea-b94d-e519d070223a,3072.24,debit,cash-withdrawal,AU00000,2023-10-09T21:50:07Z
transaction,3c002109-8ec8-4589-8e23-b48140352ffe,posted,Restaurant Dinner,-197.09,8125be39-8136-46fb-9657-54ebbbce58ef,2875.15,debit,payment,AU00000,2024-04-29T21:01:44Z
transaction,e6314b2b-cb5d-4337-86f1-d231f1cbd1f7,posted,Netflix Subscription,-2756.25,ae30ad2a-1878-44b6-b3ce-d6068a824b16,118.9,debit,payment,AU00000,2023-07-11T05:51:16Z
transaction,6cf45455-5305-4aab-8d51-5a418bcf2857,posted,Pharmacy Purchase,-2648.16,34add028-682b-4477-a541-0d1ac2120132,6205.26,debit,bank-fee,AU00000,2023-10-05T23:43:07Z
transaction,c8a73315-025e-4cc2-a54a-6a252f0875c4,posted,Mobile Phone Bill Payment,-3982.7,558bc21f-ad9a-4172-847b-51bb2c576349,2222.56,debit,cash-withdrawal,AU00000,2023-10-13T12:06:13Z
transaction,5e69e0d9-1c72-453d-a34c-0566b72e27a7,posted,Music Streaming Subscription,-1807.55,19cc9671-9944-49a0-89f2-ef65a9b99a00,415.01,debit,cash-withdrawal,AU00000,2023-09-19T06:49:27Z
transaction,3ce72b73-e9a7-46ec-bb37-d0feb30e9c43,posted,CTRLINK CARERS Ref: 998R6789201610974V,-489.51,0adca10d-9ebe-4cc2-9655-8c5998c7f202,-74.5,debit,cash-withdrawal,AU00000,2023-10-29T17:40:03Z
transaction,e2875e2e-c0e1-4651-8a28-aabce0bcb46a,posted,Clothing Store Purchase,-4875.51,d545d228-efd3-491d-ac9e-d8eba44e9561,-4950.01,debit,cash-withdrawal,AU00000,2024-03-03T21:13:46Z
transaction,dfe0aa8d-bc3a-4015-ad9a-2df1f5eeb5d5,posted,Home Improvement Store Purchase,-478.1,bc1d94a9-85cb-4b40-95be-c7703740963a,-5428.11,debit,payment,AU00000,2023-06-21T17:56:03Z
transaction,a4077d8d-b798-48a6-9b93-53beabee4411,posted,Amazon Online Shopping,-2218.14,dd042515-5893-4ed4-bd0d-b5c2c1bc3566,-7646.25,debit,bank-fee,AU00000,2023-07-18T02:20:24Z
transaction,54177e05-78ce-467f-8802-25e66ee552c3,posted,Electricity Bill Payment,-3279.38,19b13a5a-4137-4fa8-940b-22d0fc102684,-10925.63,debit,payment,AU00000,2024-03-25T11:10:53Z
transaction,be3c9494-c0c8-42ff-97b8-f915e3256198,posted,Car Maintenance Expense,-3426.24,a891398b-3e19-4508-83e7-6a1b277bea42,-14351.87,debit,bank-fee,AU00000,2023-09-06T05:21:41Z
transaction,853f95a5-49ee-4ad6-a7a2-9991628b1fd3,posted,Gym Membership Fee,-4058.17,b6c86506-2c5d-431e-8ec2-4547e0711c0a,-18410.04,debit,payment,AU00000,2023-11-30T08:02:07Z
transaction,6bcd2b16-17fd-4f66-91a0-a9f7209cdc7f,posted,Mobile Phone Bill Payment,-4628.72,5c5a4c18-3238-48df-bf62-1b5bcd6e4381,11329.55,debit,bank-fee,AU00000,2023-10-18T18:04:11Z
transaction,884b14e2-863b-42f1-a92f-a83016234b2b,posted,TRANSFER TO JOANNA SMITH CAMPING,-2551.69,54e7a9a0-1b46-4089-a97a-011168ca996c,8777.86,debit,bank-fee,AU00000,2023-06-26T12:26:51Z
transaction,04494113-40bd-4945-aab0-647daf635548,posted,Pharmacy Purchase,-1212.3,60f07402-7ee0-4461-a775-060927e9d9d3,7565.56,debit,cash-withdrawal,AU00000,2023-11-12T23:22:28Z
transaction,d210a146-3974-46da-8f11-7e37a17f8cc0,posted,Movie Ticket Purchase,-3831.26,aaa0b61b-42fb-4f91-8f46-fef1ff9396d1,3734.3,debit,bank-fee,AU00000,2024-03-23T08:58:31Z
transaction,fbd3041d-e0aa-4774-87fc-87bced6379b7,posted,TRANSFER TO JOANNA SMITH CAMPING,-1068.7,7239fbb9-f205-481e-ad8d-08c776281e21,2665.6,debit,payment,AU00000,2023-09-02T20:27:34Z
transaction,013c780a-15e2-4848-9b2e-ea7f75e7c3b0,posted,Online Gaming Purchase,-559.54,efc06b93-57cf-46f0-afad-ca0d5f51eca0,2106.06,debit,cash-withdrawal,AU00000,2024-04-26T11:51:29Z
transaction,ed6000b9-ebf3-441d-9ad1-124295fab5f0,posted,Public Transport Fare,-60.97,8beb73cb-a054-43d4-9568-3379de38fd25,2045.09,debit,bank-fee,AU00000,2024-01-04T12:09:12Z
transaction,c06082a3-2b08-4e8e-a17d-044b6b17017b,posted,AGL RETAIL ENERGY LTD (GAS),-805.31,03722f49-354c-4f95-8e08-ed1422c1c348,1239.78,debit,cash-withdrawal,AU00000,2023-11-15T05:16:51Z
transaction,fabb18e8-0868-4b6b-8b7c-bbb61eba5ff4,posted,AGL RETAIL ENERGY LTD (GAS),-833.05,7482041d-9e11-43ee-9512-07975e4ae61a,406.73,debit,bank-fee,AU00000,2023-11-19T00:33:51Z
transaction,1ba56aa4-8ffd-40d7-9f36-1cd83e7a7d3e,posted,TRANSFER TO JOANNA SMITH CAMPING,-725.24,4b0fbf48-5960-4b53-b0f9-9b8ce2f7e712,-318.51,debit,cash-withdrawal,AU00000,2023-08-01T01:51:20Z
transaction,680e8a1e-2668-4a05-a28f-a2065f639daf,posted,Clothing Store Purchase,-413.08,f413578c-3c20-4c1a-b537-0542c7965687,12569.49,debit,bank-fee,AU00000,2023-05-15T05:16:55Z
transaction,c6bd9f9d-06d9-46c5-a3f6-b5d937222137,posted,Gym Membership Fee,-2360.08,65bf209f-8ce0-4dce-8d70-b7ab96161da6,10209.41,debit,bank-fee,AU00000,2023-09-26T01:32:00Z
transaction,c291d567-0c5a-4360-af67-df839fbdaf3d,posted,Payroll WFRMS 15439393,10212.73,4dce6e6a-98d7-4dfe-b073-62e394a3aeb0,20422.14,credit,transfer,AU00000,2023-07-16T15:04:32Z
transaction,3404e7ad-f020-415a-aac6-cfcfce27a6b3,posted,Online Gaming Purchase,-3886.69,14e76828-8b37-411a-a6eb-f627b463180d,16535.45,debit,cash-withdrawal,AU00000,2023-07-19T23:10:40Z
transaction,7ed2afec-31ad-4297-b3fb-adda8921c48d,posted,Manly Maths Tutor Wages,-851.93,0bc44df5-3575-4d5b-9589-eb8af83a1816,15683.52,debit,cash-withdrawal,AU00000,2023-11-26T09:03:31Z
transaction,267fee0f-8102-453c-8dbe-988cfeb92c6e,posted,Coffee Shop Purchase,-3752.47,d3a6828d-e11e-44b4-9462-0e76221486a0,11931.05,debit,payment,AU00000,2024-04-15T19:01:22Z
transaction,0e259b72-6379-4348-b603-1dd560ef3ef4,posted,Music Streaming Subscription,-1389.52,9aea6047-c658-4f2f-a30a-6a149d52bf1d,10541.53,debit,bank-fee,AU00000,2023-07-15T20:43:31Z
transaction,349b3ec4-beb9-43d6-8865-6cc5ab7e271c,posted,Home Improvement Store Purchase,-3042.3,55110f1c-f2ae-410a-ab70-9e9ca4907c20,7499.23,debit,payment,AU00000,2023-09-08T06:23:35Z
transaction,da496045-04c3-4518-b29b-4c3b48130872,posted,Payroll WFRMS 15439393,10968.93,e395c4c6-0d80-45f9-85b3-0f439d34a5e5,18468.16,credit,transfer,AU00000,2024-04-29T04:22:08Z
transaction,c5f03e6a-42a3-421f-9a06-41af6632050e,posted,AGL RETAIL ENERGY LTD (GAS),-1150.16,9e2248c3-451d-4064-aec9-ae1599fd6af3,17318.0,debit,cash-withdrawal,AU00000,2024-04-08T07:19:01Z
transaction,21f66200-bcaa-40ba-8d60-ed641bd15aab,posted,Gym Membership Fee,-3377.05,e1f662c1-67f8-4779-babf-dd46949a41d2,8563.94,debit,cash-withdrawal,AU00000,2024-02-12T11:56:49Z
transaction,4e3caab9-047f-4257-a4db-f861232d9a0d,posted,Music Streaming Subscription,-689.41,57f9e3cb-aad7-4a2b-8f4b-23611a9641d0,7874.53,debit,bank-fee,AU00000,2023-05-22T04:30:57Z
transaction,628c200c-f191-4bad-9f24-8423dc785528,posted,Travel Agency Booking,-4308.49,e3a3b16e-f40f-4c96-91f2-f9fd532de529,3566.04,debit,cash-withdrawal,AU00000,2023-08-03T18:16:13Z
transaction,570dbddf-89cf-479d-8438-ce329f1ca971,posted,Uber Ride,-4382.18,36c4559d-33a2-4875-9ac6-d5ec12a7d1ab,-816.14,debit,cash-withdrawal,AU00000,2024-01-03T22:31:21Z
transaction,c680e007-2c48-4574-a5a3-e3e95205b0b7,posted,Non Hooli ATM Withdrawal Fee,-2670.83,ab46c124-a7b8-41d0-803e-5ba2f90d44a9,-3486.97,debit,bank-fee,AU00000,2023-12-25T00:28:33Z
transaction,f3e5f784-7b35-437d-b1b0-b09862adcea2,posted,AGL RETAIL ENERGY LTD (GAS),-3020.59,af366fac-3967-4e8e-a574-4e5a3798982c,-6507.56,debit,bank-fee,AU00000,2024-03-17T04:18:36Z
transaction,49df8f3c-8aab-41bb-acc7-42149166c83c,posted,Movie Ticket Purchase,-1134.42,d6dcbb2e-ab38-493e-95d9-6b829e9d8354,-7641.98,debit,bank-fee,AU00000,2023-09-16T06:23:41Z
transaction,3905e4ae-bf42-43e9-a0be-76fa5706ec19,posted,Transfer Platnm Homeloan 346454,-4662.79,88abeea6-0f7f-4df0-9494-889fc8c5024c,-12304.77,debit,bank-fee,AU00000,2023-09-24T16:35:03Z
transaction,d05e6746-15c2-4586-88a5-0dca07614cb3,posted,Car Maintenance Expense,-4996.64,791cc1ab-4cfa-4d84-9fc6-7f23641964b0,-17301.41,debit,payment,AU00000,2024-05-10T02:05:21Z
transaction,efee7b0b-125d-45d7-8e33-2a77b3a38cd2,posted,Hair Salon Appointment,-3350.72,bc9a6911-e206-4209-b944-5d84aae4de23,-20652.13,debit,payment,AU00000,2023-05-18T12:36:05Z
transaction,ed3366c1-f52d-46cf-8b80-00e63de787cc,posted,AGL RETAIL ENERGY LTD (GAS),-2394.01,65452bce-d0a1-4b20-973d-ac5fa84a7fdc,6719.99,debit,bank-fee,AU00000,2023-10-10T07:40:04Z
transaction,982e034b-1e57-4f86-9356-d4a0442841ee,posted,Manly Maths Tutor Wages,-1151.29,28f910ef-8d39-4483-84c2-49434ae064db,5568.7,debit,payment,AU00000,2023-09-16T11:43:48Z
transaction,36716bfb-22bf-4d56-a577-e628105e8ae3,posted,Gym Membership Fee,-830.95,b1a8357d-8bf0-4f88-a619-74810b01605d,4737.75,debit,bank-fee,AU00000,2023-08-08T10:41:21Z
transaction,bbed1937-7e55-45d4-a99d-3b077b950c49,posted,TFR Acc14000 TO 12389,-2072.75,3f95439c-76f0-49a2-a5a7-7dd3e120ede6,2665.0,debit,cash-withdrawal,AU00000,2023-10-23T23:57:17Z
transaction,6d80fc87-1d5f-4a2a-8648-0abb334bf0f5,posted,Music Streaming Subscription,-141.03,a64e6461-1dc2-4b17-a029-011a2279fe9b,2523.97,debit,bank-fee,AU00000,2024-02-05T14:00:25Z
transaction,b855419a-8e2b-497b-8bae-79845b7af53a,posted,Netflix Subscription,-2922.97,f9f674c2-4f34-4a9b-9280-286bc1b3333f,-399.0,debit,payment,AU00000,2023-11-06T21:02:56Z
transaction,01571cac-8f6e-40d5-9db9-ff58df4396f5,posted,Public Transport Fare,-1782.35,6523474a-5dd7-42dc-a109-9f74c3f03bc5,-2181.35,debit,cash-withdrawal,AU00000,2024-02-03T17:16:49Z
transaction,cf9e4f1f-1414-4083-9998-c35329da0d89,posted,Music Streaming Subscription,-4914.35,b4b7b1d3-9c08-4aac-98d4-dd8e505d8586,-7095.7,debit,cash-withdrawal,AU00000,2024-03-28T11:09:51Z
transaction,0e4c0d1a-7f2b-4f64-8c6d-bd780874fe60,posted,Non Hooli ATM Withdrawal Fee,-2177.32,24060991-bcd9-4358-87f1-a2354472ac95,-9273.02,debit,cash-withdrawal,AU00000,2023-09-19T06:22:25Z
transaction,624ab0e1-efae-4a0e-a31e-4343853478b1,posted,Wdl ATM WESTPAC IGA BALGOWLAH BALGOWL AU,-3219.76,d6d53c04-7ec9-4595-bb63-015dce91e67d,-12492.78,debit,cash-withdrawal,AU00000,2023-12-08T14:20:58Z
transaction,c900fe90-3737-46db-a80f-a373f0c534a6,posted,TFR Acc14000 TO 12389,-2612.82,d5e7442c-17f5-4223-a629-50dc5f83e207,12333.84,debit,bank-fee,AU00000,2023-10-27T15:43:29Z
transaction,8be3d263-84c8-4920-a3d6-62206d6175db,posted,AGL RETAIL ENERGY LTD (GAS),-1700.13,a4109fca-9afd-43f9-9924-05f4495b074c,10633.71,debit,payment,AU00000,2023-08-16T11:05:41Z
transaction,dfb3bc94-cd3c-4f65-a4f3-e61779d7ccba,posted,Mobile Phone Bill Payment,-2500.86,21df988f-0c61-448f-983f-0a048f035f75,8132.85,debit,bank-fee,AU00000,2023-08-01T07:06:23Z
transaction,7b4c07e3-2c6e-414c-b1d4-0d20fc71af63,posted,Gym Membership Fee,-3911.91,0a01b947-8d06-4c81-af9a-ae67253b4f70,4220.94,debit,bank-fee,AU00000,2023-06-11T10:42:57Z
transaction,d1be0547-0678-4959-9781-55e19314462f,posted,Home Improvement Store Purchase,-2746.94,7dbacd1b-5cc8-423a-9a31-f9cf3d80cada,1474.0,debit,cash-withdrawal,AU00000,2024-01-05T09:35:19Z
transaction,df8c82d3-2422-4839-b26f-45d6a7c45174,posted,Hair Salon Appointment,-4687.4,1891e08b-66ba-45f9-9b4e-ed49771b5b97,-3213.4,debit,bank-fee,AU00000,2024-02-07T07:39:01Z
transaction,65eb67d2-e336-4d5d-8b52-d0317dd14365,posted,Public Transport Fare,-344.16,c7cfb223-92ae-4c6b-83c6-abfd087e3d52,-3557.56,debit,cash-withdrawal,AU00000,2023-07-25T22:21:25Z
transaction,a205c0b1-0ba4-4151-a303-e1feb1aaee9f,posted,Car Maintenance Expense,-37.84,83595e45-a9cb-4cf6-a020-c7ae3d1d7f27,-3595.4,debit,cash-withdrawal,AU00000,2023-12-13T11:16:50Z
transaction,fa61737c-1f0e-42cb-860b-9621a94450d7,posted,TFR Acc14000 TO 12389,-4896.41,c8398937-03a3-4edc-9d8c-e2aa47e5feaf,-8491.81,debit,bank-fee,AU00000,2023-12-20T08:42:30Z
transaction,29824ffb-f267-4693-ac78-ff2542b70ff4,posted,Manly Maths Tutor Wages,-2653.43,2b0a8fd0-ccbb-42b3-b085-03dbb051dd2e,-11145.24,debit,bank-fee,AU00000,2023-05-19T18:02:54Z
transaction,de4ed3f1-5e2c-43d8-934e-12d0b99db7e5,posted,Restaurant Dinner,-1269.06,ea08922f-a4b3-4ea4-b0d3-28cde1498e1a,9248.13,debit,cash-withdrawal,AU00000,2023-07-28T00:53:41Z
transaction,6326b084-dfc3-4b9b-af9d-1d212804d828,posted,Bookstore Purchase,-3674.15,707ede0b-2f1e-4a65-b957-3d22db7070f9,5573.98,debit,bank-fee,AU00000,2023-05-16T23:03:30Z
transaction,9de1ac37-87ad-489c-8e8c-4b02cd788885,posted,Gasoline Purchase,-4864.28,8d9f3ea6-7be7-4b13-83f1-43e7977f5c2f,709.7,debit,payment,AU00000,2024-05-08T14:00:09Z
transaction,8fc9d817-81ef-4101-ab4f-3c6c9b165961,posted,Wdl ATM WESTPAC IGA BALGOWLAH BALGOWL AU,-241.14,f71bc9a3-dc5f-4b6b-96f5-8f5db581d271,468.56,debit,bank-fee,AU00000,2023-11-18T07:39:18Z
transaction,adb8549e-6237-4491-8b3b-b4d6df0d58eb,posted,AGL RETAIL ENERGY LTD (GAS),-2776.65,4fb9914a-02d8-4556-a567-602c1661de3a,-2308.09,debit,bank-fee,AU00000,2024-01-12T10:38:46Z
transaction,4e49bc02-2e49-4dcb-9669-027327735870,posted,Hair Salon Appointment,-3210.34,cbda2360-f84f-4e8c-be06-365a620c5bce,-5518.43,debit,bank-fee,AU00000,2023-12-12T10:21:29Z
transaction,a9c64f61-8510-4879-9688-cba9b7fffb21,posted,Movie Ticket Purchase,-3494.94,7e1ce28b-1bee-498f-aa27-6d2efc58a58e,-9013.37,debit,cash-withdrawal,AU00000,2023-12-09T14:41:34Z
transaction,a7fc85c6-0595-4068-878f-d7a61f2fd2a5,posted,Mobile Phone Bill Payment,-3552.17,13604ca1-2b03-47b7-8335-7933f59a2921,-12565.54,debit,bank-fee,AU00000,2023-12-01T20:18:22Z
transaction,22721f42-e9db-4e98-aa07-abd8be4b5e12,posted,Movie Ticket Purchase,-1238.66,53a06db3-0bf0-4602-8a17-29c53dbd97c1,-13804.2,debit,bank-fee,AU00000,2023-12-10T23:09:39Z
transaction,9872b0c3-56ab-45d1-a872-e687f996f961,posted,Wdl ATM WESTPAC IGA BALGOWLAH BALGOWL AU,-235.37,d5d5f055-36e1-42bb-a09b-4b8ad30650a9,-14039.57,debit,cash-withdrawal,AU00000,2023-12-21T18:17:57Z
transaction,32ce2e54-458c-4a1c-8f1b-a00e96d97a30,posted,Bookstore Purchase,-4535.31,a85ad504-289e-43f9-8806-d1e1f707393d,8458.99,debit,cash-withdrawal,AU00000,2024-03-08T21:11:16Z
transaction,0802a7db-9fc7-44fb-afca-7ee94f5bd549,posted,Electricity Bill Payment,-73.21,40481f97-4929-481b-b2f7-1be43044a5fd,8385.78,debit,cash-withdrawal,AU00000,2023-07-16T00:34:28Z
transaction,9674b076-b029-440d-8ff5-e2dcee5c6c19,posted,Online Gaming Purchase,-4693.55,9d4c3e0d-1e30-456d-8c19-00e1c79b612f,3692.23,debit,cash-withdrawal,AU00000,2024-01-25T11:32:56Z
transaction,8778d362-9f7a-4b43-ab61-e910e33b1485,posted,Wdl ATM WESTPAC IGA BALGOWLAH BALGOWL AU,-2295.72,e00343cf-c1af-426a-98a3-8d1406267583,1396.51,debit,bank-fee,AU00000,2024-03-21T03:38:00Z
transaction,da777c97-d4e3-4ba9-ae50-2c52338345f2,posted,Online Gaming Purchase,-3198.37,55a68bf9-2b9e-427c-a836-e4a008d0eb25,-1801.86,debit,bank-fee,AU00000,2023-12-10T03:10:24Z
transaction,b8654699-cec3-4190-b544-b65192dd134d,posted,Restaurant Dinner,-2369.31,9f3166a4-fe51-4cfb-b351-b2a92af52cd2,-4171.17,debit,bank-fee,AU00000,2023-09-20T12:58:28Z
transaction,48df1833-17a4-43c7-94d4-5bb6ef5f8cc2,posted,Pharmacy Purchase,-4014.35,2f98abe6-0ac5-4bbc-a413-fa8160126a08,-8185.52,debit,cash-withdrawal,AU00000,2023-11-27T12:29:01Z
transaction,bbac17c3-42dc-4212-8f5d-19ac14200f3f,posted,Amazon Online Shopping,-1778.25,1aab42a8-38c6-4929-bf29-c615524e38d2,-9963.77,debit,payment,AU00000,2023-11-04T00:04:32Z
transaction,d9274606-c610-433d-9712-cba06bb950d6,posted,TFR Acc14000 TO 12389,-3910.24,578b6546-0f72-4fbf-851e-92bb5cd0a536,-13874.01,debit,cash-withdrawal,AU00000,2023-10-19T19:14:18Z
transaction,2b6e1715-948f-4c1f-8ac1-7c364f105376,posted,Gasoline Purchase,-1385.7,8bc6d0f7-0a3b-40cb-a5cf-70246c5054d0,-15259.71,debit,bank-fee,AU00000,2023-06-10T00:53:47Z
transaction,15e550d8-d219-4440-8144-63b086ea15ff,posted,Car Maintenance Expense,-2901.91,8b337d69-fde2-42d8-8b37-6fa4c28f11e6,10403.92,debit,cash-withdrawal,AU00000,2024-03-07T02:01:49Z
transaction,b77e926d-a905-4069-8364-96719ae0ad2d,posted,Public Transport Fare,-1975.86,68e6de7c-ad3a-447b-a02b-418b09a1ae37,8428.06,debit,cash-withdrawal,AU00000,2023-11-06T14:59:32Z
transaction,7a25899d-3971-4e44-ac71-75308091fbda,posted,Movie Ticket Purchase,-289.92,d899d2f9-e7cb-4c0e-9760-def70b1ca913,8138.14,debit,payment,AU00000,2024-01-25T23:47:34Z
transaction,285319e3-30c7-4803-9d5b-70b98023eaff,posted,Music Streaming Subscription,-3616.1,65a42182-6146-4b09-99ed-8041ad6bc795,4522.04,debit,bank-fee,AU00000,2023-06-02T02:32:53Z
transaction,7ac74fd3-32b4-4dc5-914e-d416fb5764a3,posted,Gasoline Purchase,-4486.35,def1e5c2-c16f-457a-b66f-269312d16ef4,35.69,debit,bank-fee,AU00000,2023-12-07T13:08:54Z
transaction,5ed85540-be96-480e-a4fa-0752c47dbc66,posted,Pharmacy Purchase,-4391.5,36e5800c-8690-4769-835d-0c38947ec653,-4355.81,debit,payment,AU00000,2023-07-16T00:39:50Z
transaction,c1bb3cbe-08ce-48b8-8118-4bb51005fdaf,posted,Netflix Subscription,-805.75,e9c2952b-6ce9-4514-93a8-440340ac2f53,-5161.56,debit,cash-withdrawal,AU00000,2023-11-09T15:50:31Z
transaction,091e6283-a000-4034-a8d2-5737895a3c46,posted,Non Hooli ATM Withdrawal Fee,-2476.02,6514dd2c-0ad9-4f04-ad30-279e5ca97bf0,-7637.58,debit,bank-fee,AU00000,2024-05-02T05:25:18Z
transaction,5efa93b9-dfc2-420d-ab0d-7fc5cfde592b,posted,Movie Ticket Purchase,-1581.21,02f3f546-6bf7-4b53-a6be-d818527b7b01,-9218.79,debit,cash-withdrawal,AU00000,2024-01-23T10:39:11Z
transaction,d91b2cfc-3402-49a5-aa6c-3c3b196d3870,posted,Home Improvement Store Purchase,-4566.89,5cbefe54-2aab-4bac-906d-d6872a1935d4,-13785.68,debit,bank-fee,AU00000,2024-01-06T22:26:20Z
transaction,3b227174-0a55-44dd-970c-de4aa76d79db,posted,Transfer Platnm Homeloan 346454,-829.59,97f33296-6027-4f0b-8157-77390a51ddc2,5594.66,debit,bank-fee,AU00000,2023-08-22T07:34:57Z
transaction,ad5334a2-aa23-4a4d-9d12-de2571d937c5,posted,Netflix Subscription,-2662.8,b26393fa-616f-4510-bef9-19007add021a,2931.86,debit,payment,AU00000,2023-06-11T14:37:13Z
transaction,4b3e250b-5933-4b6a-a682-be0b88edf6e3,posted,Restaurant Dinner,-2627.84,5f606703-6518-4e99-ad68-0a1e0e053674,304.02,debit,payment,AU00000,2024-01-27T06:30:36Z
transaction,93ed93a6-5bac-4a3b-a46c-7d0a8cc19d8e,posted,Payroll WFRMS 15439393,11650.39,c4e505b9-ac37-4068-8c05-55a2fad0b223,11954.41,credit,transfer,AU00000,2023-10-30T17:07:29Z
transaction,34f680a7-d539-4d69-99b7-cbbe416eee3d,posted,Electricity Bill Payment,-1411.69,c5838075-68c6-4f4f-819e-7ce950936b2e,10542.72,debit,payment,AU00000,2023-10-18T05:38:24Z
transaction,6341f201-8178-4f53-bc64-687c9d68a56c,posted,Coffee Shop Purchase,-3843.32,cf2bfd69-a5da-4eea-8dd1-26da43b074df,6699.4,debit,payment,AU00000,2023-08-28T13:17:44Z
transaction,47c6762b-9303-4e7e-8d9f-807ef7a3ac06,posted,Electricity Bill Payment,-1164.28,cd4e4cfb-da48-404f-b028-86e7994c80ba,5535.12,debit,bank-fee,AU00000,2024-04-06T20:25:48Z
transaction,14d179f0-0e7c-4f47-9f61-ce7542ec34c8,posted,Pharmacy Purchase,-2464.8,495d3603-c9d9-4409-879c-35db3a93ceb9,3070.32,debit,bank-fee,AU00000,2024-02-20T10:53:52Z
transaction,0c6b7a01-d846-4947-82bf-d508ea73e6b2,posted,AGL RETAIL ENERGY LTD (GAS),-2482.97,7b4787be-61a6-41d9-ae2c-1d81cf3d3548,587.35,debit,cash-withdrawal,AU00000,2024-03-23T19:29:52Z
transaction,d0058828-61d7-4181-8f45-5b4849fafdb1,posted,TRANSFER TO JOANNA SMITH CAMPING,-4372.09,84f3f7f4-2489-4d43-afad-d4aaed39abc4,-3784.74,debit,cash-withdrawal,AU00000,2023-12-23T19:18:51Z
transaction,ce871e6e-a113-431d-acfb-29945c34b3f7,posted,Coffee Shop Purchase,-344.94,53642b82-ce07-4d6c-963b-712441d4e7cc,15394.75,debit,cash-withdrawal,AU00000,2024-05-02T00:42:34Z
transaction,e1aeac37-018f-440c-a469-1733643b9310,posted,Bookstore Purchase,-3787.54,8f5c7b47-daf5-4dd0-a8b8-08d78328d815,11607.21,debit,bank-fee,AU00000,2024-04-19T23:06:52Z
transaction,2f718e43-67c8-4532-9e09-060f9dcd7f26,posted,Pharmacy Purchase,-3419.37,6ff1ec6c-dda4-4cb0-932a-dee3f0e15c8a,8187.84,debit,payment,AU00000,2023-06-08T01:53:53Z
transaction,ec1d068e-124a-4276-a615-aeb66287eb35,posted,Coffee Shop Purchase,-2633.67,8b96fd07-d566-40b0-9b4b-564a2ab85b99,5554.17,debit,cash-withdrawal,AU00000,2023-08-22T06:26:54Z
transaction,ccc5b261-208e-413d-b8c8-da736bc47564,posted,Restaurant Dinner,-395.58,b2ad3fb9-0532-4691-b970-42736daaf4be,5158.59,debit,payment,AU00000,2023-12-15T21:32:45Z
transaction,ffc839fb-5438-4c6b-9dcc-4ffa9f58846f,posted,Online Gaming Purchase,-1518.84,759e6628-8292-4c25-88f9-bf2431354603,3639.75,debit,cash-withdrawal,AU00000,2023-06-20T21:27:56Z
transaction,38025140-75c3-4fc8-8a8c-16cb9563b04b,posted,Non Hooli ATM Withdrawal Fee,-2284.59,fc6c07e0-eea1-46fc-95ea-e23d891cdd46,1355.16,debit,payment,AU00000,2023-12-16T11:25:07Z
transaction,5e2fd4ac-e1bb-40f9-9359-6b34044bd35c,posted,Mobile Phone Bill Payment,-3920.68,e5e4035b-3693-4944-8db6-c3049d01319a,-2565.52,debit,payment,AU00000,2024-01-07T18:37:55Z
transaction,6f23d952-7f3d-4f92-b1e1-040bcb8964bf,posted,Pharmacy Purchase,-1234.98,85f09a87-5b58-4c55-8a07-f67b2e2d25e6,-3800.5,debit,cash-withdrawal,AU00000,2023-07-09T15:16:33Z
transaction,aa72d6f2-0843-4655-9839-7cb25bbecaa8,posted,Wdl ATM WESTPAC IGA BALGOWLAH BALGOWL AU,-3544.97,3a6dbd97-e3e4-45ba-bd36-86692937d0f4,-7345.47,debit,cash-withdrawal,AU00000,2023-10-18T03:06:07Z
transaction,22e889af-cca6-41fb-be4f-7f1ad1d3bef7,posted,Non Hooli ATM Withdrawal Fee,-2043.89,eb4c1a83-b862-4360-808b-158eb1d502ee,6958.3,debit,payment,AU00000,2024-05-03T07:08:50Z
transaction,6d779cb2-d132-4ce8-bc33-d1064dfaf371,posted,Electricity Bill Payment,-3300.63,8ec316dc-331a-4449-912f-39529fb68eef,3657.67,debit,payment,AU00000,2024-03-04T16:33:06Z
transaction,3f5cb257-bf1c-4600-9389-10a6028512e9,posted,Non Hooli ATM Withdrawal Fee,-2662.57,cfd4a6bf-6b0a-4e9d-a5f8-805dc576c9dc,995.1,debit,cash-withdrawal,AU00000,2023-10-17T02:06:17Z
transaction,282b0aeb-3e2b-4113-a6cd-d2ac93ced5df,posted,Transfer Platnm Homeloan 346454,-4572.43,4fb5f185-ac6d-40ac-8e09-2e0f30b7cc6f,-3577.33,debit,payment,AU00000,2023-11-01T01:57:43Z
transaction,6cf399d5-eb43-4aa4-abef-7a3baf9a1c06,posted,Clothing Store Purchase,-3654.46,67958295-ad22-4745-ad0e-c080b8b7dd8f,-7231.79,debit,bank-fee,AU00000,2024-03-13T06:43:48Z
transaction,7918eb8d-45da-4393-9672-daf19b070dac,posted,Music Streaming Subscription,-3704.32,8d048236-018d-4dd9-af3d-cbf57b3f315f,-10936.11,debit,cash-withdrawal,AU00000,2023-06-15T07:07:33Z
transaction,5dc8625f-51eb-4313-8272-a68d28c10aee,posted,CTRLINK CARERS Ref: 998R6789201610974V,-4993.24,8e706179-d80a-4ec4-840c-26a524859250,-15929.35,debit,payment,AU00000,2024-01-17T11:31:57Z
transaction,8e6299bf-ad40-478c-98c4-428cd06caa44,posted,Travel Agency Booking,-3839.12,8b0a0ba6-c9ef-4b38-9bdf-2d844ee5ebdf,-19768.47,debit,cash-withdrawal,AU00000,2024-04-16T12:58:35Z
transaction,05d43d06-123e-4da4-b722-71ec8ed07c68,posted,Coffee Shop Purchase,-1811.07,e21e9f81-db11-416a-bace-dcde5e92f9a2,-21579.54,debit,payment,AU00000,2023-06-06T09:54:57Z
transaction,b6e40ca4-1562-443e-9a8b-eb40e0a304e6,posted,Car Maintenance Expense,-272.22,0c81be2d-7828-4c4e-8b7e-f71ad3e60b69,-21851.76,debit,cash-withdrawal,AU00000,2023-07-12T19:17:17Z
transaction,c7436885-9c27-4352-b0ea-72b2ad6c4a3f,posted,Coffee Shop Purchase,-3019.5,e0958e0e-67e6-4096-b077-d8c4614ec5da,14275.93,debit,payment,AU00000,2023-12-29T10:28:57Z
transaction,7f34dc0a-01f3-4413-94e9-5b9e2ad9dfb4,posted,Gym Membership Fee,-3533.1,c9272d27-26da-4260-8a98-c4e65a7ad8f4,10742.83,debit,cash-withdrawal,AU00000,2024-01-16T05:23:50Z
transaction,92c7b205-6ff1-4d03-8529-816407ac2941,posted,Pharmacy Purchase,-328.83,c0d3d167-2c0f-4fb6-b803-e9ad2c45f772,10414.0,debit,cash-withdrawal,AU00000,2023-12-05T14:50:58Z
transaction,eb03317c-0056-41cf-8347-49731e6a9ea0,posted,Public Transport Fare,-1366.5,109d2f32-f405-4211-b366-f591ac99f6c3,9047.5,debit,cash-withdrawal,AU00000,2024-02-05T00:48:45Z
transaction,394194bf-3689-4d82-be3c-3afd1c1f1be0,posted,Netflix Subscription,-1161.58,0a084050-a58a-4145-8cfd-dd64fd3cb788,7885.92,debit,cash-withdrawal,AU00000,2023-08-10T23:14:04Z
transaction,cb729e34-4b6b-4b08-9d78-f4316ddfc612,posted,Coffee Shop Purchase,-3664.83,968b187a-4108-4303-9c4a-e622b2afe400,4221.09,debit,bank-fee,AU00000,2024-02-13T20:00:43Z
transaction,9cb30f9f-87bd-4db0-ba2e-a375c86ed3c9,posted,Amazon Online Shopping,-1758.74,a69c3ec3-d15d-4f41-a84c-053ecc60ee0d,2462.35,debit,payment,AU00000,2023-09-22T02:39:43Z
transaction,3b87a2c6-6541-43b6-aaf6-d46638fce638,posted,Pharmacy Purchase,-2410.37,f32e936a-9050-4c8d-bf3a-731a3aec5953,51.98,debit,payment,AU00000,2024-03-10T22:26:15Z
transaction,33043d61-8daa-449e-a521-c8cc228cea7d,posted,Mobile Phone Bill Payment,-4985.3,0f2535c6-620f-4a6e-be99-5f4f66c23161,-4933.32,debit,bank-fee,AU00000,2023-12-15T14:50:39Z
transaction,60b2a279-e2d1-4f79-8d22-40db255cac89,posted,Public Transport Fare,-4868.58,96fc9237-db3a-4b51-b4ce-33f1510efd0b,-9801.9,debit,cash-withdrawal,AU00000,2023-10-20T19:38:03Z
transaction,3db1b050-8aab-4067-b2d3-3b5eb5339d95,posted,Bookstore Purchase,-3727.12,287275e3-aa04-47f9-bf15-17a92c468503,12597.56,debit,payment,AU00000,2023-11-20T19:28:23Z
transaction,3e9efc05-bb99-42fb-9b70-6f3c2e419579,posted,Music Streaming Subscription,-2536.45,84b6ddff-6e0c-4f30-a6ca-82ec89371074,10061.11,debit,payment,AU00000,2023-11-14T00:44:25Z
transaction,16714d6c-ce24-485f-b9f8-7a11e218cbd9,posted,Electricity Bill Payment,-1823.1,040d22d0-7a27-4ea5-932d-7b9488d5efee,8238.01,debit,cash-withdrawal,AU00000,2023-08-01T01:25:56Z
transaction,60633a01-39e2-4944-b330-c5812a570293,posted,Pharmacy Purchase,-1711.07,9e862edd-cd15-40c9-9a22-19474e5ef160,6526.94,debit,payment,AU00000,2024-04-13T08:38:44Z
transaction,13591998-2d51-45a6-8c05-e840a0715d1b,posted,Electricity Bill Payment,-1097.17,984314eb-1197-432e-a87f-3eb80941fe93,5429.77,debit,payment,AU00000,2023-09-01T08:50:25Z
transaction,61106fed-c5cf-42af-be53-55c211953aeb,posted,AGL RETAIL ENERGY LTD (GAS),-4391.25,c40228c4-506c-42b4-ae28-be22c6ee25d5,1038.52,debit,payment,AU00000,2023-12-23T09:20:52Z
transaction,0f178fe4-68d6-4110-a36b-84a224cf2ccd,posted,TFR Acc14000 TO 12389,-1166.32,f5023e08-9664-4de5-b5d8-b3d024ff2de3,-127.8,debit,cash-withdrawal,AU00000,2023-12-05T18:59:38Z
transaction,7bc7a258-6997-4cc1-9d92-e895c426d9fa,posted,Online Gaming Purchase,-1636.84,01fc7dd8-3435-477d-b4f3-11f53af129ca,-1764.64,debit,cash-withdrawal,AU00000,2023-10-05T08:15:22Z
transaction,0089b87f-1a19-4d81-b5c3-ab37e2dc3cff,posted,Manly Maths Tutor Wages,-1697.95,66354775-162e-4feb-8284-62814a81afe1,-3462.59,debit,payment,AU00000,2023-11-12T05:27:25Z
transaction,9aa6a34a-e571-4feb-a160-d69b3efb0040,posted,Gym Membership Fee,-2311.83,86f7fde0-b9a3-4f28-a5c5-ac2d3b1dee3a,-5774.42,debit,payment,AU00000,2023-07-30T17:39:40Z
transaction,7b823206-1bcf-43fe-bbc9-9a6e945db92f,posted,AGL RETAIL ENERGY LTD (GAS),-2629.8,2d0d6704-e01f-40ef-a5c3-01468996d8ff,13787.59,debit,cash-withdrawal,AU00000,2023-07-11T04:32:28Z
transaction,05782d46-4903-4cfc-a81c-30a124c7f41e,posted,Amazon Online Shopping,-2627.45,2a1b83eb-7523-4ded-a826-edc5161eee7d,11160.14,debit,payment,AU00000,2023-05-30T04:03:18Z
transaction,b3aa10c5-a13a-42d0-8fc0-e33780009d8d,posted,Amazon Online Shopping,-2021.63,4f9b68c8-7db2-43b2-930a-0dd017abf384,9138.51,debit,bank-fee,AU00000,2024-04-09T12:35:05Z
transaction,56eded4c-6598-40b5-9a25-016e92971fc1,posted,Home Improvement Store Purchase,-595.62,75396185-13e9-4fca-b430-dc4460096a1b,8542.89,debit,cash-withdrawal,AU00000,2023-10-10T06:32:02Z
transaction,1a071cb8-35d7-4a56-85c2-7bca91598a9e,posted,Bookstore Purchase,-2813.26,906d00bd-d9c7-4aeb-ada1-73f2c213e777,5729.63,debit,payment,AU00000,2023-09-19T10:33:28Z
transaction,f7dcda2c-ea06-4b64-b10c-5572927b5a37,posted,Car Maintenance Expense,-2050.12,eddaf7db-4858-4879-98da-0dffc81fa89e,3679.51,debit,bank-fee,AU00000,2024-04-09T01:27:16Z
transaction,dc43c98c-cd57-4138-a7cc-727dc777a388,posted,Coffee Shop Purchase,-3327.05,0813c71a-55b7-46b1-b535-60eb4ce199cb,352.46,debit,cash-withdrawal,AU00000,2023-09-14T20:08:47Z
transaction,275752a5-e619-4461-98f6-00f6b8adf6cf,posted,Manly Maths Tutor Wages,-4879.8,cdaef0ce-94a3-4112-bce7-6104a5db1611,-4527.34,debit,payment,AU00000,2023-07-16T07:49:23Z
transaction,43b50a20-3fe3-4108-8a72-8edd2d2d9185,posted,Public Transport Fare,-3550.66,8a789606-e451-4808-a390-6f246735bdcd,-8078.0,debit,payment,AU00000,2024-02-16T06:37:36Z
transaction,19cbeae0-8afa-47d6-9081-7f604d505b3a,posted,Wdl ATM WESTPAC IGA BALGOWLAH BALGOWL AU,-4874.17,f98e090c-691c-4e7d-8d4b-5cacec2b4f19,-12952.17,debit,cash-withdrawal,AU00000,2024-02-28T01:48:21Z
transaction,b6c6c83d-c1fe-41ed-a8c6-43c3e2f1b157,posted,Mobile Phone Bill Payment,-903.0,8070e9c9-54ab-49b7-8a68-a9b9d8f9056e,12109.24,debit,payment,AU00000,2024-04-18T22:41:49Z
transaction,527ed93b-0be7-4315-ab2b-c7e9cec94616,posted,Payroll WFRMS 15439393,10870.33,5c95a99f-6581-46f7-b18c-37520e025489,22979.57,credit,transfer,AU00000,2023-11-23T00:30:18Z
transaction,b1a8114b-c00e-470c-be59-eec48d80df13,posted,Public Transport Fare,-4028.93,bfb65729-d440-4d35-9db4-ce3e99b8f356,18950.64,debit,bank-fee,AU00000,2024-05-09T17:04:08Z
transaction,a23f781c-1fb5-41cf-9326-6679f4006e4f,posted,Public Transport Fare,-2342.32,d35ae2d1-d4f0-4043-be07-7086062c595b,16608.32,debit,cash-withdrawal,AU00000,2023-12-08T09:01:04Z
transaction,a984b125-322d-4be9-b67f-652d404939c8,posted,Electricity Bill Payment,-1366.19,4c86debb-938a-4436-9c08-489e2c7366aa,15242.13,debit,cash-withdrawal,AU00000,2023-09-09T07:47:22Z
transaction,49cdf041-9c84-4d69-bbc4-b98b2805a28a,posted,Restaurant Dinner,-4341.52,72d6dc39-596a-4de7-9a98-294ec2425d60,10900.61,debit,payment,AU00000,2023-12-15T06:17:37Z
transaction,44ce54e1-42a0-41e3-9914-6934b07dc100,posted,Electricity Bill Payment,-1071.42,c7337f7d-c41a-4927-8785-425343e6ce69,9829.19,debit,payment,AU00000,2023-09-11T07:58:43Z
transaction,ec119102-7b44-4e2a-a153-f7b0d487f0f9,posted,Music Streaming Subscription,-4232.46,2264c5fa-47cb-4fb3-92f1-0b6fbd6f1dde,5596.73,debit,payment,AU00000,2024-03-02T11:21:27Z
transaction,8d8fa276-6178-45d5-953d-4c773b7e09e6,posted,Gasoline Purchase,-2154.6,ccf73cc2-ef58-42d1-8019-0fd1249439ed,3442.13,debit,bank-fee,AU00000,2024-01-30T09:38:53Z
transaction,f613ecd2-9543-4f94-86e9-40bef4263f4e,posted,Non Hooli ATM Withdrawal Fee,-2673.65,6c43a50b-6b1f-47d8-ac17-914339098b43,768.48,debit,bank-fee,AU00000,2024-04-05T16:02:37Z
transaction,9c23571e-26e8-44dc-a50a-81b9ab7a7d8c,posted,Netflix Subscription,-4011.19,e6783c99-8eb6-4d14-b235-af950ce2fa49,8788.55,debit,bank-fee,AU00000,2024-01-02T17:13:07Z
transaction,2f332070-3145-4608-ad8e-90c0db525328,posted,Public Transport Fare,-3290.16,cac48640-3307-4bb9-b194-476e1231fb89,5498.39,debit,bank-fee,AU00000,2023-05-16T14:46:54Z
transaction,f31837bf-f1b2-4af9-8306-5ecdd55c4641,posted,Manly Maths Tutor Wages,-1875.33,25cc1baf-910d-4a8b-b936-fc8af2e8695b,3623.06,debit,payment,AU00000,2023-10-25T16:50:23Z
transaction,c6a7dcd2-c89a-4646-9da8-93543c56308e,posted,AGL RETAIL ENERGY LTD (GAS),-2302.48,72a78d7f-cce5-4dfb-9c16-5260a5ccc903,1320.58,debit,cash-withdrawal,AU00000,2023-07-10T00:52:48Z
transaction,1ae1336e-2bdc-49b7-89fd-98142bf6ee25,posted,Car Maintenance Expense,-4294.74,6328cc85-8d82-470c-b68c-a93d40118b43,-2974.16,debit,bank-fee,AU00000,2023-07-01T00:17:04Z
transaction,38835b5d-6e35-495e-bb00-50b0e0a3a4e6,posted,Manly Maths Tutor Wages,-856.82,5d188f03-355f-43df-a011-b363418c289e,-3830.98,debit,cash-withdrawal,AU00000,2023-09-27T13:37:50Z
transaction,b32d805d-40d5-4532-acc0-de9c5ee3e608,posted,Electricity Bill Payment,-3645.47,6e070372-4800-4672-8c8f-5ee94f42495b,-7476.45,debit,cash-withdrawal,AU00000,2024-02-20T09:08:51Z
transaction,435b98df-bba4-443b-9001-c7d655bb4ca0,posted,Mobile Phone Bill Payment,-2724.47,21837656-058d-464e-a0d2-ce29808c551a,-10200.92,debit,payment,AU00000,2023-05-16T07:35:09Z
transaction,65717a6d-896d-4082-a0df-2a32621a3578,posted,AGL RETAIL ENERGY LTD (GAS),-129.58,abb6611c-25e4-49df-b08b-b6e3b6728507,-10330.5,debit,bank-fee,AU00000,2024-01-25T18:30:44Z
transaction,72969d87-118d-4af6-bf31-d5f1a874f03f,posted,Car Maintenance Expense,-3114.95,7936da92-6dab-474a-8c49-95562de82471,-13445.45,debit,payment,AU00000,2024-03-21T06:56:17Z
transaction,4c3c047c-39cd-4ee6-a78b-5d16ced76d5e,posted,Uber Ride,-2068.16,28167cf6-c433-49f9-99aa-3735dcfa1bf3,5869.46,debit,payment,AU00000,2023-09-15T13:36:56Z
transaction,f22698ed-14f4-4500-9227-cdd81bbb0c69,posted,Bookstore Purchase,-4278.27,2fbbabbc-5781-4234-b30b-0f9e71de0a72,1591.19,debit,payment,AU00000,2023-10-10T19:44:17Z
transaction,42b4ca58-fce5-4d5b-9c54-d638aac3eabd,posted,Netflix Subscription,-1716.27,3d7fa054-ec5f-4c05-88ab-b04faffc88c4,-125.08,debit,bank-fee,AU00000,2023-07-30T18:29:03Z
transaction,0843e1fa-8795-4668-bb21-7608b2bff61f,posted,TRANSFER TO JOANNA SMITH CAMPING,-2605.16,a9e09d7c-caad-4d75-a545-4acde084fd1d,-2730.24,debit,payment,AU00000,2023-10-17T18:36:24Z
transaction,a04ca052-0796-488c-a623-aee30c07ebfc,posted,Non Hooli ATM Withdrawal Fee,-4338.43,98b0f093-867d-44fd-a62c-8316ed77800a,-7068.67,debit,cash-withdrawal,AU00000,2024-01-05T15:16:36Z
transaction,7e617442-474e-4b95-8ca4-7176a11da1b3,posted,Home Improvement Store Purchase,-183.27,1bfd68cc-8e37-4b1f-8e6b-871517cb83b2,-7251.94,debit,bank-fee,AU00000,2024-03-08T11:12:35Z
transaction,137ae72a-d31b-4fca-9ff2-fc7da2bdc403,posted,Gym Membership Fee,-1663.01,f98c9495-e87c-48fa-ad14-3d044bbd21aa,-8914.95,debit,cash-withdrawal,AU00000,2023-07-22T11:43:37Z
transaction,4ef926c2-4b1c-4889-a3da-f99ff4bfff40,posted,Non Hooli ATM Withdrawal Fee,-3208.35,1da263b7-2806-48f6-b01f-02ca5d3ffcbe,-12123.3,debit,bank-fee,AU00000,2024-03-02T03:54:50Z
transaction,890a530e-791c-4f9b-9953-6dd69ee119ac,posted,Non Hooli ATM Withdrawal Fee,-1191.55,a7f83d25-adca-4aef-9e63-b20b001c2c1f,-13314.85,debit,payment,AU00000,2023-07-02T10:27:17Z
transaction,a81f4f4e-2f75-43b3-86af-d465660978da,posted,Clothing Store Purchase,-635.71,e457f7a2-eed6-4897-a070-c721e813e96a,-13950.56,debit,bank-fee,AU00000,2023-07-17T21:28:33Z
transaction,21d56d6b-fa9e-4145-996d-77e6ef206072,posted,Car Maintenance Expense,-4362.89,d4f3eee2-5b6b-4e4e-8cd6-8878f5a203db,7498.6,debit,payment,AU00000,2024-04-09T08:10:53Z
transaction,b5e49105-00f6-4374-8484-2441c130d2ba,posted,Mobile Phone Bill Payment,-372.52,aa9f80d6-399b-4f9d-974c-74d34aa0a359,7126.08,debit,cash-withdrawal,AU00000,2023-12-20T17:47:14Z
transaction,21423685-5588-4d63-b41e-a99cee343fef,posted,AGL RETAIL ENERGY LTD (GAS),-4344.52,ea1d7864-14b9-4d29-b2e8-8279aa239d0b,2781.56,debit,payment,AU00000,2024-05-01T23:59:52Z
transaction,80ce10d2-90e9-4c4d-a8a2-3c39472e8cc6,posted,Amazon Online Shopping,-2740.3,2c473d24-08d0-4efe-a8e5-c6800fd7aeda,41.26,debit,cash-withdrawal,AU00000,2024-03-31T12:01:23Z
transaction,dd85a0ce-331b-4d43-807b-bc839da4d139,posted,Non Hooli ATM Withdrawal Fee,-752.23,a927fdac-c202-45f9-9f24-21edc05fe95c,-710.97,debit,cash-withdrawal,AU00000,2024-02-08T01:43:08Z
transaction,ba54251c-6f6e-4df5-a4b0-0ae82f9b4209,posted,Mobile Phone Bill Payment,-2320.0,bdabc8d2-1a45-4083-897c-58d3a4ede970,-3030.97,debit,payment,AU00000,2023-07-17T10:46:58Z
transaction,d5076056-590c-4957-b1c3-588f527d1fc4,posted,Restaurant Dinner,-3202.39,318868e2-67de-42bf-b481-8661a66b0cf4,-6233.36,debit,payment,AU00000,2023-11-09T07:27:09Z
transaction,71d2c1b7-2478-4732-a4f0-a01447e8550e,posted,CTRLINK CARERS Ref: 998R6789201610974V,-723.31,df66c6f2-e61c-4e6a-8d2a-f25f3290f700,-6956.67,debit,cash-withdrawal,AU00000,2023-12-15T10:04:05Z
transaction,30812f45-0c59-49ea-a432-e17b67dbac3d,posted,Pharmacy Purchase,-2637.8,c7fb1657-774b-41b4-a732-c132c1d67f7e,-9594.47,debit,cash-withdrawal,AU00000,2023-09-27T17:24:32Z
transaction,ece1b65f-95d7-4331-b6fb-de184fb2f367,posted,Non Hooli ATM Withdrawal Fee,-2172.34,f3c004bd-4b79-4dac-8cd3-dfeaa4a3f08b,-11766.81,debit,payment,AU00000,2023-10-31T04:35:30Z
transaction,5eb4bd1f-f596-4871-a618-2750578ff946,posted,Uber Ride,-4262.6,cb93c248-fb98-4a1c-a8d2-6ac14e822f66,10267.08,debit,payment,AU00000,2023-06-24T09:52:10Z
transaction,eac88abd-b729-4984-8766-99be0d1db5be,posted,Home Improvement Store Purchase,-3073.44,60a0f276-ad55-4442-883f-31fd7d0726f9,7193.64,debit,payment,AU00000,2023-08-05T14:26:52Z
transaction,d07c460b-51c1-455d-b92b-1147ba0ff744,posted,Online Gaming Purchase,-1594.98,995ee447-46e5-46c1-8f1a-dc6bae60ea9c,5598.66,debit,payment,AU00000,2023-07-07T21:48:11Z
transaction,7ab5d795-6ede-4426-9883-9738fc6462d0,posted,Bookstore Purchase,-2960.83,ff8e5b79-1e75-4c5a-bff5-2a5090ceef23,2637.83,debit,payment,AU00000,2023-11-01T02:14:17Z
transaction,123dbf15-f14e-4720-81ec-76d187e4faaa,posted,Movie Ticket Purchase,-2518.43,9095ecb9-9505-49bb-89dc-4ed99de14ac4,119.4,debit,cash-withdrawal,AU00000,2023-10-14T20:47:49Z
transaction,94ad92ef-1ac6-4ddf-bff7-4f322f255f42,posted,Amazon Online Shopping,-2636.41,5ebe46ee-418f-4b28-a576-77e68dc257d4,-2517.01,debit,bank-fee,AU00000,2023-11-18T01:02:20Z
transaction,b6be1311-5685-4d63-b0db-e4da91a877c2,posted,Public Transport Fare,-3719.71,903332ed-3967-4d16-9000-689940e5f05a,-6236.72,debit,payment,AU00000,2024-02-20T13:54:29Z
transaction,975a03b6-4af8-45ae-b92d-cf7ef5004c0f,posted,Payroll WFRMS 15439393,10291.89,525ebba6-9506-458d-953b-ce6d8f7364a7,4055.17,credit,transfer,AU00000,2024-04-04T06:09:11Z
transaction,c5f2461d-6968-4128-9934-c95839e1425c,posted,Uber Ride,-2832.15,a3a6f95d-3410-492c-b1f4-88701c59cd39,1223.02,debit,cash-withdrawal,AU00000,2024-04-16T02:29:49Z
transaction,a48aebd9-940c-4121-ab6a-820750f4fe71,posted,Transfer Platnm Homeloan 346454,-1182.27,b1e396af-2434-40bc-a4b5-3e51e58b9c91,40.75,debit,bank-fee,AU00000,2023-08-03T23:16:40Z
transaction,afe69204-0d95-4c4b-818d-fe027fe11ce7,posted,Transfer Platnm Homeloan 346454,-4176.11,c7c09e3f-67b9-49b7-9f44-cc55b84808d0,15513.97,debit,cash-withdrawal,AU00000,2023-06-14T19:15:49Z
transaction,75accdd9-45a5-4019-ba32-9a9aaa41386b,posted,Hair Salon Appointment,-3754.56,478e0b08-6bc8-4d4f-8289-84b247e08506,11759.41,debit,payment,AU00000,2023-08-08T09:51:26Z
transaction,027fba28-4187-4cf2-8dd4-3b0b9157fcd8,posted,Manly Maths Tutor Wages,-1597.48,8fdb3564-f9c0-4ebe-82b1-ade601d09c7c,10161.93,debit,cash-withdrawal,AU00000,2023-09-02T04:48:12Z
transaction,0e0ad188-d31f-45ab-afde-e7fd7de49ec9,posted,Payroll WFRMS 15439393,11411.09,d16291f1-3f94-47f2-9a92-6f1c50dc0784,21573.02,credit,transfer,AU00000,2023-07-23T13:09:03Z
transaction,5475bbfa-4c0b-4250-84c1-5fd204c0392a,posted,Netflix Subscription,-434.06,9e034a9e-92f2-4a5c-9270-7346d9b80fc3,21138.96,debit,payment,AU00000,2023-10-11T03:37:27Z
transaction,c7e40419-0340-4e79-aaae-16d4a50e4ee1,posted,Gym Membership Fee,-2909.67,37cea846-ea49-440a-a230-75c15f76bbaf,18229.29,debit,payment,AU00000,2024-03-16T10:36:54Z
transaction,9400bf1d-b0ec-4ff8-9d43-b685c0bd821a,posted,AGL RETAIL ENERGY LTD (GAS),-3906.4,a7a66886-b3d6-4f48-ad40-af80292007f6,14322.89,debit,bank-fee,AU00000,2023-11-03T01:33:11Z
transaction,9102473e-1ca6-4322-a9e0-7c5348b8da9f,posted,Travel Agency Booking,-4606.85,a1c56bdf-e154-4c4d-9653-229ddf0878fb,9716.04,debit,payment,AU00000,2024-04-10T23:50:23Z
transaction,594f47e4-d751-46a7-8200-63a1fb7d3d65,posted,Uber Ride,-2969.85,175c9763-fa22-4a5c-ab2d-a2c154f8e78b,6746.19,debit,cash-withdrawal,AU00000,2024-01-17T07:10:37Z
transaction,dd66929f-e15e-4170-8ab3-32e0c507e873,posted,Online Gaming Purchase,-656.27,c0ec1004-11f6-4ab8-8862-6b05615f6423,6089.92,debit,payment,AU00000,2023-10-15T07:10:41Z
transaction,bf9fa894-e5c1-4fef-a3cd-437b47946e3f,posted,Manly Maths Tutor Wages,-4101.99,bbc6fa55-e58c-4a9b-903c-6a72a682a100,10002.79,debit,payment,AU00000,2023-08-01T07:45:21Z
transaction,fd3812d5-020a-46d2-a52b-8ac841d06c91,posted,Coffee Shop Purchase,-1579.18,fde39c2f-8430-47af-8b93-6c46612ef746,8423.61,debit,cash-withdrawal,AU00000,2023-07-05T09:48:04Z
transaction,955c0b57-b063-4b3f-978c-e2a41857a3c2,posted,Manly Maths Tutor Wages,-2650.07,0c43ae1a-014a-4c7c-b0d2-a58ef4441c9d,5773.54,debit,bank-fee,AU00000,2023-08-28T20:03:10Z
transaction,043a7767-9b3a-4336-87ae-f6c2612fe807,posted,Mobile Phone Bill Payment,-4581.62,fa03d791-c71d-4f78-904f-ef2c66726ea6,1191.92,debit,cash-withdrawal,AU00000,2024-01-16T18:28:00Z
transaction,e045fa4b-4ccc-4bc2-b9d8-8396707c3e09,posted,Home Improvement Store Purchase,-150.65,4b51da11-c59f-4d7a-9cfc-f68174266542,1041.27,debit,bank-fee,AU00000,2024-03-31T22:39:50Z
transaction,738837f5-62d0-4764-bcb1-3c236a481d8b,posted,TFR Acc14000 TO 12389,-4205.35,4a0e4268-f8d1-4ed3-91b0-916d12afa44c,-3164.08,debit,bank-fee,AU00000,2023-05-22T07:16:11Z
transaction,701ff166-2d4b-4ef1-a6c7-74b8e4b3a412,posted,Gasoline Purchase,-2340.66,26b4f9ce-ec61-4114-9016-e25d895b26ba,-5504.74,debit,payment,AU00000,2023-07-03T13:17:47Z
transaction,d6b0af42-7415-4c95-b659-679f2b5d6c96,posted,Travel Agency Booking,-1595.87,ee49e7e7-af5c-4985-a668-8c46df0f44d8,-7100.61,debit,cash-withdrawal,AU00000,2024-03-21T00:04:59Z
transaction,428886b9-fa16-496d-bf50-a90f8ec57e07,posted,Gasoline Purchase,-2386.37,29be4238-1a53-427d-8b29-cf37ec2f76ac,-9486.98,debit,payment,AU00000,2024-01-27T10:13:10Z
transaction,3c46413a-baa0-408f-80c6-5404881448b3,posted,Transfer Platnm Homeloan 346454,-2330.52,3cacb631-fc27-49f2-ac56-e2d23fc9b4df,-11817.5,debit,payment,AU00000,2023-08-22T03:22:42Z
transaction,8ec8ada0-d03c-4a06-879a-f157e4e06c0a,posted,Netflix Subscription,-3051.92,23e53c36-f66e-4358-8178-6f942d5fe5ce,12006.1,debit,bank-fee,AU00000,2024-05-09T00:42:40Z
transaction,5c7ac91d-d6ef-4afe-bf7b-c6908cf0f389,posted,Amazon Online Shopping,-2686.23,6eefb5c6-ee0f-4a46-95fc-3785a888e80b,9319.87,debit,cash-withdrawal,AU00000,2023-08-06T21:50:32Z
transaction,bf41f29f-dbec-448e-8343-85184c169fe9,posted,Manly Maths Tutor Wages,-168.35,8f8ffb99-e850-4d53-a878-98582ec23989,9151.52,debit,payment,AU00000,2023-08-14T20:14:29Z
transaction,b775b1a0-3c5f-41fa-be16-7728e11ffda4,posted,Hair Salon Appointment,-1559.83,5668e533-6438-4c19-9b9d-f71c312c62c7,7591.69,debit,bank-fee,AU00000,2023-12-21T10:04:19Z
transaction,7762757e-10e4-4361-884b-3263c7d7237d,posted,Travel Agency Booking,-938.44,986f3516-46b8-4227-b3e4-67ce819cbe05,6653.25,debit,cash-withdrawal,AU00000,2023-05-20T13:07:14Z
transaction,39c7a0ac-8ded-43b5-99fd-f90773295746,posted,Music Streaming Subscription,-3318.85,41798540-5686-4d2c-97bd-87accc753ae8,3334.4,debit,payment,AU00000,2023-12-22T02:24:27Z
transaction,65530159-53d4-479f-a307-b20d1e87cdd2,posted,Car Maintenance Expense,-3372.04,53709efd-4cf0-4f68-941b-d4281a71b44c,-37.64,debit,payment,AU00000,2023-07-01T03:42:05Z
transaction,d1cca7c2-9d36-4705-a449-201c84bff8da,posted,Home Improvement Store Purchase,-737.31,82bed453-a9af-4295-ab7d-484c91afc3a9,-774.95,debit,payment,AU00000,2023-09-04T00:12:21Z
transaction,15d81308-6a7a-4e8b-9792-b46c8181e633,posted,Clothing Store Purchase,-793.24,91e92ed3-8488-43e0-b078-0cfbdf7e143b,-1568.19,debit,bank-fee,AU00000,2023-09-06T06:11:22Z
transaction,111a1136-ae93-4e5f-b6e9-1c57d6870a76,posted,Coffee Shop Purchase,-2673.21,b5e7e660-3cfe-4eca-a4c6-7e23abcbc849,-4241.4,debit,payment,AU00000,2024-05-06T16:27:38Z
transaction,ad3c49af-6966-4976-934b-83b589b9b413,posted,Manly Maths Tutor Wages,-4929.94,f274d04b-41dc-4569-9560-7cc39c7cae86,4438.43,debit,payment,AU00000,2023-11-22T21:07:40Z
transaction,3b4327a2-be65-42e4-9e23-5996cec7bf57,posted,Restaurant Dinner,-2596.54,bd404222-174e-43f1-9027-9345f942c27f,1841.89,debit,cash-withdrawal,AU00000,2024-02-09T02:39:52Z
transaction,19f79b19-a834-4ed9-87e7-3161daa5de81,posted,Bookstore Purchase,-1583.58,cacc63d6-dbea-4f47-b3ec-c3b89e9bec6a,258.31,debit,bank-fee,AU00000,2024-03-18T01:49:45Z
transaction,4767764f-30ff-4f95-9a2a-4ad3118782e1,posted,Wdl ATM WESTPAC IGA BALGOWLAH BALGOWL AU,-426.09,d245874a-f302-47d3-9813-a478ca5718af,-167.78,debit,bank-fee,AU00000,2023-06-13T07:07:48Z
transaction,49520bc2-5669-4e2d-b445-1b1211bee868,posted,Gym Membership Fee,-4296.91,462b72c4-3b0e-4c06-b0e9-e33b3f40f642,-4464.69,debit,bank-fee,AU00000,2023-08-30T02:48:00Z
transaction,decdd1a1-19dc-4218-9893-8369795b164a,posted,Clothing Store Purchase,-3908.59,1fb0f44c-70e3-41fd-ab9c-4e56bea30705,-8373.28,debit,cash-withdrawal,AU00000,2023-06-25T05:41:59Z
transaction,621dec9c-f0cb-4cda-8a41-a13e7d46fcbf,posted,Wdl ATM WESTPAC IGA BALGOWLAH BALGOWL AU,-2053.6,9be5b8af-3f4d-45b8-a79f-92e3f6a04580,-10426.88,debit,bank-fee,AU00000,2023-09-24T08:34:41Z
transaction,dfca32ac-a5d4-4ff3-b73b-3d6ce62ded0e,posted,Coffee Shop Purchase,-3560.0,c8642cac-8e68-434c-9813-7a7d44cd8982,-13986.88,debit,cash-withdrawal,AU00000,2023-12-17T16:01:11Z
transaction,077c402c-c46a-4b91-ad67-e9e5f48a3caf,posted,Gasoline Purchase,-4926.66,962d0f5b-63c2-404c-8ca8-c08fa8d68ad7,-18913.54,debit,payment,AU00000,2024-04-24T10:01:17Z
transaction,4bb6d484-c966-4596-86c5-576233a8e184,posted,Payroll WFRMS 15439393,11180.24,5562966c-0c51-47be-a791-ddbf5a288d4e,-7733.3,credit,transfer,AU00000,2023-06-07T21:30:56Z
transaction,b02aec66-e905-4ba7-be4d-3e17db5d22db,posted,Hair Salon Appointment,-4246.27,af1ea506-04bc-4530-b016-5076490c56e4,1155.23,debit,cash-withdrawal,AU00000,2023-12-25T05:25:14Z
transaction,bb0c105d-b165-4455-bd8f-a38de5de5223,posted,Bookstore Purchase,-4328.38,783c223a-aef6-4609-832f-b145fe1ad032,-3173.15,debit,bank-fee,AU00000,2023-06-10T06:04:32Z
transaction,986621a2-ca49-4d96-8377-cd47976d7d10,posted,Transfer Platnm Homeloan 346454,-4893.89,c29216c3-019a-43a7-a6e5-9bf3741c2a9e,-8067.04,debit,bank-fee,AU00000,2024-03-10T04:16:15Z
transaction,d3b10a6a-6ea8-4f41-b642-f2d3b345a855,posted,Uber Ride,-1779.64,2c35b54f-d60d-4b05-adad-8494e251afa2,-9846.68,debit,bank-fee,AU00000,2023-07-17T21:30:07Z
transaction,e933f643-6551-40dd-a3e3-9d0cb4199558,posted,Pharmacy Purchase,-3470.39,863a2b1c-4f38-4676-aafb-ffefd550bce6,-13317.07,debit,bank-fee,AU00000,2024-01-27T23:33:37Z
transaction,a0bd1dd7-f446-4632-8a74-ae1f141dec11,posted,CTRLINK CARERS Ref: 998R6789201610974V,-3720.33,d5677917-9078-474d-918e-14f1618f5322,-17037.4,debit,cash-withdrawal,AU00000,2024-04-11T02:31:09Z
transaction,835c4375-03bb-4e44-b991-246023f8b594,posted,Car Maintenance Expense,-4379.52,3bf0ede3-a585-483f-94dd-32c12b902b2f,-21416.92,debit,payment,AU00000,2024-03-06T10:36:25Z
transaction,90d0c657-cb84-4646-af77-2c54acfaa1d2,posted,Bookstore Purchase,-3595.58,ac88c6b7-58f0-4178-813f-0892385a70e8,-25012.5,debit,bank-fee,AU00000,2023-08-21T07:56:14Z
transaction,2246d83f-2f1a-497f-a9bb-0a5203cee99b,posted,Movie Ticket Purchase,-146.56,4761f8b4-6b1f-4fdc-acc3-299baeddd031,-25159.06,debit,bank-fee,AU00000,2024-05-01T04:16:20Z
transaction,e62222d9-dce7-463a-a8a6-a43b2edce9da,posted,Online Gaming Purchase,-4800.91,e062e31a-316b-45a2-9eac-cbb73cc3013d,-29959.97,debit,payment,AU00000,2024-01-12T06:59:28Z
transaction,083cdef1-c9e9-471e-8eeb-00037af27c80,posted,Amazon Online Shopping,-1805.56,e08e611f-48dd-41b6-b9d4-39a9dfd449a6,13483.56,debit,bank-fee,AU00000,2024-03-26T00:17:54Z
transaction,fb974c38-7c16-4a1e-89b1-b8dda8ec3f26,posted,CTRLINK CARERS Ref: 998R6789201610974V,-1652.07,2b5fe149-0851-4717-ad74-bfff2fd5da6e,11831.49,debit,payment,AU00000,2023-08-10T07:05:35Z
transaction,86c8e9c4-a47d-4ea3-b4a7-c562e8cdfb29,posted,TFR Acc14000 TO 12389,-4754.67,eadf286c-5827-42b8-816d-ea83667f2077,7076.82,debit,payment,AU00000,2023-08-03T03:34:21Z
transaction,f03a326e-b401-46fc-bde2-8cd290221a91,posted,Movie Ticket Purchase,-1315.68,71735b54-6ca1-486a-9033-a4eaf5dc08ea,5761.14,debit,payment,AU00000,2024-03-15T21:34:57Z
transaction,fe8fafce-2f76-4073-ad7e-1ba1acceb1e0,posted,Hair Salon Appointment,-3304.68,dffc43c9-01b2-4475-bbcb-9d3b6c286fbd,2456.46,debit,cash-withdrawal,AU00000,2023-07-10T14:52:31Z
transaction,b16506a8-84d7-4ff9-b858-df5f5aedca34,posted,Public Transport Fare,-366.11,60d32e0d-5708-4155-b839-47665ae2276e,2090.35,debit,payment,AU00000,2024-03-19T11:50:27Z
transaction,37cf6c1e-120b-4404-a97b-a7d1264e2487,posted,Hair Salon Appointment,-4475.67,3df651e0-a36c-4b2e-8beb-5ce0d943c085,-2385.32,debit,payment,AU00000,2023-12-17T15:12:30Z
transaction,71b45125-5a7d-4215-8f79-59d040af3d75,posted,Mobile Phone Bill Payment,-3023.44,6a0d4233-f338-4f17-a0ae-54e6962a18b0,-5408.76,debit,bank-fee,AU00000,2024-04-24T15:28:59Z
transaction,87262169-6abb-4278-ac9b-a40073e30fcd,posted,Wdl ATM WESTPAC IGA BALGOWLAH BALGOWL AU,-2179.1,16482862-2772-434c-ac67-cfc01a7ab88f,-7587.86,debit,payment,AU00000,2023-06-11T13:18:50Z
transaction,c0d1fc2f-d3bd-435d-b452-160897ca2084,posted,Netflix Subscription,-940.68,dea0e09d-cf23-41b2-8ecf-5b8b1aecec4a,-8528.54,debit,bank-fee,AU00000,2024-02-27T06:43:26Z
transaction,c06d1aac-7d16-4c94-abf7-5c6d6c5ddc0b,posted,TRANSFER TO JOANNA SMITH CAMPING,-559.2,e1051785-2543-4ab0-bafb-ddc4da5f3677,7747.19,debit,bank-fee,AU00000,2023-07-01T16:39:44Z
transaction,2f83065d-a0c0-49ab-95e5-4df8b27cd17c,posted,Gasoline Purchase,-1472.37,b5dc79e7-3f68-4e39-9c3d-d07862561c10,6274.82,debit,payment,AU00000,2024-02-27T22:48:53Z
transaction,45e21410-983e-44e4-8781-a190bcd2e151,posted,Non Hooli ATM Withdrawal Fee,-947.61,a8125475-42d3-4c28-8b8e-40c2193c5d2e,5327.21,debit,cash-withdrawal,AU00000,2024-02-24T06:48:56Z
transaction,0e8e95d7-06ce-40bc-9325-a1fbd6d3ee33,posted,Electricity Bill Payment,-1941.95,1b8a7ea3-ecd6-4e47-917a-b40e28682485,3385.26,debit,cash-withdrawal,AU00000,2023-07-28T09:26:15Z
transaction,2650d267-c2b2-4546-bf7b-80889033d7dd,posted,Travel Agency Booking,-2768.33,aa0071f7-02b0-4cb2-98e0-b8ccea182175,616.93,debit,payment,AU00000,2023-11-04T06:40:20Z
transaction,8463d3bf-267a-4d31-87fe-a30d901d928d,posted,Manly Maths Tutor Wages,-583.68,945c77ea-ae7f-4b78-adb8-8390bef5ecf2,33.25,debit,payment,AU00000,2023-08-03T20:36:23Z
transaction,e988b444-61cc-4d3c-9f97-2266f3963260,posted,CTRLINK CARERS Ref: 998R6789201610974V,-4684.06,1a521a61-a829-4f86-8077-85ad88800f07,-4650.81,debit,cash-withdrawal,AU00000,2024-02-23T00:48:50Z
transaction,b624ecc2-6fdf-4d4e-bed9-800ab0da2a54,posted,Non Hooli ATM Withdrawal Fee,-2497.75,0f2dccb3-11ab-4afc-8453-da69697ad46c,-7148.56,debit,bank-fee,AU00000,2024-01-27T04:40:12Z
transaction,ebc06422-375b-4fdd-9afc-b0fbe51c34f6,posted,CTRLINK CARERS Ref: 998R6789201610974V,-4486.91,13fe7863-0270-46ab-ad47-bd6a512cc282,-11635.47,debit,payment,AU00000,2024-02-16T16:24:18Z
transaction,c1605845-ca03-452e-84b2-77ca84f35ef7,posted,Electricity Bill Payment,-32.89,79fa503d-3fb3-4b88-9323-a9d7f3991d54,-11668.36,debit,payment,AU00000,2023-11-26T15:53:14Z
transaction,c46f6e74-7162-41ff-9fa4-158775e321c5,posted,Bookstore Purchase,-4499.42,1201d4cf-1b76-4e59-b028-84c0ecf404d6,9838.62,debit,bank-fee,AU00000,2024-02-02T09:23:25Z
transaction,3893e134-b01e-47a7-ab2a-84224ec00459,posted,Electricity Bill Payment,-474.04,e915746a-7160-4bab-a871-587f8cf2ffbb,9364.58,debit,bank-fee,AU00000,2024-02-04T07:05:35Z
transaction,9e92f6be-abb4-4e91-9007-7061e6250d52,posted,Car Maintenance Expense,-1508.71,51cdbe5d-050f-40b4-af44-a78ab0acf573,7855.87,debit,bank-fee,AU00000,2023-06-19T01:12:22Z
transaction,cfaf3fe5-b299-4fe2-a594-8f75d0c930b0,posted,Home Improvement Store Purchase,-4298.53,ba88aec1-9661-415c-b99d-fcd77ffeacf7,3557.34,debit,bank-fee,AU00000,2023-06-07T12:23:39Z
transaction,c1c87507-6681-4205-90b0-ac66444974a6,posted,Wdl ATM WESTPAC IGA BALGOWLAH BALGOWL AU,-4052.67,3c3581a4-c885-49c0-8cc5-c796d7c3db86,-495.33,debit,payment,AU00000,2023-11-23T09:56:25Z
transaction,2fed84f6-4255-4260-ae82-d5e368d98d95,posted,Gasoline Purchase,-985.63,e04f4d12-e786-4f39-ae77-5426af19f2b5,-1480.96,debit,bank-fee,AU00000,2024-03-22T11:11:00Z
transaction,4a77b007-3b02-4382-a9bc-4e5125bd5702,posted,AGL RETAIL ENERGY LTD (GAS),-27.67,0338b6a7-3b36-487f-9f5f-3869ca16c35d,-1508.63,debit,cash-withdrawal,AU00000,2023-10-16T04:18:41Z
transaction,59c92ac9-280f-4bb6-92c5-dce1acf12468,posted,Car Maintenance Expense,-2577.58,d83a7497-a440-4128-a7ef-586339e05be3,-4086.21,debit,cash-withdrawal,AU00000,2023-09-06T11:26:49Z
transaction,89a4f6ad-aa57-4a73-92cd-7f57f1418115,posted,Restaurant Dinner,-1547.54,88ca9450-65fa-42d0-b429-48aedfc90086,-5633.75,debit,payment,AU00000,2023-10-24T13:03:42Z
transaction,7df7423b-5d31-480f-aab6-91a8517fe47d,posted,Amazon Online Shopping,-1496.65,2d21b483-a74e-4507-8b94-8963f8b0b5f1,-7130.4,debit,payment,AU00000,2024-01-13T05:05:40Z
transaction,f3989894-daaa-4f8c-86d1-6b914fe5693d,posted,Online Gaming Purchase,-3789.92,6f00fbfe-3559-420e-9d5b-237bf6e20def,2537.11,debit,cash-withdrawal,AU00000,2024-04-10T19:26:01Z
transaction,fa6504d8-fb2f-4736-bd03-4210709ed4a8,posted,Bookstore Purchase,-2244.28,37cde948-a993-47f4-ae46-191585fbec0b,292.83,debit,cash-withdrawal,AU00000,2023-09-04T10:39:46Z
transaction,788429e1-8d6e-4d7f-8ea5-ee3918f13771,posted,Gym Membership Fee,-219.03,e3ea4349-efc0-4d19-a1ba-43fc3bdb8d53,73.8,debit,bank-fee,AU00000,2023-06-19T13:05:48Z
transaction,ea10cdd2-bc1a-4895-8970-34c539f6b184,posted,Home Improvement Store Purchase,-1533.89,c09282e5-742d-45b9-8f68-2a7893658093,-1460.09,debit,cash-withdrawal,AU00000,2023-09-05T23:41:20Z
transaction,3608e4c2-7b68-410b-bd40-99612e167329,posted,Restaurant Dinner,-3509.47,84eed39f-cd94-4021-89c6-fabd977f383c,-4969.56,debit,cash-withdrawal,AU00000,2023-06-01T15:37:09Z
transaction,56d36a93-ccc9-47d9-9d14-cbe618180ee6,posted,Clothing Store Purchase,-223.49,a5bc08f4-bd19-4e90-a271-f9a15bb3ec51,-5193.05,debit,payment,AU00000,2023-10-06T09:00:17Z
transaction,db5d084b-c0fb-4667-af2f-6df268d80e10,posted,Bookstore Purchase,-1333.82,abc1c2a1-9c02-4d01-833d-f11d324d3ebc,-6526.87,debit,payment,AU00000,2024-03-13T04:00:19Z
transaction,435455e1-b74c-4f39-8344-4a4bac9103ac,posted,Amazon Online Shopping,-4317.6,15c1f0be-1f03-4000-8a44-3cd38713b23b,-10844.47,debit,payment,AU00000,2023-10-30T00:43:23Z
transaction,733c25ae-4bd0-48ee-bbe3-5e2f9d0ce393,posted,Car Maintenance Expense,-3364.45,d7136abe-b8c7-44bb-ada2-3d6511eca186,-14208.92,debit,bank-fee,AU00000,2023-07-31T01:27:51Z
transaction,562b28e2-d9d6-4b95-8d11-04b24af9b37a,posted,Transfer Platnm Homeloan 346454,-3139.28,44871785-102e-4f87-8c57-a181372940de,-17348.2,debit,cash-withdrawal,AU00000,2023-05-23T02:49:20Z
transaction,142c81b2-d0b2-460e-9278-f67adc13aeec,posted,Mobile Phone Bill Payment,-4496.78,d2339849-b2eb-465b-b15a-7306ab290959,11148.09,debit,bank-fee,AU00000,2023-07-07T10:32:22Z
transaction,8722354d-0fb4-4961-b2f5-2f9f41645f1e,posted,Netflix Subscription,-3089.8,9257bd34-7869-44a9-8d76-790fa64d19b7,8058.29,debit,bank-fee,AU00000,2023-08-31T21:57:49Z
transaction,28844b33-8d15-42e9-9006-8e96534fb7ec,posted,Gym Membership Fee,-472.43,a820d820-833c-4496-81b8-4bae8a4a86fe,7585.86,debit,cash-withdrawal,AU00000,2023-11-12T12:41:42Z
transaction,e0209a5f-d39d-49cc-8495-2c77f08a6eb5,posted,Payroll WFRMS 15439393,11249.07,6bfa0694-bdff-4b08-8ac5-5183259649ab,18834.93,credit,transfer,AU00000,2024-03-30T05:44:27Z
transaction,09f31040-abcc-4e91-96b3-62ed08daab71,posted,Gym Membership Fee,-359.13,592218ea-ee10-48b4-8093-e77bb9484772,18475.8,debit,payment,AU00000,2024-01-06T22:30:36Z
transaction,624eb33c-717f-4497-8e65-16c91d91e5fb,posted,Gasoline Purchase,-918.73,becc8589-412a-4e8a-ac02-b4004b49ca44,17557.07,debit,cash-withdrawal,AU00000,2023-07-19T02:43:10Z
transaction,f575b47b-d073-4a79-8ece-ae7262168960,posted,Uber Ride,-1859.02,1f2efcee-cfd9-44f2-a393-faa1510b3e8e,15698.05,debit,cash-withdrawal,AU00000,2023-10-09T05:16:58Z
transaction,5edb89c4-6f71-4da8-b956-ed5fdbda8af6,posted,Payroll WFRMS 15439393,11704.34,7f93d042-aa3d-4f9b-abd3-890b2108f7f5,27402.39,credit,transfer,AU00000,2024-03-11T07:31:43Z
transaction,229042a8-2c5b-4d42-9289-e14708432d5b,posted,TRANSFER TO JOANNA SMITH CAMPING,-2916.95,7623f395-32da-48fc-b1b8-8deaa5d04fac,24485.44,debit,cash-withdrawal,AU00000,2024-04-04T23:48:58Z
transaction,bb3e8f46-d9e5-478a-bb16-f3323c1783ec,posted,Coffee Shop Purchase,-1928.56,434e0967-ad4d-482c-9622-65a5ffdcc762,22556.88,debit,cash-withdrawal,AU00000,2024-03-20T07:01:00Z
transaction,6056254f-f584-4824-9f28-5e1dda1d3654,posted,Payroll WFRMS 15439393,11804.33,6716e181-a8ea-4314-ab96-a41dc6c234f9,18042.51,credit,transfer,AU00000,2023-09-07T11:09:11Z
transaction,894f8396-97cf-4052-b798-d607227f8fae,posted,Hair Salon Appointment,-2648.31,041f8642-d1f3-48a6-94ab-65fce566b880,15394.2,debit,bank-fee,AU00000,2023-05-16T09:36:03Z
transaction,f73d54eb-668d-4377-81b5-2818de2c3e20,posted,Uber Ride,-4825.23,f0dcb1e4-df6a-40a6-a7d5-bd20f5200170,10568.97,debit,payment,AU00000,2023-10-12T04:22:36Z
transaction,ef0a3b31-1edd-4d79-a51f-173fcc0a7c0b,posted,Coffee Shop Purchase,-4221.96,6016137f-e3fc-4f0f-b930-e24946dc046c,6347.01,debit,bank-fee,AU00000,2024-03-24T06:44:40Z
transaction,6c84ce4b-daaa-49bb-afa0-ab4f6a0ffb62,posted,Restaurant Dinner,-369.02,618ef6c6-59a5-4f6a-9175-18c695ca0b54,5977.99,debit,cash-withdrawal,AU00000,2023-08-25T04:31:52Z
transaction,9efdff09-5d19-4de1-98fd-98e9e2202ed1,posted,Hair Salon Appointment,-124.87,add50896-5fe1-47ea-a050-71cc70325058,5853.12,debit,payment,AU00000,2023-05-15T02:57:55Z
transaction,9eeb406a-c348-495d-a444-40909427d403,posted,Music Streaming Subscription,-2744.41,b3dbe4e1-68ec-4b83-b80c-36b3686fbcf2,3108.71,debit,payment,AU00000,2023-12-28T10:04:16Z
transaction,0efa49f4-61ef-4384-addb-d0d9c36fce99,posted,Gym Membership Fee,-97.38,69a54cd9-7fe5-463b-a749-3534bbcad952,3011.33,debit,payment,AU00000,2024-03-17T13:57:32Z
transaction,e6ca4e93-b849-4a1d-a4aa-21d27ae9a3e6,posted,Movie Ticket Purchase,-1636.76,8a2d7d61-4adb-4d78-92aa-7cacc693d509,1374.57,debit,payment,AU00000,2023-09-17T04:04:47Z
transaction,6a64813c-61aa-433f-92b1-f97836a42451,posted,CTRLINK CARERS Ref: 998R6789201610974V,-942.7,cfa60c14-a0f7-42e5-b513-51c4ba5d8d41,431.87,debit,bank-fee,AU00000,2024-03-25T05:29:16Z
transaction,2b717ab3-a467-40d0-bb31-a27a6303d7d6,posted,Transfer Platnm Homeloan 346454,-533.19,0199ace8-bbb3-41ad-b2d1-1805cdfcfef6,18865.43,debit,payment,AU00000,2023-11-12T12:21:01Z
transaction,b9341a44-9db6-42ac-8c8c-2e06afe6fbee,posted,Pharmacy Purchase,-4723.97,1d381fe4-4c91-44b4-adb2-015663c9be7c,14141.46,debit,cash-withdrawal,AU00000,2024-01-05T08:07:18Z
transaction,e413d36b-8777-4804-a503-7c6edfb30b4e,posted,Wdl ATM WESTPAC IGA BALGOWLAH BALGOWL AU,-1818.97,a561284d-bce4-4c39-ac8b-bbd3c4b23006,12322.49,debit,payment,AU00000,2024-02-27T03:37:02Z
transaction,5ec113d4-fb95-412d-9625-5c1ebd2f9df8,posted,Car Maintenance Expense,-3061.89,c93145e8-15cf-4537-88c9-6d26028ca387,9260.6,debit,bank-fee,AU00000,2023-10-17T20:06:19Z
transaction,1f8b0134-09c6-49fa-b5b8-c05ce78c5abc,posted,Coffee Shop Purchase,-4671.9,a9a17078-09ed-4b88-988e-fb5e267d7874,4588.7,debit,payment,AU00000,2023-10-23T11:17:56Z
transaction,49eb8e19-21dd-4388-b8fd-1e9b4911eb94,posted,Electricity Bill Payment,-2531.46,2b755834-0e98-4b8b-9242-f0387cb92b8f,2057.24,debit,cash-withdrawal,AU00000,2024-04-02T18:41:09Z
transaction,6a793b93-e62f-49b9-802d-b98085800e96,posted,Manly Maths Tutor Wages,-623.36,e6105754-ac06-48e3-994c-c660fa80c6b7,1433.88,debit,bank-fee,AU00000,2024-04-08T14:56:13Z
transaction,9fc9d150-025e-49e9-a9cc-6c4a581a7f18,posted,Coffee Shop Purchase,-4396.55,75219b29-2716-4361-aafc-604ae7a264c0,-2962.67,debit,bank-fee,AU00000,2023-10-03T03:27:15Z
transaction,5d2ea791-e4ee-4e67-8306-e0005f181a43,posted,Public Transport Fare,-3709.94,89b5ee4f-70d4-4e9c-a232-f226def5d86b,-6672.61,debit,bank-fee,AU00000,2024-04-27T05:28:41Z
transaction,f0aea5fa-733a-4a9a-a17a-393333c3c96a,posted,Travel Agency Booking,-1102.04,b586c87c-110c-4d01-8618-8d80481c8a55,-7774.65,debit,bank-fee,AU00000,2023-07-09T15:21:56Z
transaction,7fa9dc63-539d-42eb-b327-fa11880713ab,posted,Clothing Store Purchase,-1386.58,20cca558-204a-43b4-af61-310461707e1a,10672.88,debit,bank-fee,AU00000,2024-04-09T21:15:29Z
transaction,c0ad0f9e-d366-4bee-99a8-42fd25f6c656,posted,Transfer Platnm Homeloan 346454,-566.37,82c78351-0679-496c-908b-62a6f496826f,10106.51,debit,bank-fee,AU00000,2024-05-03T07:47:09Z
transaction,5c11d2bf-6939-4c4c-a6b6-91e83c006111,posted,Uber Ride,-1999.13,d79f7543-2a17-4908-9642-257b82ca0c2a,8107.38,debit,bank-fee,AU00000,2024-04-23T04:24:10Z
transaction,e887be0d-40fd-4716-ba50-f2017d2c0da3,posted,Netflix Subscription,-2995.59,b488c174-301f-4b90-8707-aa94febd7e6e,5111.79,debit,payment,AU00000,2024-02-13T08:06:46Z
transaction,6456b6a9-aab9-41c0-b2c0-8e0529c84af1,posted,Manly Maths Tutor Wages,-825.87,8382870e-8ff6-4c55-9f81-105e4162d94d,4285.92,debit,cash-withdrawal,AU00000,2023-12-31T06:04:57Z
transaction,7f82cb77-b52d-4bdd-9c40-684d56f1531e,posted,Manly Maths Tutor Wages,-3629.02,15678012-fd89-4846-a911-cf9b260c69bf,656.9,debit,bank-fee,AU00000,2024-02-17T02:34:42Z
transaction,e5de10d7-27b4-4120-a801-578f8c28e032,posted,Manly Maths Tutor Wages,-3583.83,5cdf5be6-89fd-446d-9f31-73c0ef923d46,-2926.93,debit,bank-fee,AU00000,2023-10-19T08:07:33Z
transaction,0650a996-13e5-4612-aa23-9d8f16930cd4,posted,Clothing Store Purchase,-4952.93,9166b3af-0145-4c96-8621-4e1019562c8f,-7879.86,debit,bank-fee,AU00000,2023-12-03T10:13:10Z
transaction,7882325c-d780-40e9-8897-2e26388597f8,posted,AGL RETAIL ENERGY LTD (GAS),-3414.98,382a5092-007f-414a-8f1c-f93fe0c1b90a,-11294.84,debit,payment,AU00000,2023-05-15T22:22:16Z
transaction,d15e92f0-2fbe-4a6c-a183-008f86adb60f,posted,Pharmacy Purchase,-2546.95,03097a77-bd87-4219-a12f-96cc787a00b6,-13841.79,debit,bank-fee,AU00000,2024-04-20T11:10:51Z
transaction,4774648d-cbac-42e5-ba0d-46cb2ea2656c,posted,Hair Salon Appointment,-3479.63,aad8e6c9-e96c-482e-a5bf-7fad2a851e2f,1699.28,debit,payment,AU00000,2023-10-13T04:39:45Z
transaction,61834ee5-038f-4403-b6f6-f4f59f595ac4,posted,Netflix Subscription,-3296.6,538de24c-cb3c-405a-a029-714119d9b973,-1597.32,debit,cash-withdrawal,AU00000,2023-09-07T02:56:53Z
transaction,e5604477-3976-4406-a8c5-df345e09d748,posted,Pharmacy Purchase,-2493.98,4c54f928-175e-4d92-b8c1-243ba5e3f226,-4091.3,debit,payment,AU00000,2024-02-05T21:53:13Z
transaction,6bb50612-3f61-45d0-894e-4cf41cad92bd,posted,Home Improvement Store Purchase,-1478.57,ceb4d8c9-3eca-414c-a51f-e5d3e7341d64,-5569.87,debit,bank-fee,AU00000,2023-11-07T00:50:25Z
transaction,3d1248c9-12e7-4685-8929-adf0707b3a3e,posted,AGL RETAIL ENERGY LTD (GAS),-2734.68,f3ca80d9-9e26-4924-93f5-05b14530314c,-8304.55,debit,bank-fee,AU00000,2023-08-07T04:41:00Z
transaction,4206dde7-99d8-4f9d-8215-bee65c96ea6e,posted,Transfer Platnm Homeloan 346454,-2764.82,a17a12cc-2dea-47e7-8b90-525fbef26acd,-11069.37,debit,bank-fee,AU00000,2023-08-05T11:33:47Z
transaction,338df2ca-c3fa-4bce-8fdc-3bafb86de36a,posted,Pharmacy Purchase,-1186.84,f6b6dfbd-ba03-4a01-8de9-a3b722f398bb,-12256.21,debit,payment,AU00000,2024-02-18T22:59:34Z
transaction,4ee0316c-e198-41be-9afd-5083dbbb5e05,posted,Wdl ATM WESTPAC IGA BALGOWLAH BALGOWL AU,-1971.69,3e8430e5-0ad8-43a3-b859-32815622ae8e,-14227.9,debit,cash-withdrawal,AU00000,2023-10-23T16:11:35Z
transaction,040b4e53-229d-481d-b81d-d5d0b13b52c5,posted,Payroll WFRMS 15439393,10039.62,6de32d82-247a-40bc-bdf0-0f082288d826,-4188.28,credit,transfer,AU00000,2023-12-19T05:48:04Z
transaction,9fb1d2d3-a3ac-4fb6-be8e-cc9193d55dc5,posted,Coffee Shop Purchase,-4157.02,06017241-a1d4-421a-bb2c-0e70358b00c4,-8345.3,debit,cash-withdrawal,AU00000,2023-06-11T21:54:42Z
transaction,1b95b03e-9e29-4e32-a3db-336f83867b33,posted,Manly Maths Tutor Wages,-3313.84,a9c6032d-7aed-44e9-9eaf-abd4226ca49f,2703.55,debit,payment,AU00000,2023-11-19T05:07:25Z
transaction,e31d1611-461a-4370-9515-8ec82f56e383,posted,Travel Agency Booking,-1169.48,02150d8b-d13e-401b-9ee9-badb34de4725,1534.07,debit,bank-fee,AU00000,2023-11-21T01:12:40Z
transaction,672ce12b-1991-4d1a-9889-67ca9f0847d1,posted,Music Streaming Subscription,-1886.02,81f97611-b4e9-4f91-8b0b-ad7a4fbaf255,-351.95,debit,bank-fee,AU00000,2023-11-17T01:21:30Z
transaction,f4b6b68b-3af4-4892-ac3c-b483fde6738c,posted,Home Improvement Store Purchase,-524.79,4b104836-90f6-4a55-b44c-9140ae5715fe,-876.74,debit,payment,AU00000,2024-02-02T08:42:42Z
transaction,d6109d6a-ea5b-4a90-842a-562ca67df8da,posted,Gym Membership Fee,-4337.51,54a6f29b-5783-46e4-b669-04b4fe72142c,-5214.25,debit,bank-fee,AU00000,2023-08-26T04:13:15Z
transaction,f0ea2c48-866e-4c1b-b7ad-27e4aba02ce3,posted,TRANSFER TO JOANNA SMITH CAMPING,-1387.96,1c734ec3-a64a-4992-8140-f04978ab17e9,-6602.21,debit,cash-withdrawal,AU00000,2023-07-26T05:49:43Z
transaction,6a2c7690-57c3-4ead-866a-0c2f1d0549fb,posted,Home Improvement Store Purchase,-989.58,6558eaee-b1b0-47bb-b5d1-94affd4fa700,-7591.79,debit,cash-withdrawal,AU00000,2023-05-27T20:22:07Z
transaction,1349c48f-7048-43ee-aef7-1fa0a1c0d62a,posted,Gym Membership Fee,-670.3,1fb3955f-c606-44c8-b4c6-ec31f1450527,-8262.09,debit,bank-fee,AU00000,2023-05-17T22:58:53Z
transaction,252ef8fb-04e3-4abd-98c6-8be61d754a6f,posted,Clothing Store Purchase,-3503.47,b21ef3f1-f99d-4ea8-b7c0-d77679871dd9,-11765.56,debit,payment,AU00000,2023-06-11T22:56:47Z
transaction,c619717e-3094-4fc6-ad31-240df166eb91,posted,Clothing Store Purchase,-1642.71,bbcb09c7-83b7-432b-9005-97fd899c5ea5,-13408.27,debit,bank-fee,AU00000,2023-07-30T14:03:45Z
transaction,79ec0490-f593-4c50-b12a-f9b484de8d13,posted,Home Improvement Store Purchase,-3182.33,826a7c94-5550-4d34-abf5-3054f88b3bfc,16100.83,debit,bank-fee,AU00000,2023-06-12T10:02:24Z
transaction,30a07fdc-1f82-4949-aac3-353c9793f431,posted,Gasoline Purchase,-3071.53,bb8401fe-d8a8-4ac6-becc-3d1c323181db,13029.3,debit,cash-withdrawal,AU00000,2023-07-08T08:12:28Z
transaction,054b7ec3-5498-47dd-a74e-4929480475aa,posted,Non Hooli ATM Withdrawal Fee,-3502.19,6288741e-a197-4e47-84ba-b786ed6812fc,9527.11,debit,cash-withdrawal,AU00000,2023-09-08T08:05:22Z
transaction,62491c0a-3a9c-472c-947b-2847ab4dbc96,posted,AGL RETAIL ENERGY LTD (GAS),-3157.58,063511cf-ad04-48b9-8177-1419c083b78e,6369.53,debit,bank-fee,AU00000,2023-11-14T03:30:07Z
transaction,438d8d23-842b-4a8a-bbd3-5425e1fc16d7,posted,Music Streaming Subscription,-1430.43,78e4e728-4dac-4cc0-a99f-44b1dab2224b,4939.1,debit,cash-withdrawal,AU00000,2023-12-05T11:51:09Z
transaction,a733e2fe-c770-4483-9eef-d4998e54e53c,posted,Clothing Store Purchase,-3558.13,60146882-31ee-4c8b-b523-efd426f543d3,1380.97,debit,cash-withdrawal,AU00000,2024-03-08T23:40:40Z
transaction,659814d6-6fb4-4d78-8d0f-85c056cff32b,posted,Movie Ticket Purchase,-4985.82,9b17d042-a346-425a-a302-fe0421d8bf98,-3604.85,debit,cash-withdrawal,AU00000,2024-01-01T23:30:16Z
transaction,7e14731c-0a12-435b-8373-42b38fc351c8,posted,TFR Acc14000 TO 12389,-3895.69,971d41c3-6c52-4ae4-b2c4-14bb007e217f,-7500.54,debit,payment,AU00000,2024-01-25T09:26:11Z
transaction,951d845f-15fc-4b7c-aec4-1fcf641ba7cf,posted,AGL RETAIL ENERGY LTD (GAS),-508.61,b512de29-b810-4c6d-a3b0-fb4effd97535,-8009.15,debit,bank-fee,AU00000,2023-05-20T11:26:08Z
transaction,ef49120d-2352-4fc9-a842-d95af317f914,posted,Clothing Store Purchase,-867.71,e8fa0fb5-c166-478f-852d-11f9f24af272,-8876.86,debit,bank-fee,AU00000,2023-08-09T15:57:13Z
transaction,cf8d78d4-ebab-4af7-9a3c-8164445d35f3,posted,Bookstore Purchase,-4920.27,6fdf9ce1-a502-4f96-848e-743ddbce996a,14988.4,debit,bank-fee,AU00000,2023-09-22T10:20:27Z
transaction,46a336c7-7a5e-4b77-8316-49c2f6946172,posted,Public Transport Fare,-4559.79,2bdf0850-70d7-47b0-8c18-b2c7008e7072,10428.61,debit,cash-withdrawal,AU00000,2023-10-26T04:02:19Z
transaction,a9c074ac-37ed-4af4-9951-bbba9afe2a3a,posted,Car Maintenance Expense,-1236.81,5443ad27-203d-485f-b89c-088d83b9a12a,9191.8,debit,cash-withdrawal,AU00000,2023-05-14T17:46:24Z
transaction,3289f8c3-e6c4-45e3-887a-e87f2c1536db,posted,Payroll WFRMS 15439393,11549.6,a5d9b3c7-37fb-470f-a6fb-402f15515dc7,20741.4,credit,transfer,AU00000,2024-02-05T07:43:50Z
transaction,57e711f6-8488-4916-9d93-52d9f464d590,posted,Payroll WFRMS 15439393,11752.87,84e4764f-588e-47a5-ad8b-689300b8b8a7,32494.27,credit,transfer,AU00000,2024-04-30T22:36:48Z
transaction,5005a0a3-d500-4471-8446-2588840fc665,posted,TRANSFER TO JOANNA SMITH CAMPING,-4924.68,5727b705-a7fb-422d-be12-b3e1eeee73fd,27569.59,debit,cash-withdrawal,AU00000,2023-11-02T07:17:54Z
transaction,fd9c5937-275b-4272-93a0-02d2603c4919,posted,Non Hooli ATM Withdrawal Fee,-2093.53,8c7be379-f738-4075-9cc2-91313f55d119,25476.06,debit,cash-withdrawal,AU00000,2023-05-18T11:09:50Z
transaction,a5fc5d77-567d-4b8a-9284-995154c78e81,posted,AGL RETAIL ENERGY LTD (GAS),-4217.25,15a3460b-9f4a-4ebd-a3d8-0dea63e935c4,21258.81,debit,bank-fee,AU00000,2023-07-08T10:00:44Z
transaction,cf930040-199a-43c8-b847-cac0e848710d,posted,Mobile Phone Bill Payment,-1769.08,281d0bc4-1ad0-443d-8206-2cbe6c4f9155,19489.73,debit,cash-withdrawal,AU00000,2023-06-23T10:27:26Z
transaction,a68752ab-6be0-4b8c-bcb3-9e194635b030,posted,Restaurant Dinner,-4556.16,979713b4-8c91-418c-a4e9-4daf25c4d364,14933.57,debit,bank-fee,AU00000,2024-03-04T19:15:16Z
transaction,8f21564d-7d33-412f-bf6d-66edcda4d46a,posted,AGL RETAIL ENERGY LTD (GAS),-767.04,9ea8219e-dc10-4ca5-9603-2e06e8b9cf5b,8994.12,debit,bank-fee,AU00000,2023-10-03T09:12:23Z
transaction,314e8d74-7331-4fe0-8508-c28f2ace35c4,posted,CTRLINK CARERS Ref: 998R6789201610974V,-4736.87,f704821e-e2e4-4e4d-a731-ccd037f145db,4257.25,debit,cash-withdrawal,AU00000,2023-10-28T10:30:57Z
transaction,8ee043d5-ff8d-4721-a288-af4bc9862c00,posted,Pharmacy Purchase,-3968.74,360084ac-f6bb-4407-885a-bbe91a197afb,288.51,debit,payment,AU00000,2023-05-24T13:13:32Z
transaction,8a9fa6eb-8eb4-48e6-8cbc-f9cc5804534d,posted,Non Hooli ATM Withdrawal Fee,-4122.74,5cb8b2ab-15b0-4889-8a81-1ec8c4c55d16,-3834.23,debit,cash-withdrawal,AU00000,2024-01-18T14:51:24Z
transaction,e1c6f66b-eea8-4cdc-8eea-a9fef0edd3ab,posted,Public Transport Fare,-2346.88,22bf0c20-0403-4a76-b608-4a8178ac613f,-6181.11,debit,bank-fee,AU00000,2023-08-05T16:10:13Z
transaction,67f4d38b-0439-4948-a30e-dc1c8b63ba48,posted,Movie Ticket Purchase,-4216.97,c1cd8f73-a09c-4605-a93d-b7e1accab463,-10398.08,debit,payment,AU00000,2023-12-05T23:44:21Z
transaction,b2eabfb2-fe1a-4946-a57d-aa6589fdfad9,posted,Electricity Bill Payment,-1218.07,79f42f6a-aee2-404b-b744-13e984243603,-11616.15,debit,payment,AU00000,2024-02-10T17:39:58Z
transaction,492e7d33-8650-43ec-b0d9-86cf88275659,posted,AGL RETAIL ENERGY LTD (GAS),-1319.15,7fe05d67-db6f-4236-b17b-2f179dc0d71f,-12935.3,debit,cash-withdrawal,AU00000,2024-04-02T10:41:57Z
transaction,fed03cc0-3209-4352-9e78-2749f9477fc4,posted,Restaurant Dinner,-1340.41,3a5a7b50-010e-4ff3-966c-e81309cb9b95,-14275.71,debit,cash-withdrawal,AU00000,2024-03-20T01:34:26Z
transaction,63cd19c7-a0da-40c4-bc5c-ff8f8eae0bb9,posted,Non Hooli ATM Withdrawal Fee,-1428.58,6890d8c6-1414-461e-8d06-989871c9afc6,-15704.29,debit,bank-fee,AU00000,2024-02-08T08:44:24Z
transaction,ee89679b-e924-4e34-99f6-80b227a2d3c3,posted,Movie Ticket Purchase,-4395.25,44bcda9f-9d5c-45bf-9e35-483cf4d6b86c,4229.53,debit,payment,AU00000,2023-08-27T03:26:42Z
transaction,252897f8-0341-4aa5-a471-232b960eb482,posted,Online Gaming Purchase,-2395.38,dde07b78-f190-40fb-9dad-16403bab9330,1834.15,debit,payment,AU00000,2023-09-30T03:58:23Z
transaction,3fcf0839-bc6e-46db-af5a-28db774a7e0b,posted,Bookstore Purchase,-4104.95,31f0eca0-87b7-489d-bc06-5d9235b52459,-2270.8,debit,bank-fee,AU00000,2024-02-08T10:45:59Z
transaction,ae969e0e-a780-4793-8bc8-df45f58d017e,posted,Wdl ATM WESTPAC IGA BALGOWLAH BALGOWL AU,-4892.65,33b432d1-2877-4200-abf4-c36153e38948,-7163.45,debit,bank-fee,AU00000,2024-04-15T06:38:53Z
transaction,01a9f93b-4e49-49c9-9c93-8471f9cdbd6e,posted,Amazon Online Shopping,-627.83,b8b3e292-8819-46bb-b525-a542fd3a078b,-7791.28,debit,bank-fee,AU00000,2024-04-01T14:03:41Z
transaction,cf6d7638-7b4d-42fa-aab5-b9d1971f5053,posted,Pharmacy Purchase,-1547.11,180c29c5-9562-4567-b07c-5d02a574ca64,-9338.39,debit,cash-withdrawal,AU00000,2024-04-16T20:13:29Z
transaction,8099aa57-f1c3-4806-a0c9-bb2c2ead27ee,posted,CTRLINK CARERS Ref: 998R6789201610974V,-3799.87,d018cc47-e795-4e56-a3fe-a98121d7fb2f,-13138.26,debit,bank-fee,AU00000,2024-04-14T16:51:57Z
transaction,cb5311ce-1736-40ba-8a52-e187a57e5061,posted,Wdl ATM WESTPAC IGA BALGOWLAH BALGOWL AU,-418.87,3f1e4259-3360-4fb0-af13-e74d03e0c00d,-13557.13,debit,payment,AU00000,2023-08-15T21:46:20Z
transaction,5030d961-9e5a-434a-b680-25b854802e77,posted,Manly Maths Tutor Wages,-4283.7,ab0be76f-e4a4-4064-8280-4f3be7ab1d92,-17840.83,debit,payment,AU00000,2024-01-15T17:52:49Z
transaction,01a56b55-636f-44ef-b9b0-76f5e1a9a80a,posted,TFR Acc14000 TO 12389,-1950.39,67039465-a287-47d5-a958-a5af5da4527a,-19791.22,debit,bank-fee,AU00000,2024-01-07T08:59:43Z
transaction,35a30243-a56d-44bf-aa70-dd11ceb0b7a4,posted,Coffee Shop Purchase,-4999.83,d7db7b78-b92d-4dd2-a4b2-695b14687c40,2820.3,debit,payment,AU00000,2023-12-05T11:40:58Z
transaction,9e17296c-9a15-4621-a2d7-b4a23e9047d4,posted,Bookstore Purchase,-4516.9,7465adad-fcfe-41fa-b9d7-de9e76505373,-1696.6,debit,payment,AU00000,2023-08-14T03:23:55Z
transaction,2c25d12f-c8fd-4afb-9090-ce72d2cf7f9e,posted,Clothing Store Purchase,-1434.24,5170070f-ab01-41f0-99df-fc485f40deb1,-3130.84,debit,cash-withdrawal,AU00000,2023-10-19T15:59:02Z
transaction,3bc0df13-cffd-4dda-a02d-1208c72eb5b9,posted,Home Improvement Store Purchase,-511.59,4f069912-a964-419d-9f0c-34b00dbe657d,-3642.43,debit,bank-fee,AU00000,2024-05-10T22:02:06Z
transaction,8d4d2117-a482-4ccc-a678-4cc37c27f279,posted,Electricity Bill Payment,-2606.33,cd07ad82-ba56-495d-9725-936c000acfba,-6248.76,debit,payment,AU00000,2023-10-18T15:31:28Z
transaction,0ea2081b-97b3-4ef5-bcbb-0c0e4f81787b,posted,Gasoline Purchase,-36.06,b7fd078e-3097-4914-9c05-8d0efa123b74,-6284.82,debit,cash-withdrawal,AU00000,2023-06-12T09:01:57Z
transaction,9a0ef2d9-4914-4b04-8fe2-17ec1d379786,posted,AGL RETAIL ENERGY LTD (GAS),-1026.83,91ae77a1-8a6b-4b74-b4b3-74002c7c2c9e,-7311.65,debit,bank-fee,AU00000,2024-03-12T06:03:57Z
transaction,05058638-567f-4f5e-a8ee-ff3cc5062710,posted,Public Transport Fare,-4816.3,4bd9c808-5faa-4693-84ec-72659c32074e,-12127.95,debit,bank-fee,AU00000,2024-02-02T00:45:17Z
transaction,8f6d9e81-5f8b-42e8-bd0c-bbeccbb73627,posted,Manly Maths Tutor Wages,-1438.09,968e7492-7232-4658-8e17-7269f4dda3c1,-13566.04,debit,bank-fee,AU00000,2023-06-26T17:47:58Z
transaction,e78dcc25-372b-471d-8326-ab187cb5e366,posted,TFR Acc14000 TO 12389,-4994.15,41db18bc-3b27-4879-adb0-66136c6285e1,-18560.19,debit,cash-withdrawal,AU00000,2023-08-11T11:44:41Z
transaction,e5b23cbb-b7b5-4a9f-9329-df112a8a7448,posted,Home Improvement Store Purchase,-2948.07,5946d86c-7b76-42c6-8279-df8de69e61b9,15859.79,debit,cash-withdrawal,AU00000,2023-07-29T11:41:28Z
transaction,d9109576-8103-4733-b1ce-6987a3678500,posted,Public Transport Fare,-1625.97,b1ab0591-87c4-4126-8593-349eba02d155,14233.82,debit,payment,AU00000,2024-02-25T07:23:41Z
transaction,18d17ba8-7589-4f34-ad70-73b3f696e1eb,posted,Non Hooli ATM Withdrawal Fee,-3734.55,5eac915a-ca21-46a5-a349-ddb88550697a,10499.27,debit,cash-withdrawal,AU00000,2023-08-06T22:13:06Z
transaction,351fdf3b-fa2a-4e34-8b2a-dae89531fc7d,posted,Gym Membership Fee,-4570.65,26b91903-f139-4b19-a36d-87729c22b324,5928.62,debit,cash-withdrawal,AU00000,2024-04-07T19:27:28Z
transaction,474fcdec-26cf-4264-8cf8-2eb7ae8cd249,posted,Clothing Store Purchase,-1433.91,e7207f8d-ff0d-4452-bd8d-186c2be9c8bf,4494.71,debit,payment,AU00000,2024-03-12T02:22:42Z
transaction,76bfa488-aa48-4ccf-b819-1196a443c789,posted,Netflix Subscription,-2908.61,637d1edd-b063-4154-b559-114c41cd4990,1586.1,debit,cash-withdrawal,AU00000,2024-02-06T17:01:31Z
transaction,26b25b91-86a1-43b5-8642-7e840eec4c44,posted,Gasoline Purchase,-3735.81,67929b36-c87f-45d5-8f3b-8d02ab1b7e78,-2149.71,debit,cash-withdrawal,AU00000,2023-11-11T04:33:11Z
transaction,460c71e9-6b22-4f45-945e-d3e6a097102e,posted,Public Transport Fare,-2719.19,f8ad22a6-ed28-4102-82b7-5b6c9b1fa026,-4868.9,debit,payment,AU00000,2023-09-30T09:36:08Z
transaction,537f9638-e863-4953-bdb3-53e0a563921e,posted,Bookstore Purchase,-865.97,93753229-5503-4faa-9637-527f8e06d7ec,-5734.87,debit,payment,AU00000,2023-09-15T06:39:54Z
transaction,74fec9ae-719c-4796-a455-733fac7e3978,posted,CTRLINK CARERS Ref: 998R6789201610974V,-2072.89,9ffc7710-d4d0-4b57-9b2f-a43a514cdd62,-7807.76,debit,cash-withdrawal,AU00000,2024-02-18T07:04:04Z
transaction,8e382443-c62a-4294-b338-e4572762c701,posted,Hair Salon Appointment,-3768.04,9e087213-8c29-4d9f-8615-710cafef21fc,5987.16,debit,cash-withdrawal,AU00000,2023-10-04T02:55:33Z
transaction,cb7f81e1-237f-4537-87f1-41411642a319,posted,Pharmacy Purchase,-3997.43,4868ecba-4a41-4ae3-9735-0924099dca45,1989.73,debit,payment,AU00000,2023-07-20T15:57:32Z
transaction,336b4bfb-20b2-4853-9819-276607e87b38,posted,Restaurant Dinner,-4450.51,45b7f553-eec8-4b9b-9806-c427d8a35136,-2460.78,debit,payment,AU00000,2024-04-06T13:11:32Z
transaction,d9ccab29-9910-4436-a429-deed92949bc4,posted,Car Maintenance Expense,-3924.01,cee8a796-3570-4fd3-b8d4-395386730b51,-6384.79,debit,cash-withdrawal,AU00000,2023-12-14T01:07:21Z
transaction,ed9fba0b-514f-4c92-8bf9-cd5efeeef583,posted,Hair Salon Appointment,-196.56,103427ea-0e18-4726-95b8-746c50523042,-6581.35,debit,cash-withdrawal,AU00000,2023-12-03T04:25:16Z
transaction,2f82c006-67f9-43e5-89a5-3fb981207f54,posted,Pharmacy Purchase,-2815.41,525c8ac3-9aab-45ed-99fb-2b5e0fb66341,-9396.76,debit,cash-withdrawal,AU00000,2023-06-05T10:05:17Z
transaction,7739816c-5bf8-4d90-b9e8-74fb9bc74ec8,posted,Bookstore Purchase,-4917.18,cc2cc740-c0dc-4142-9db0-7d8b12556d2c,-14313.94,debit,bank-fee,AU00000,2023-10-31T14:25:22Z
transaction,07347c69-6e85-4f71-8cc7-fb1229e65ef0,posted,Online Gaming Purchase,-2886.32,2930f916-d40e-4bb2-a66c-30fad6127646,-17200.26,debit,cash-withdrawal,AU00000,2023-10-17T11:58:19Z
transaction,a5c8280b-a42c-4223-b344-4a3e8836f55f,posted,Restaurant Dinner,-2208.8,740719a8-abf4-418e-a03a-4311a0a1d62e,-19409.06,debit,cash-withdrawal,AU00000,2024-04-26T22:29:25Z
transaction,9d184cc6-27d6-400c-9557-1f5ce58987cf,posted,Gasoline Purchase,-4612.2,b01c709e-da14-4c70-ab9b-137c9a2f2094,-24021.26,debit,cash-withdrawal,AU00000,2024-05-08T11:53:28Z
transaction,f64fcd0c-6f51-4c5e-a883-97b3b4d62c8b,posted,Online Gaming Purchase,-1812.53,d1493479-3d3d-4416-9648-94b2a46c1092,7589.42,debit,payment,AU00000,2023-06-21T01:02:49Z
transaction,143d3da7-ccf1-47d3-959e-8125f14b3c09,posted,Gym Membership Fee,-1857.78,9610ea49-4dbd-4610-94b7-191d3eeb8828,5731.64,debit,payment,AU00000,2023-11-05T13:54:43Z
transaction,fb75daf2-5a50-4b36-8b6f-f6be8101d510,posted,Online Gaming Purchase,-72.81,7a61b0e3-3e19-4183-90e8-bcffb3e734b5,5658.83,debit,cash-withdrawal,AU00000,2023-07-06T02:50:51Z
transaction,5d804f78-6d96-4337-9f4f-80b9b7c614be,posted,Electricity Bill Payment,-3961.89,23ed49a7-bb66-4e0a-a033-7aeff73b6f67,1696.94,debit,bank-fee,AU00000,2023-12-30T13:42:28Z
transaction,11d7a8b5-e697-47a1-8305-6d113d49f62e,posted,Non Hooli ATM Withdrawal Fee,-3980.92,0b910b8f-01e6-4dc6-b9d1-60f35900c52d,-2283.98,debit,payment,AU00000,2024-03-10T09:24:58Z
transaction,a9627966-c651-4984-8b98-1ef2f27bc6c2,posted,Public Transport Fare,-190.76,77f1d7a9-e955-4d80-afd4-8799e3172c85,-2474.74,debit,bank-fee,AU00000,2024-04-26T01:14:25Z
transaction,b83aec70-b4d8-4a87-833e-0e6558b6548b,posted,Electricity Bill Payment,-2403.47,6ba36b0d-411f-4544-8787-01eda7fb066d,-4878.21,debit,bank-fee,AU00000,2023-10-24T11:55:59Z
transaction,f70ccee3-1cc8-4a0f-bdfd-1b9dfd5be1b4,posted,Non Hooli ATM Withdrawal Fee,-4994.82,7a464617-a480-4648-b780-1c02ca40e3f4,-9873.03,debit,payment,AU00000,2023-05-29T15:26:26Z
transaction,8589fcce-6677-4212-8165-d3aca99ce657,posted,Online Gaming Purchase,-1264.09,f371a6cd-1c9e-41b7-9678-bcd1e0774f41,-11137.12,debit,bank-fee,AU00000,2023-08-01T05:52:40Z
transaction,ca7fa91b-4acd-46b9-bc25-c57030e3ba5e,posted,Gym Membership Fee,-3627.19,4d34fb61-db1e-4950-af1d-399d5a1dc2d9,-14764.31,debit,payment,AU00000,2024-05-02T23:23:14Z
transaction,df608c7b-89f4-4ee6-8c4c-fa4cdada86d8,posted,Bookstore Purchase,-1550.83,57001fd6-67d6-402a-8f08-ea5c179e5601,12002.22,debit,payment,AU00000,2024-02-23T01:34:28Z
transaction,2078efef-0ca0-4e79-9119-c5e5c6e9cb21,posted,AGL RETAIL ENERGY LTD (GAS),-715.95,ddcc79db-fccf-4198-985f-b850be54fc9c,11286.27,debit,cash-withdrawal,AU00000,2024-03-16T11:34:20Z
transaction,64796fbc-618e-43de-9275-7c5204c17561,posted,Clothing Store Purchase,-3893.14,5339ea1d-a6f3-4099-82c9-15f0a8c5714a,7393.13,debit,cash-withdrawal,AU00000,2023-10-16T15:22:19Z
transaction,1b297132-46f6-44c6-87f8-d12e9d933e60,posted,Non Hooli ATM Withdrawal Fee,-3383.57,0a94ac1b-6256-4ac3-bb67-b4078348a457,4009.56,debit,payment,AU00000,2023-07-27T02:22:40Z
transaction,6defa4d8-7a4c-4a3b-b8e7-54ae0bdae1f1,posted,Coffee Shop Purchase,-846.61,1c73d890-33b4-400a-8103-1eead14b89b8,3162.95,debit,bank-fee,AU00000,2024-03-06T04:25:31Z
transaction,52f7a345-2faa-46c2-8db4-da899dc9c61d,posted,Clothing Store Purchase,-4580.05,3e5c5ed4-7b6c-4fb7-8581-71b6e560723a,-1417.1,debit,payment,AU00000,2023-09-07T12:47:18Z
transaction,136a6c49-7c03-45e2-8870-ef071143e2a9,posted,Car Maintenance Expense,-4113.22,b0b9fa98-c04b-461f-a1c4-dcec32957b90,-5530.32,debit,cash-withdrawal,AU00000,2023-06-11T17:37:26Z
transaction,9597dc16-e9ef-496d-969d-39334d7d197a,posted,Gasoline Purchase,-1661.47,493d1c05-a7e8-4700-a338-cab953af0d78,-7191.79,debit,bank-fee,AU00000,2023-07-02T11:20:57Z
transaction,c86f15fc-1931-456f-8fa4-367a1c728cbe,posted,Manly Maths Tutor Wages,-882.37,321e5eae-150f-4661-bb43-051256546f18,-8074.16,debit,cash-withdrawal,AU00000,2023-05-30T00:16:08Z
transaction,145b8c59-1bd5-4da7-97c4-4c28e806cbf1,posted,Travel Agency Booking,-2295.62,9933d50d-d44e-4eb1-8599-0c13547b30cc,-10369.78,debit,bank-fee,AU00000,2023-06-01T19:07:08Z
transaction,62ca1111-e965-4660-91b3-8a4fad4e2023,posted,Travel Agency Booking,-3132.95,93c3e0de-2d32-4f96-a196-cacaa36c378e,5668.74,debit,payment,AU00000,2023-12-05T23:03:10Z
transaction,84ed2635-a0a0-4f37-9e7d-75a23393e2ba,posted,Gym Membership Fee,-4179.04,b65d7481-1aa3-4811-90b4-c932046f49ba,1489.7,debit,cash-withdrawal,AU00000,2024-02-13T09:46:23Z
transaction,2d836a4c-1fc0-48f2-be25-fec26dfa3653,posted,Public Transport Fare,-2165.41,2a6408fe-03cf-42ae-8419-2fe7c6676d4d,-675.71,debit,payment,AU00000,2023-07-01T03:19:10Z
transaction,4f19ede0-485b-4d75-815c-380d497b4843,posted,Gym Membership Fee,-1006.39,9c06d450-0b4e-4fec-ab72-835d63e5afcb,-1682.1,debit,cash-withdrawal,AU00000,2023-07-18T04:11:33Z
transaction,0817f4bd-5c58-497e-8007-cc43c6cb1898,posted,Wdl ATM WESTPAC IGA BALGOWLAH BALGOWL AU,-1796.34,bac42752-1786-4155-99fc-ce653109be96,-3478.44,debit,bank-fee,AU00000,2024-02-15T13:18:07Z
transaction,b9ef70bf-2dbe-4eb9-a893-65378a5a304c,posted,Uber Ride,-810.99,407ebae1-d5ff-4957-98b3-9a1c6be1bdd9,-4289.43,debit,bank-fee,AU00000,2023-07-07T13:48:46Z
transaction,4111046a-f78f-4b5b-82ff-53abe87d1ee3,posted,Transfer Platnm Homeloan 346454,-2170.72,e206596f-deed-460a-b551-beafc751dbc1,-6460.15,debit,cash-withdrawal,AU00000,2023-08-25T19:04:19Z
transaction,23b05881-2d3d-4aa2-803e-df2604cc5f1e,posted,Pharmacy Purchase,-2346.89,c025b56a-f797-4d90-9c77-25ef91bce00b,-8807.04,debit,cash-withdrawal,AU00000,2024-01-31T09:11:10Z
transaction,bb66d5a6-05c8-418d-b218-32ef429f77b9,posted,Bookstore Purchase,-2297.9,5df63e59-aa99-4bb6-a3bf-38d161a87708,-11104.94,debit,cash-withdrawal,AU00000,2023-09-24T20:02:00Z
transaction,06825846-f453-4ca2-a4b3-a0d453f4fb22,posted,AGL RETAIL ENERGY LTD (GAS),-4152.11,25e51027-1280-4e98-a97f-f5d09df08cf6,-15257.05,debit,bank-fee,AU00000,2023-12-04T13:16:13Z
transaction,96824e6a-8973-4313-9fbc-1c74b8384a15,posted,Online Gaming Purchase,-2762.68,8988746d-6ab7-4bb6-91e3-5d9d30f8a1cf,2900.62,debit,cash-withdrawal,AU00000,2023-06-26T10:35:55Z
transaction,69b11b43-7f04-4d0d-a1ed-34fdcbeca117,posted,Public Transport Fare,-1487.3,8bd690f0-048c-441f-97b9-e97c66ae1eee,1413.32,debit,bank-fee,AU00000,2023-05-30T22:08:42Z
transaction,89f16f97-562c-479b-84bd-aadf8f8005e0,posted,Restaurant Dinner,-3725.75,0f0bbe0c-fda8-41af-ae4f-3ac92f220375,-2312.43,debit,bank-fee,AU00000,2024-02-05T08:07:32Z
transaction,29df4b12-a183-4e58-8a1d-a6634865ea95,posted,Mobile Phone Bill Payment,-1783.56,c0603054-fe05-4d06-9d3c-0464e515ac3c,-4095.99,debit,payment,AU00000,2023-10-14T02:04:00Z
transaction,2b2bf9d6-8910-4750-ba44-107495ecfd64,posted,CTRLINK CARERS Ref: 998R6789201610974V,-2102.66,197f82b0-08b1-4801-b2e6-01fbd714fc70,-6198.65,debit,cash-withdrawal,AU00000,2023-06-13T02:19:51Z
transaction,9f85d8ec-9821-48ac-9f0b-7505828839f7,posted,Home Improvement Store Purchase,-4000.17,9691c47d-420f-4e0a-941a-2101ce9b3ff4,-10198.82,debit,payment,AU00000,2023-06-27T20:11:06Z
transaction,55ababca-8727-4b3f-8ef1-2710f7d636bc,posted,Netflix Subscription,-4733.53,40a43f13-9079-48e4-be3f-22b61d680e8b,-14932.35,debit,cash-withdrawal,AU00000,2023-08-03T05:03:26Z
transaction,397657ef-3d3f-4b41-b771-f4c35edd6e2f,posted,Music Streaming Subscription,-297.99,69d06e10-8fd9-45e9-8431-9f78b9396568,-15230.34,debit,payment,AU00000,2023-07-27T04:50:44Z
transaction,3ab099de-92c6-43df-a8e0-c4e1f00f7056,posted,Uber Ride,-4906.32,ba67893c-e11f-49b7-80b1-022ccce23001,-20136.66,debit,bank-fee,AU00000,2023-11-07T06:43:46Z
transaction,379c72da-e057-4c61-84b8-8d5743764551,posted,Gym Membership Fee,-480.76,eba35dc7-724d-433f-86ea-2b7f25e093d9,-20617.42,debit,payment,AU00000,2024-02-05T10:20:39Z
transaction,dbe00126-29a1-47a8-a53e-425ce340e6cc,posted,Mobile Phone Bill Payment,-2367.69,44c28e4d-ea8a-4b6e-b646-a40b0216a77b,11712.19,debit,payment,AU00000,2024-02-01T17:06:29Z
transaction,077a4bae-b477-4b7f-aaa5-3595658ee216,posted,Clothing Store Purchase,-3737.84,eeb964bd-c043-4f60-8758-bab3611739bf,7974.35,debit,bank-fee,AU00000,2023-12-29T07:40:34Z
transaction,7f0398a2-2277-4afa-8004-d93b093dad86,posted,Pharmacy Purchase,-2745.15,c09a1af7-f2b2-4107-b683-cbb73d21bfbe,5229.2,debit,bank-fee,AU00000,2023-09-26T15:40:11Z
transaction,b7598a03-059d-4878-9601-4a58ae95f8fb,posted,Hair Salon Appointment,-1879.09,1a402758-fff5-4aca-bc38-0faa8711b5c7,3350.11,debit,cash-withdrawal,AU00000,2023-08-27T22:20:01Z
transaction,3f0b2218-8057-4675-8aa2-82bb2b896766,posted,Bookstore Purchase,-628.12,f00ebc3a-eddb-48d2-8713-991242315584,2721.99,debit,payment,AU00000,2024-05-05T23:35:36Z
transaction,3629a235-b1ef-4d3a-8a82-c39737123241,posted,CTRLINK CARERS Ref: 998R6789201610974V,-3159.89,d9f2550a-f221-4176-8841-f28b7ce8eccb,-437.9,debit,cash-withdrawal,AU00000,2023-10-13T03:32:11Z
transaction,65f2028c-5f2a-4eb4-b1d9-f194eafc32bb,posted,Restaurant Dinner,-3794.73,9c540a37-50a2-4fe3-be2c-44888ccc5c9a,-4232.63,debit,bank-fee,AU00000,2024-02-18T04:03:45Z
transaction,7a6b2e4c-a303-4b2c-ae1f-b9d2884c9945,posted,Movie Ticket Purchase,-573.79,06b757cf-6bc5-4448-93d5-6b919de42ecd,-4806.42,debit,cash-withdrawal,AU00000,2023-09-06T17:04:57Z
transaction,0c6fd1fa-00d1-4c26-9703-8bf7de8df53d,posted,Online Gaming Purchase,-724.9,8c2fec28-3226-46fc-8e28-454a4a711e4e,-5531.32,debit,cash-withdrawal,AU00000,2023-08-09T05:29:31Z
transaction,9e51eba3-c73a-4ad8-ab41-27a42736c6fe,posted,Music Streaming Subscription,-390.79,f0e1021b-e8e0-402a-ae3a-dc9d05c4b3ee,-5922.11,debit,bank-fee,AU00000,2024-02-29T20:06:18Z
transaction,f38e0a3e-e702-4c76-9674-9793574575ae,posted,Gasoline Purchase,-3683.08,e0e14164-7644-4cf8-95e7-bb7e2313db18,14760.4,debit,payment,AU00000,2023-07-31T14:46:06Z
transaction,770ac0e8-243e-4e1d-80b9-87388cee7ef8,posted,CTRLINK CARERS Ref: 998R6789201610974V,-576.87,43fd3835-f919-4171-b77d-54c9977a8cab,14183.53,debit,cash-withdrawal,AU00000,2024-04-29T17:52:22Z
transaction,ebdb53cf-93a8-4f4d-9729-1ddee180dacf,posted,Hair Salon Appointment,-2138.3,7571cc30-3ee6-4a4f-b2dd-0458dc44dbf1,12045.23,debit,bank-fee,AU00000,2023-06-26T23:01:26Z
transaction,7bcf423c-fafd-40ca-8676-3b01a36d9ee5,posted,TRANSFER TO JOANNA SMITH CAMPING,-2429.09,bf41272c-33e1-4740-ad85-2f7a85dd63fb,9616.14,debit,payment,AU00000,2024-02-25T05:56:47Z
transaction,79eddf20-93ac-4feb-b75a-892a259ac806,posted,Online Gaming Purchase,-458.94,84506ef2-a8b0-45e3-a493-38492cefe98c,9157.2,debit,cash-withdrawal,AU00000,2023-11-10T05:14:46Z
transaction,146fed84-8cc9-4857-85e0-5093e769774b,posted,Wdl ATM WESTPAC IGA BALGOWLAH BALGOWL AU,-1690.79,5aafbdac-5577-44b4-98cb-3329d2843cf9,7466.41,debit,payment,AU00000,2024-03-01T01:57:34Z
transaction,5d2ff507-f49f-4fdf-89a1-e9a45ab30e69,posted,Clothing Store Purchase,-3186.75,c5be2c8e-d1db-474d-b24c-72a790395532,4279.66,debit,payment,AU00000,2023-11-07T05:16:44Z
transaction,895487e9-0bb4-48b9-b8e3-7ad00305c8d9,posted,Pharmacy Purchase,-1191.61,91417710-2dd0-40c8-8f69-c1bdb2ee7242,3088.05,debit,payment,AU00000,2023-07-13T09:04:03Z
transaction,a3ed7619-6658-4484-b63c-c4cb1c59db2f,posted,Manly Maths Tutor Wages,-2707.74,27f571aa-ac92-48b3-a88c-f45a6455c115,380.31,debit,bank-fee,AU00000,2023-10-24T18:24:45Z
transaction,4d11cb23-25f1-46bd-b6c1-a89027df3135,posted,Uber Ride,-421.25,c11d1b4c-880a-4dea-b5b2-d910b3ec6c46,-40.94,debit,bank-fee,AU00000,2023-10-31T02:17:57Z
transaction,b60e79f8-6119-43bc-a2b7-15108a710ab5,posted,Car Maintenance Expense,-4293.55,c5fc443b-9437-4c0d-b243-48c44458c7c0,12456.47,debit,payment,AU00000,2024-01-29T23:27:01Z
transaction,6fb1c68a-4206-4ef5-8512-b5a7ab23edde,posted,Mobile Phone Bill Payment,-91.9,67438a5a-bac6-4747-b474-f707c2998d53,12364.57,debit,payment,AU00000,2023-11-10T05:46:56Z
transaction,214e51c9-25ef-4516-b56c-c7acabf14e54,posted,Music Streaming Subscription,-4012.39,4adcf910-fae8-45bf-bcec-58cf2fc0f7a6,8352.18,debit,cash-withdrawal,AU00000,2024-02-06T08:24:29Z
transaction,221cdf0c-28db-4fe9-9729-1da8d103b878,posted,Music Streaming Subscription,-1162.79,e5a11caa-ec9d-40d8-a57c-d553094b33cb,7189.39,debit,cash-withdrawal,AU00000,2023-07-04T10:44:26Z
transaction,0ecdbe12-1700-47d7-8732-16fc83576d61,posted,Music Streaming Subscription,-2405.99,7bb7bd44-dc96-416e-b3b0-331ca6a87750,4783.4,debit,cash-withdrawal,AU00000,2023-05-28T01:37:14Z
transaction,2f16ca9a-6c94-496f-be11-3bcb1651fad6,posted,Gasoline Purchase,-1421.15,70c68e98-f698-4a5e-aff8-4ffb020579c7,3362.25,debit,cash-withdrawal,AU00000,2023-08-05T14:19:38Z
transaction,d77ef4f6-79ae-4cec-9703-61cf6b959719,posted,Movie Ticket Purchase,-3347.1,fafdc973-34c4-456b-9e9c-6db4d4fe4020,15.15,debit,bank-fee,AU00000,2024-03-24T02:48:51Z
transaction,272d9919-1d30-4232-be5a-e31b58e8c2fe,posted,Public Transport Fare,-2802.05,af76a560-0a64-46af-9396-12dc04918f17,-2786.9,debit,bank-fee,AU00000,2023-12-16T10:59:12Z
transaction,ad3d6e79-c88f-403e-ae56-57d5d2907b40,posted,Payroll WFRMS 15439393,11408.29,8d56c4f6-d069-4498-9934-33360e2e4da6,8621.39,credit,transfer,AU00000,2023-11-07T03:48:40Z
transaction,be4a5291-b871-42c9-95df-5bb6d9939678,posted,Online Gaming Purchase,-1203.73,4d291b80-3220-4687-ba5a-bc6942d606a0,7417.66,debit,bank-fee,AU00000,2023-12-25T17:23:21Z
transaction,75814869-c7a3-468c-8055-5c96721a0f61,posted,Pharmacy Purchase,-213.1,5a0c6f16-7628-49a5-a49b-94fa34a4fc2c,13300.4,debit,bank-fee,AU00000,2023-09-24T18:43:51Z
transaction,44d5396b-600a-4e2d-a77d-e470057e1731,posted,Restaurant Dinner,-2500.93,f702450e-9c83-4987-9027-489436bb5654,10799.47,debit,payment,AU00000,2023-11-28T21:42:09Z
transaction,a11bb45d-f44d-44c5-ba20-4ccee1618d04,posted,Coffee Shop Purchase,-4501.19,7760a57b-7186-44bb-887e-d620539c1061,6298.28,debit,bank-fee,AU00000,2023-05-22T14:37:45Z
transaction,d48aaf95-8887-4171-9bab-4dc5fa2219db,posted,Hair Salon Appointment,-3454.71,fab6453b-ae6b-40ec-a6bf-e31556f75b51,2843.57,debit,payment,AU00000,2023-05-21T16:29:02Z
transaction,dca46926-0f55-4fd7-af09-597558a273b1,posted,Gasoline Purchase,-2142.04,b589a04f-1747-405a-822d-008325b6cb03,701.53,debit,payment,AU00000,2023-08-12T02:03:18Z
transaction,2e3788a0-4d7e-40c1-9581-12da44804aca,posted,Online Gaming Purchase,-3720.83,c9c7a9fa-b6a2-411d-a8c1-f1288cd4f7ac,-3019.3,debit,payment,AU00000,2023-07-17T08:05:57Z
transaction,85e95705-0a93-4667-9753-df4dd95c2107,posted,AGL RETAIL ENERGY LTD (GAS),-4399.06,9af435a8-0ba1-477b-bcc7-e2bef4f36f7b,-7418.36,debit,bank-fee,AU00000,2023-09-10T07:35:11Z
transaction,14df315c-66f5-4f8a-9c1a-8743e5ffb452,posted,Electricity Bill Payment,-179.2,2a1a43ff-9f9d-43fc-8656-457850d42db4,-7597.56,debit,bank-fee,AU00000,2024-03-03T18:03:23Z
transaction,eed79ff5-f5a5-44dd-8016-a1e4dd857029,posted,Uber Ride,-1745.11,d2c48ebe-aa0b-4cdb-a24b-1a1d1e768e4d,-9342.67,debit,bank-fee,AU00000,2023-11-23T00:09:47Z
transaction,155c9be1-cd1c-4542-ba62-b05f7e91952c,posted,Gym Membership Fee,-1754.53,b9264323-9462-4001-8421-f3e69bde43a2,-11097.2,debit,payment,AU00000,2024-04-26T18:39:59Z
transaction,89b2437a-8665-4a2f-938a-199327329a79,posted,Electricity Bill Payment,-302.78,4407ace2-1e81-4d0a-8720-622685239c30,12003.62,debit,cash-withdrawal,AU00000,2023-10-12T06:19:56Z
transaction,4c06e435-9efe-4535-b898-def8fc0c2ff7,posted,Bookstore Purchase,-1152.84,506cd890-a811-417d-be4b-f35e903ccd72,10850.78,debit,cash-withdrawal,AU00000,2023-09-23T04:24:26Z
transaction,bd602839-d81f-43c2-9f43-ac42ccdf71c1,posted,Wdl ATM WESTPAC IGA BALGOWLAH BALGOWL AU,-2882.71,15265a3d-54cc-4575-a7a2-da95b258f071,7968.07,debit,cash-withdrawal,AU00000,2023-06-05T06:06:46Z
transaction,1b1faba3-6c39-4dce-be32-11def636ea8d,posted,Online Gaming Purchase,-417.56,295a82e0-b072-4f40-b48b-a148c3e46b66,7550.51,debit,payment,AU00000,2023-08-28T02:42:52Z
transaction,a697600c-3c8b-4002-87a9-a2ee771fc22c,posted,Uber Ride,-1712.08,b696b06c-929f-49b1-91ae-58ef655229e7,5838.43,debit,payment,AU00000,2024-01-14T17:29:50Z
transaction,e0e491c0-d9e3-4576-aea4-2710977fba6f,posted,Car Maintenance Expense,-1544.65,a98ee660-fd1c-4574-8503-447471db0e5b,4293.78,debit,payment,AU00000,2024-05-08T03:04:45Z
transaction,bc4257e6-f921-4176-bf21-a67002201e11,posted,Uber Ride,-1440.13,fc9bacff-c90f-49b9-8b48-bc1f3b040695,2853.65,debit,bank-fee,AU00000,2024-01-01T00:12:04Z
transaction,e002b775-6f34-4387-92d6-21424e158ae9,posted,Music Streaming Subscription,-1246.28,74baf298-828f-4c89-9a60-b692a6831447,1607.37,debit,cash-withdrawal,AU00000,2024-03-29T17:37:40Z
transaction,762af590-9314-42f0-b860-f7bd7c7b0508,posted,Mobile Phone Bill Payment,-1209.4,991eee0a-3fa3-437a-ac09-bacd76ced656,397.97,debit,cash-withdrawal,AU00000,2023-09-12T23:37:42Z
transaction,ef3c378e-d028-40ad-87d9-2b9833d4c38d,posted,Pharmacy Purchase,-1739.44,05014657-b4d2-4978-8a19-d2c3bd511b71,-1341.47,debit,payment,AU00000,2024-02-26T15:49:31Z
transaction,06c742d5-456b-477a-83d7-f5c565cb8965,posted,Clothing Store Purchase,-4736.32,9bd81b1d-d34b-401a-b4ae-7638288103fb,2100.25,debit,payment,AU00000,2023-05-28T08:48:52Z
transaction,ef15401e-7595-492f-8714-1320641845c4,posted,Hair Salon Appointment,-1790.42,b03211d3-c66c-4cd1-a024-c5a47a104954,309.83,debit,payment,AU00000,2023-08-05T07:29:15Z
transaction,4f9a330a-62d5-4e0e-b325-e3a841c47a0c,posted,Pharmacy Purchase,-3780.4,ebff6149-08ad-44af-a515-8f88db46ffe8,-3470.57,debit,cash-withdrawal,AU00000,2023-05-29T07:18:48Z
transaction,413ce703-c1ff-4310-94b1-57f367d0b6e6,posted,AGL RETAIL ENERGY LTD (GAS),-3600.01,89e5d69c-da4f-486c-8c00-816ac29df397,-7070.58,debit,cash-withdrawal,AU00000,2023-05-15T14:31:55Z
transaction,39691ec8-8d2a-4c5f-a953-8b1d2af795e4,posted,Non Hooli ATM Withdrawal Fee,-4541.95,8beebb4a-afdb-4f14-a212-38f16a5dc254,-11612.53,debit,bank-fee,AU00000,2023-07-18T01:17:08Z
transaction,4be4353b-ae05-422a-9c12-063102b3c4fd,posted,Mobile Phone Bill Payment,-2785.36,32d663ab-b8ac-4f9e-a87d-f84c41d8b5f8,-14397.89,debit,payment,AU00000,2023-09-30T10:02:35Z
transaction,f83da659-262c-45cb-8bdb-b03dc2b7557e,posted,Amazon Online Shopping,-607.42,c992edf3-fd8f-4b7c-a390-5468c3d987f0,-15005.31,debit,payment,AU00000,2023-09-27T16:57:38Z
transaction,6a2f0672-18f9-4f16-a630-524e5c9d781f,posted,Non Hooli ATM Withdrawal Fee,-2462.62,d44bb689-7ebb-4368-95bc-3e5b369b05b1,-17467.93,debit,bank-fee,AU00000,2023-11-26T23:24:03Z
transaction,8883732e-e9c9-4fe4-8d2e-fa6f6e7e37ca,posted,Bookstore Purchase,-1975.04,3f7c5c72-a069-4048-9bee-b7e56c99add9,-19442.97,debit,cash-withdrawal,AU00000,2023-11-30T15:45:41Z
transaction,8ed026d9-2c16-48bb-9f66-60ce205f64e8,posted,Mobile Phone Bill Payment,-3334.75,021e1a15-fc11-47e8-bd0c-efd7ed81b9aa,-22777.72,debit,bank-fee,AU00000,2024-03-26T17:44:14Z
transaction,4f7c6c54-2828-43d4-bb3f-9074ed23d02b,posted,Payroll WFRMS 15439393,10740.6,2edd5ddb-488b-44d8-a143-284defd89f0e,27545.02,credit,transfer,AU00000,2024-02-23T22:49:53Z
transaction,56410ef0-9d1c-4eec-8f2f-4d6ee48aff47,posted,Electricity Bill Payment,-4677.84,46a79119-f16f-4298-885d-89b58afa7dc9,22867.18,debit,cash-withdrawal,AU00000,2023-11-02T14:14:27Z
transaction,c33b7254-1d2f-49d5-bd78-c605fbf4e0d3,posted,Wdl ATM WESTPAC IGA BALGOWLAH BALGOWL AU,-1597.05,f53fb435-460b-4ab4-957a-f3cfbb9bbad2,21270.13,debit,payment,AU00000,2024-04-03T15:41:10Z
transaction,738d12c9-fc53-4dfe-8d6c-8040325b7be1,posted,Payroll WFRMS 15439393,10103.56,9ce66be9-462f-462e-b82b-6e88120977fb,31373.69,credit,transfer,AU00000,2023-07-15T16:07:53Z
transaction,d418e4be-59e7-4853-8f30-e3d26e2dec26,posted,Amazon Online Shopping,-644.54,b1ad036e-9566-4884-b53f-9dc6d1be179d,30729.15,debit,bank-fee,AU00000,2024-01-26T15:34:44Z
transaction,8e7c4ee6-d272-4b33-a95b-c5853749bc3f,posted,Wdl ATM WESTPAC IGA BALGOWLAH BALGOWL AU,-2243.5,6a4bcffd-63b0-4ed9-b821-f87a29ee6ea1,28485.65,debit,bank-fee,AU00000,2023-05-16T15:46:37Z
transaction,b8932761-ff2d-47ed-89cd-5b75d0d8f471,posted,Payroll WFRMS 15439393,11385.45,1698f390-b0cb-44fd-9b78-aefd5bdc7013,39871.1,credit,transfer,AU00000,2023-11-09T10:29:53Z
transaction,1f2c3dc6-ef2a-4d77-94cf-fa0368c3617c,posted,Mobile Phone Bill Payment,-4594.75,d965d41e-c172-4a60-9be6-8aa779c65b7e,35276.35,debit,payment,AU00000,2023-12-04T18:35:17Z
transaction,ea0a588a-32a2-484f-a302-8b6b99a65ebc,posted,AGL RETAIL ENERGY LTD (GAS),-3535.05,bbdb120d-a4dc-4328-89e1-51c0fd26e9f0,31741.3,debit,cash-withdrawal,AU00000,2023-07-13T18:09:19Z
transaction,4e75a026-cbe0-4f08-a236-2a5a657663c6,posted,Restaurant Dinner,-4717.8,48671b46-fdbb-46c1-bb93-a13a1b69bd83,27023.5,debit,cash-withdrawal,AU00000,2023-08-16T13:55:21Z
transaction,138ffa6e-066a-4dd0-b9c4-66205958f80f,posted,Transfer Platnm Homeloan 346454,-3956.87,0261425a-631b-4ac4-bf8b-eb227dc4684a,7171.36,debit,payment,AU00000,2024-02-14T16:42:29Z
transaction,063a8adc-c713-4def-8627-3f3e2c78ef41,posted,Hair Salon Appointment,-2412.08,8eb65a23-fecc-4382-8326-770bcf7d4888,4759.28,debit,bank-fee,AU00000,2023-09-25T12:06:51Z
transaction,d37d84dc-99bc-4806-85ea-a05e097501f4,posted,Restaurant Dinner,-1182.5,9ba26968-6bb1-42c2-bfae-e2d6ce219ae6,3576.78,debit,cash-withdrawal,AU00000,2023-06-26T12:33:32Z
transaction,c24e30a6-110e-4581-a3f4-c034022aaf92,posted,Hair Salon Appointment,-1002.46,8edc27f8-dbde-47e7-90fb-8e2610546c1a,2574.32,debit,payment,AU00000,2023-08-27T01:45:55Z
transaction,4f80ce2a-44ec-466f-9cdf-763d8b903c96,posted,Movie Ticket Purchase,-2285.56,4f9b9dc8-d2e2-4b78-b547-2b6e51e6603b,288.76,debit,bank-fee,AU00000,2023-07-14T20:01:51Z
transaction,7e38dca7-522b-4694-ba46-5fda9c325566,posted,Pharmacy Purchase,-351.27,d7651566-d220-45ee-89d9-0cf80bc0bb7e,-62.51,debit,bank-fee,AU00000,2023-10-14T06:20:59Z
transaction,1bef8d45-e371-45c5-a299-80a5ec8a168d,posted,Wdl ATM WESTPAC IGA BALGOWLAH BALGOWL AU,-3426.6,65aa9420-e9c2-4641-8c43-845a90baaf6d,-3489.11,debit,bank-fee,AU00000,2023-06-19T07:44:21Z
transaction,a990e2df-bf8e-49de-866b-fbc3c7a14f9c,posted,Amazon Online Shopping,-3138.63,33730cd1-d320-4516-b0a4-9316cdb010d1,-6627.74,debit,bank-fee,AU00000,2024-05-06T22:39:42Z
transaction,76cc8d2b-22a5-4115-9266-1391d9f5b15b,posted,Public Transport Fare,-770.0,b0b21ae1-5822-47c1-bcbd-9fcff4832beb,-7397.74,debit,cash-withdrawal,AU00000,2024-01-02T17:37:51Z
transaction,80758074-7803-43ea-bced-ae9d051e9e78,posted,Netflix Subscription,-1040.94,86219f08-7bfc-40cc-9acb-53cc7a49b3db,-8438.68,debit,payment,AU00000,2023-10-07T12:43:37Z
transaction,572ed10b-a7c8-4759-9f47-2e0f25d446d7,posted,Netflix Subscription,-3607.34,907fe24e-a690-4dda-9c58-9d615e5a60c7,6211.55,debit,payment,AU00000,2023-11-18T03:03:42Z
transaction,d2cdead7-09eb-4abb-a32f-c6743a88105f,posted,CTRLINK CARERS Ref: 998R6789201610974V,-3704.61,fa1c4e58-d9e2-43c5-8fdd-1ddb441aa319,2506.94,debit,payment,AU00000,2024-03-19T19:28:06Z
transaction,1615fd74-05db-4b66-aa78-8b13de7a0822,posted,Uber Ride,-1094.68,a4c52685-713c-4e2d-b243-05d191bc2249,1412.26,debit,bank-fee,AU00000,2023-05-13T09:16:20Z
transaction,6e2a621e-8956-46e6-a1da-68a5ded0b757,posted,TRANSFER TO JOANNA SMITH CAMPING,-3397.82,89650c72-b9e4-4664-97ab-d5fc1a95a9c4,-1985.56,debit,payment,AU00000,2024-04-21T14:53:57Z
transaction,f67c8db5-02d2-45c6-8624-dc9b3a2257f8,posted,Uber Ride,-4395.01,72b8ef43-d111-4a41-a57e-4e58d3d6c140,-6380.57,debit,payment,AU00000,2024-03-21T04:16:11Z
transaction,d25108f7-f690-45ef-9b5e-710d75245673,posted,Non Hooli ATM Withdrawal Fee,-597.24,dedebb17-996b-4eb4-9431-d5ef12ddb4b9,-6977.81,debit,cash-withdrawal,AU00000,2024-01-22T00:38:22Z
transaction,832c2d17-bd67-477a-a531-d1785494a53f,posted,Home Improvement Store Purchase,-3771.71,856defdc-09e2-4951-b685-3da7a6831c8b,-10749.52,debit,payment,AU00000,2024-02-11T19:18:00Z
transaction,373befc7-4a24-44dd-a2d9-94f83dde40c9,posted,Music Streaming Subscription,-491.68,fd562a22-6e80-47c1-bffb-af60f72c0789,-11241.2,debit,bank-fee,AU00000,2023-07-21T17:09:52Z
transaction,7e3063fd-a155-4ecb-bf13-d4facb544a19,posted,Uber Ride,-1676.76,7dd61887-6b18-4e2b-aae7-baf78d058161,-12917.96,debit,bank-fee,AU00000,2023-09-23T18:28:41Z
transaction,5a92373f-a0de-4d49-a9da-2cc89957c03c,posted,Uber Ride,-709.88,13de83d8-b02d-4bc7-a2bf-de5e1d62fb36,-13627.84,debit,payment,AU00000,2024-04-24T12:30:01Z
transaction,7da3e459-9add-4d45-9960-4f2d1d711c67,posted,Restaurant Dinner,-2697.62,6684d568-4364-4ce0-ba30-02ae8c8def6d,4209.21,debit,payment,AU00000,2024-02-24T09:37:21Z
transaction,5d6a0f1b-b747-45eb-ae45-b5e3dec6f6ba,posted,Gasoline Purchase,-1880.86,1f3ac24e-b530-44e9-8f44-ce1c93b2fa4f,2328.35,debit,payment,AU00000,2024-01-22T23:16:59Z
transaction,eb3265ef-e1c2-4361-b3a3-66be2bc042a2,posted,Car Maintenance Expense,-3440.23,ec2dbe7f-2ed8-46b7-889d-e4a66f7c6a31,-1111.88,debit,bank-fee,AU00000,2024-03-22T18:01:33Z
transaction,902d9762-7122-43bc-960b-98ed0898d231,posted,TFR Acc14000 TO 12389,-4776.24,37bfa70f-ae0d-42c8-ba3f-bd41036956aa,-5888.12,debit,payment,AU00000,2023-07-16T09:28:45Z
transaction,e76e9324-258e-4f51-9376-ef471d48e858,posted,Home Improvement Store Purchase,-4373.12,0ef368b6-375e-4a3a-b6c6-fcb47682d232,-10261.24,debit,cash-withdrawal,AU00000,2023-12-29T15:12:55Z
transaction,8540c193-f346-49a8-b22f-f7edf12a08f5,posted,Manly Maths Tutor Wages,-228.48,706236ea-b2c7-49b6-9d4b-0b73fcd12f63,-10489.72,debit,cash-withdrawal,AU00000,2023-12-18T12:26:52Z
transaction,75834fef-9249-400c-a46c-832402cdaba3,posted,Hair Salon Appointment,-2842.67,15c02138-6c3b-4ba4-a352-de5738e1894c,-13332.39,debit,cash-withdrawal,AU00000,2024-01-27T11:52:04Z
transaction,844c6daf-1672-4ee6-9c65-d997ab74025a,posted,Public Transport Fare,-3665.02,ec5cb87f-4a76-4fe2-8eff-202f0256b4ca,-16997.41,debit,cash-withdrawal,AU00000,2023-09-14T09:16:54Z
transaction,4896ae44-ae5a-42f8-91d6-8f69bcc64e1e,posted,Clothing Store Purchase,-4632.98,df3e5ba1-15c8-41de-9dbc-d8a8af2f9555,-21630.39,debit,cash-withdrawal,AU00000,2024-01-09T12:58:28Z
transaction,60e86c98-a4ee-4a4a-9354-0e1cca205cd9,posted,Manly Maths Tutor Wages,-4803.42,f4af7e72-8273-4e2d-ad3f-00c5e6a9bd70,-26433.81,debit,bank-fee,AU00000,2023-11-01T12:20:02Z
transaction,f2648847-8a73-46be-a0e3-67dbdc51361c,posted,Non Hooli ATM Withdrawal Fee,-4868.27,a1c42069-ef27-48d9-8270-95ddf1808cba,8266.01,debit,payment,AU00000,2023-08-22T19:02:00Z
transaction,29261aaf-a866-49a3-b26d-45d3c435c761,posted,Hair Salon Appointment,-2050.47,d92f871c-0d05-4e63-82d3-97a10f7e747b,6215.54,debit,payment,AU00000,2024-01-08T15:30:25Z
transaction,656ac246-aa06-4c62-847a-550a824db58d,posted,Bookstore Purchase,-1524.87,42f984fa-0b51-4832-9bb2-b7768aa89901,4690.67,debit,cash-withdrawal,AU00000,2023-06-22T00:57:26Z
transaction,36fcc101-9a85-461e-a3f1-5de0dba46892,posted,Transfer Platnm Homeloan 346454,-496.19,5d178775-80b7-4210-8132-299e124f22ef,4194.48,debit,payment,AU00000,2024-01-01T17:36:19Z
transaction,011c535c-cda2-4c69-9ad0-c223122bcd9c,posted,Non Hooli ATM Withdrawal Fee,-377.95,06914ac0-040e-49c9-86cf-f43c7600387a,3816.53,debit,bank-fee,AU00000,2023-11-17T02:50:24Z
transaction,b23f88b2-d32f-43d6-a96d-346f505471be,posted,Gym Membership Fee,-1780.37,517e57b6-8459-4877-859e-8d98d0c43873,2036.16,debit,cash-withdrawal,AU00000,2023-12-27T11:31:43Z
transaction,ebc9d83c-ccfe-4616-b6f1-062c00e86e47,posted,Pharmacy Purchase,-3619.62,742884bb-893c-4e25-8c2d-04252123013a,-1583.46,debit,cash-withdrawal,AU00000,2024-03-27T11:51:07Z
transaction,4a9c222c-8116-477d-bb64-4d136c5dc6c3,posted,Pharmacy Purchase,-3817.18,b7874518-a8db-454b-92e3-39beb5ef7bdc,-5400.64,debit,payment,AU00000,2023-05-17T00:15:36Z
transaction,f410025f-39d5-4b82-a760-c616dc218af1,posted,Bookstore Purchase,-3600.17,6b8a09c5-8ebc-4854-a80c-6cdb50ba597f,-9000.81,debit,cash-withdrawal,AU00000,2023-11-14T12:39:43Z
transaction,e3c65020-2276-4b70-9f20-c567e2748ef5,posted,Public Transport Fare,-2660.97,d64210e9-5f40-499f-b7e6-8f481477094b,-11661.78,debit,bank-fee,AU00000,2023-06-23T16:10:26Z
transaction,d7db19f2-349d-404e-a33a-46bbfebeaf63,posted,Hair Salon Appointment,-1721.85,956c41f8-b354-48fa-b9e7-758dbce4471a,12162.2,debit,bank-fee,AU00000,2024-01-10T00:07:14Z
transaction,b6d39c5f-8e58-43cf-ac09-d9ad529eed47,posted,Coffee Shop Purchase,-1621.24,bf2d217c-d889-4699-b312-6c1187e95c82,10540.96,debit,payment,AU00000,2023-09-06T15:13:27Z
transaction,ad8cbc9b-bb1e-43c7-9f20-1950b5af6897,posted,Home Improvement Store Purchase,-2217.14,3a367af3-42ec-4a2c-bcce-1c26504d5415,8323.82,debit,cash-withdrawal,AU00000,2023-06-23T09:34:47Z
transaction,e745a366-fbfd-4a78-be79-e7dbfcef3eca,posted,Gasoline Purchase,-441.9,a7153635-be1a-4077-af6c-8faa1d3dd06e,7881.92,debit,bank-fee,AU00000,2024-01-03T21:22:37Z
transaction,713674b5-4331-449c-8ec2-44597698b282,posted,Non Hooli ATM Withdrawal Fee,-673.3,6b5af372-2d8a-4d9b-b1cb-4f64d678b947,7208.62,debit,cash-withdrawal,AU00000,2023-07-16T01:07:48Z
transaction,174a8711-0907-4f79-8ebf-17ac58ebaa35,posted,CTRLINK CARERS Ref: 998R6789201610974V,-1004.43,672b2abc-b2d8-4efb-8592-e8dabfdd84e3,6204.19,debit,payment,AU00000,2024-04-30T20:45:50Z
transaction,a882b468-7f4d-4645-96ed-f66787c67122,posted,Amazon Online Shopping,-4740.75,2166aa57-b8d3-4bee-8e2b-f55d73ce8b11,1463.44,debit,bank-fee,AU00000,2024-03-25T15:55:07Z
transaction,5f99f2e5-bd66-451f-b322-77b84cb03ba7,posted,Car Maintenance Expense,-152.43,b558dbc2-6c1d-4f03-b245-613cdeea06c2,1311.01,debit,cash-withdrawal,AU00000,2024-03-15T02:19:52Z
transaction,cd7799f0-f17c-482c-bb7a-de663de36069,posted,Wdl ATM WESTPAC IGA BALGOWLAH BALGOWL AU,-4366.95,f4e1c9b5-67f0-44ed-bc32-a73397e0407e,-3055.94,debit,bank-fee,AU00000,2023-08-17T20:59:01Z
transaction,d202eaf5-6452-400e-a82f-b3603a6c0b4f,posted,Gym Membership Fee,-4514.84,e4bce137-3022-443b-a42f-2e5201601cc2,-7570.78,debit,payment,AU00000,2023-08-27T21:13:16Z
transaction,bb3af32e-9a56-4c6f-9d77-cd8e93353077,posted,Netflix Subscription,-1609.32,846d66f5-e2a5-4ce1-b53e-924a67094778,8625.04,debit,bank-fee,AU00000,2023-07-12T21:55:16Z
transaction,349a1c1b-4515-4188-8472-77ead48a5d4f,posted,Netflix Subscription,-3927.24,e57d1984-3d0e-4fc7-b251-dc5fe10e3ebe,4697.8,debit,cash-withdrawal,AU00000,2023-07-01T02:49:49Z
transaction,b86ce7e6-1751-4ac9-9f1f-dde38458de72,posted,Online Gaming Purchase,-963.24,efca8049-86d7-45b8-9252-416e7217a38b,3734.56,debit,payment,AU00000,2024-03-29T13:36:23Z
transaction,863f5682-129d-4836-873e-10a62a6b7ea3,posted,Movie Ticket Purchase,-2659.89,d017b4e2-fa1a-45f1-8db1-ad031a3e26e4,1074.67,debit,cash-withdrawal,AU00000,2024-02-27T12:53:21Z
transaction,6ded080d-e36b-410f-99ff-2127558cb483,posted,Public Transport Fare,-2400.89,9f176fc6-a958-44fa-9c51-491f5eb1ca04,-1326.22,debit,cash-withdrawal,AU00000,2023-11-24T13:11:25Z
transaction,951f9c9b-01a0-4f13-b31e-db767357e162,posted,Bookstore Purchase,-4489.66,68ff7497-835b-43f9-a4d3-32c0b524bd10,-5815.88,debit,bank-fee,AU00000,2023-12-13T11:03:37Z
transaction,28b6cdc6-f2ce-43c4-88cb-7dc25ffd9e21,posted,Hair Salon Appointment,-1930.02,19d3e928-63b1-4352-8447-d6c7e0b2f4e6,-7745.9,debit,payment,AU00000,2023-10-20T15:29:11Z
transaction,067d0f1c-b225-40a0-9ee0-bf4239d40560,posted,Electricity Bill Payment,-3064.56,f01b4486-1fd7-40e1-b3a0-90dae3398bbe,-10810.46,debit,cash-withdrawal,AU00000,2023-06-05T03:11:13Z
transaction,8e6846d9-e394-4573-adad-0acf671795ce,posted,TRANSFER TO JOANNA SMITH CAMPING,-2931.06,36c785a8-f029-4a58-8295-ef2b7713c00a,-13741.52,debit,payment,AU00000,2023-12-17T01:59:49Z
transaction,5063dc73-a61e-4a93-9169-de45ef4ff328,posted,Hair Salon Appointment,-4157.65,9a25208d-ddcb-4244-be9b-c02b34064940,-17899.17,debit,payment,AU00000,2024-02-09T08:44:45Z
transaction,15b8473a-cfb1-4f73-96dc-2fc9a9cc7c5a,posted,TRANSFER TO JOANNA SMITH CAMPING,-1102.47,53be4416-c309-4a62-8250-6cfb845165c2,16752.9,debit,bank-fee,AU00000,2023-08-23T03:10:59Z
transaction,717d307f-9537-4b69-90c0-091f454db62d,posted,Payroll WFRMS 15439393,11392.92,fd39acfe-50b7-44a6-9c30-063cc688dda5,28145.82,credit,transfer,AU00000,2023-10-31T03:05:32Z
transaction,b952eebe-8dcc-4a3c-8de3-3725d9226b26,posted,Gasoline Purchase,-462.27,47a80f60-9355-4142-ad0b-e440af0e0f01,27683.55,debit,bank-fee,AU00000,2023-07-23T01:25:53Z
transaction,63992e6f-45b8-4524-8c4f-1cc33ef36f8e,posted,Wdl ATM WESTPAC IGA BALGOWLAH BALGOWL AU,-3258.62,e7967453-72dc-4a71-b1db-675021fe994e,24424.93,debit,payment,AU00000,2024-04-09T12:13:09Z
transaction,07848b6c-f1c2-4d20-971f-4f0bb6224635,posted,Non Hooli ATM Withdrawal Fee,-589.73,6cfe2af1-6ea4-4b75-91b8-3ccf282b33c7,23835.2,debit,payment,AU00000,2023-11-10T06:12:11Z
transaction,39b115db-9edc-4753-945b-c9d0150c530d,posted,Netflix Subscription,-329.24,c8b13e5c-bdd0-4126-bd90-87b154ae3ca7,23505.96,debit,bank-fee,AU00000,2024-04-05T11:35:34Z
transaction,5678813f-6c70-43c8-8743-525d29489afc,posted,Online Gaming Purchase,-1785.76,e7cb9e76-93b4-4cef-bed3-677a924fef20,21720.2,debit,payment,AU00000,2023-07-03T13:50:42Z
transaction,e60e9a97-24d3-4367-ae45-a78d2fa2628c,posted,Travel Agency Booking,-921.89,b3d7ab69-bfe9-435d-b1cc-08959a0a58e1,20798.31,debit,payment,AU00000,2023-12-14T08:47:47Z
transaction,b8b5cf52-6b70-47f9-ad5a-bb43979cf146,posted,Hair Salon Appointment,-1894.38,c2149bd1-a741-4c59-beb4-4287511ff9b8,18903.93,debit,cash-withdrawal,AU00000,2024-03-30T17:07:04Z
transaction,93ad68cf-4290-483b-a5e6-4ee883e2588e,posted,Non Hooli ATM Withdrawal Fee,-2149.99,a6280de2-4b8b-4cb3-a90c-65776f898d3f,16753.94,debit,cash-withdrawal,AU00000,2024-02-13T10:05:12Z
transaction,892079d3-ea70-43c6-9d26-b7079cb5e023,posted,Mobile Phone Bill Payment,-921.15,71cc6d23-235e-41ca-a8a8-1612a35e35e4,4520.29,debit,payment,AU00000,2024-01-11T09:41:12Z
transaction,09629d58-e383-4b0a-82ed-0d37138994f4,posted,Manly Maths Tutor Wages,-125.71,75b0a16a-abea-4881-a865-50a5975437ed,4394.58,debit,bank-fee,AU00000,2023-09-15T23:07:50Z
transaction,a4a31811-6588-4e9d-8764-c17e0bfffbd8,posted,Bookstore Purchase,-4871.6,0d6ebc01-9e6d-4974-8ca6-34235874eda8,-477.02,debit,payment,AU00000,2023-07-18T04:45:12Z
transaction,f9b2311c-d6ad-40af-a531-6c12977f3a86,posted,Netflix Subscription,-1166.75,45c62fb8-fd0d-4505-86e5-9d91597ac760,-1643.77,debit,payment,AU00000,2023-06-07T08:22:06Z
transaction,0a75a56e-70a6-4d90-95f2-6f7deda8ae29,posted,Transfer Platnm Homeloan 346454,-492.16,a72234a8-cae8-422c-b149-13152d88b483,-2135.93,debit,bank-fee,AU00000,2023-12-29T04:50:36Z
transaction,7c36377f-7103-44bd-ac84-f1b3c839f6dd,posted,Bookstore Purchase,-3186.46,5d71ba52-46c1-466a-b695-c3e4e6757a80,-5322.39,debit,bank-fee,AU00000,2024-03-27T05:10:12Z
transaction,755f56f6-ae7d-4427-946d-e9c2d0aec488,posted,Gasoline Purchase,-4026.23,362f034f-fa79-4b40-8118-4b5c76b9e37b,-9348.62,debit,bank-fee,AU00000,2023-08-23T11:08:01Z
transaction,a0960c47-822a-417c-9131-a0877252e935,posted,Electricity Bill Payment,-3881.03,57f7c385-1b64-4034-855f-7adbb669fea2,-13229.65,debit,cash-withdrawal,AU00000,2023-10-15T16:05:55Z
transaction,826573ca-3bdb-4a5b-9edd-b77b477a7007,posted,Bookstore Purchase,-4956.99,09903fa6-e16a-4c08-92ac-c353ce8ccb11,-18186.64,debit,bank-fee,AU00000,2023-11-16T08:42:42Z
transaction,312b8073-54bd-43c9-8c2f-6a29523701b9,posted,Electricity Bill Payment,-2853.62,e505da60-0fdd-45e9-a26b-4aa71573c7d9,-21040.26,debit,cash-withdrawal,AU00000,2023-11-16T23:58:59Z
transaction,198a5070-cd52-4486-9245-77e52c1a8400,posted,Payroll WFRMS 15439393,10627.77,92f0b90a-2516-420d-a548-e2975e95a45e,30272.43,credit,transfer,AU00000,2024-05-07T00:05:17Z
transaction,8b985341-7c35-4583-987c-9d24976d301a,posted,Wdl ATM WESTPAC IGA BALGOWLAH BALGOWL AU,-2177.87,e8b2a2ac-07c9-454f-8c60-5e71f9a718b0,28094.56,debit,bank-fee,AU00000,2023-09-11T01:35:19Z
transaction,22116e5c-fdeb-4bba-b1c6-8cfb22e87b3c,posted,Gasoline Purchase,-4294.14,f8556bf2-33bc-48e9-bca0-fa8949181e15,23800.42,debit,payment,AU00000,2024-03-05T12:41:01Z
transaction,0ce7036f-2a4b-4ece-a155-140e1a3e3408,posted,Amazon Online Shopping,-4252.65,ec299d23-05eb-48c7-b988-1cd88b00f1a5,19547.77,debit,bank-fee,AU00000,2023-09-19T01:27:08Z
transaction,ec41d07d-75f9-44a2-b161-102c68fe926e,posted,Wdl ATM WESTPAC IGA BALGOWLAH BALGOWL AU,-2283.16,5ecd74ff-e94d-4f35-873a-d973e7f0c18b,17264.61,debit,bank-fee,AU00000,2023-11-12T14:04:11Z
transaction,3d73a846-5de8-43bb-b4d9-8f5570e06aa7,posted,Movie Ticket Purchase,-3916.44,f1bfbca9-5d5b-4afe-85e4-81f756118e51,13348.17,debit,bank-fee,AU00000,2023-11-28T00:26:25Z
transaction,353e9f51-3bab-4d29-90a3-4a595dad011c,posted,Clothing Store Purchase,-1438.79,4eb0332f-004c-4b27-a13c-4d1db565969f,11909.38,debit,cash-withdrawal,AU00000,2024-05-06T12:44:09Z
transaction,b2a372e0-2dea-473f-ab10-5641f645efc1,posted,Hair Salon Appointment,-4863.62,af9050a3-1352-4de3-9c12-dafa770576a3,7045.76,debit,cash-withdrawal,AU00000,2024-01-14T03:09:52Z
transaction,f7ba30d4-2219-4bcc-b608-294fadc34ca4,posted,Mobile Phone Bill Payment,-3864.55,a9185b55-d968-4fe6-b8fd-814788719910,3181.21,debit,payment,AU00000,2023-07-12T00:32:48Z
transaction,ef331c73-b937-4fe7-9142-707a4740eadd,posted,Gasoline Purchase,-1722.43,75e26dce-48d6-46f3-b535-64db742aec04,1458.78,debit,bank-fee,AU00000,2024-02-24T14:23:03Z
transaction,6c79b517-c670-4b7c-8026-95ea3e215335,posted,Clothing Store Purchase,-16.38,b30cea8b-a4d4-4e16-b764-53e184b0fb43,5897.01,debit,cash-withdrawal,AU00000,2023-10-24T21:21:07Z
transaction,236d27f2-9572-4668-8907-91c0bc84b7c8,posted,Amazon Online Shopping,-3554.94,3f48a96f-75ce-404e-ad26-a51fdee8129f,2342.07,debit,payment,AU00000,2024-01-11T15:09:59Z
transaction,05e3d5d7-16c5-4a1b-8c27-2c651cc22cd1,posted,Electricity Bill Payment,-3230.44,9dd941d1-45e9-4c1d-8ec3-ca432e25054e,-888.37,debit,cash-withdrawal,AU00000,2023-07-21T19:46:11Z
transaction,556ba7bc-162c-4b0a-85c6-32138a2946a3,posted,Gasoline Purchase,-286.27,64e9cc3a-1bbe-4404-9f9d-ec4c49a01ac9,-1174.64,debit,cash-withdrawal,AU00000,2024-04-03T05:06:47Z
transaction,3cdf68f0-7175-48cc-b426-35d6817f9670,posted,Restaurant Dinner,-4824.03,45b9b009-45c5-4c4b-ba04-b7d89e7a6596,-5998.67,debit,cash-withdrawal,AU00000,2024-04-25T04:58:09Z
transaction,746c1c71-99fd-4e39-ae71-721f5b5d8d65,posted,Non Hooli ATM Withdrawal Fee,-1237.23,2a57e7ef-7db3-42c2-a0aa-4e0c52354d3b,-7235.9,debit,bank-fee,AU00000,2023-10-03T08:29:12Z
transaction,9140178c-2064-49df-a502-6938e21135ee,posted,Wdl ATM WESTPAC IGA BALGOWLAH BALGOWL AU,-1966.29,49d860bc-336f-43a4-b76a-38d7e330d983,-9202.19,debit,payment,AU00000,2024-02-10T15:38:43Z
transaction,bbf2bdf6-8855-4802-b180-ab09d0491758,posted,Pharmacy Purchase,-4442.58,424160ea-de55-4c7d-9c61-291765ea4351,-13644.77,debit,cash-withdrawal,AU00000,2023-07-08T10:19:18Z
transaction,444ee6e3-3665-40fd-a526-e120c5d404fc,posted,Hair Salon Appointment,-4362.62,12397ce1-e34b-4368-8372-4d85639631a2,-18007.39,debit,cash-withdrawal,AU00000,2023-05-15T23:47:24Z
transaction,05945649-e8b2-4f01-8dcd-3fb6d3127d81,posted,TRANSFER TO JOANNA SMITH CAMPING,-157.89,407978e4-b61d-4d76-986b-a1f2378c46e9,-18165.28,debit,cash-withdrawal,AU00000,2024-02-18T15:06:19Z
transaction,5a6308d8-4ae9-46c2-b610-08bd6df43f3b,posted,Wdl ATM WESTPAC IGA BALGOWLAH BALGOWL AU,-1291.55,9e05035d-d928-4c06-944c-bddd7095c78c,15570.92,debit,cash-withdrawal,AU00000,2023-07-17T15:14:13Z
transaction,757a8920-55a9-4791-a6ca-01ed2085e45e,posted,Uber Ride,-2133.3,237e41be-0855-495b-b142-640b77a60a37,13437.62,debit,cash-withdrawal,AU00000,2024-01-28T20:45:07Z
transaction,a48925b3-9641-48b0-af72-1321aa02c3c0,posted,Netflix Subscription,-3265.32,3fb0c8d2-0c3e-437a-87b5-8a6f5f7931c2,10172.3,debit,cash-withdrawal,AU00000,2024-03-26T21:38:23Z
transaction,3596b84a-2796-4886-a0d0-ee8f642f2e1c,posted,Movie Ticket Purchase,-2303.14,1ff8a5c4-7aad-4dca-be57-021ef15b9254,7869.16,debit,payment,AU00000,2023-05-12T09:54:19Z
transaction,b7f69e6c-42db-4186-965f-9a7fe5fce650,posted,TRANSFER TO JOANNA SMITH CAMPING,-1357.94,a77354ee-8ff5-4404-813c-6bd1eea101ce,6511.22,debit,payment,AU00000,2023-08-26T18:58:35Z
transaction,f9dfd1e0-70aa-41bf-b9dc-49efb3fe1c76,posted,Clothing Store Purchase,-4653.2,036d59cd-0e37-49b8-bb85-c418ea042fa6,1858.02,debit,payment,AU00000,2024-02-24T12:11:08Z
transaction,fd08409c-4427-45e8-8be5-5e5f3280f78d,posted,TRANSFER TO JOANNA SMITH CAMPING,-4750.35,6df989ec-af21-4c52-b5bc-94459c8d8ac4,-2892.33,debit,payment,AU00000,2024-01-14T11:44:26Z
transaction,40c3ed42-b789-4a68-8fed-06a9bf53a300,posted,Movie Ticket Purchase,-1381.16,fc2f3299-0e88-4966-af90-4bc504b1a1fc,-4273.49,debit,cash-withdrawal,AU00000,2024-03-03T22:42:59Z
transaction,036275ed-5964-4f66-b0f7-d6c1985c272a,posted,Gym Membership Fee,-3029.78,4aeae15b-42ba-4978-bca4-140d7ba8d7fa,-7303.27,debit,cash-withdrawal,AU00000,2023-09-22T16:26:24Z
transaction,c0b95c67-93b9-45e2-b004-6570e83b5197,posted,Hair Salon Appointment,-948.34,636a9748-5c57-446d-add8-5d73ae699ebe,-8251.61,debit,cash-withdrawal,AU00000,2024-02-01T11:23:30Z
transaction,13571bb8-ddc1-4507-9f26-1770924be509,posted,Wdl ATM WESTPAC IGA BALGOWLAH BALGOWL AU,-17.49,68a6f403-fe34-45ff-b791-c55dd675da54,5509.13,debit,payment,AU00000,2023-12-14T11:01:34Z
transaction,30f614db-50f9-4711-95fb-8c3dd917a98a,posted,Uber Ride,-461.32,5a2120d6-cca5-47d7-9a33-e9487ba4037c,5047.81,debit,bank-fee,AU00000,2023-06-01T04:38:35Z
transaction,b473de23-33d7-4b38-9f08-c38162e3ea5d,posted,Electricity Bill Payment,-2288.04,d747c9c3-8388-4a20-ae60-d0ffefeb77ac,2759.77,debit,payment,AU00000,2024-03-01T19:31:20Z
transaction,58cce94f-a8fe-494d-a78f-0a652675e9f8,posted,Payroll WFRMS 15439393,10083.31,8d56aa92-f578-454f-8f1b-7e2353a995f0,12843.08,credit,transfer,AU00000,2023-10-11T20:42:45Z
transaction,f0a2a183-354a-4fcc-8716-8cd50d463e3f,posted,Car Maintenance Expense,-1717.83,4462ba30-22a9-44ec-b5c1-e5ab73926710,11125.25,debit,cash-withdrawal,AU00000,2023-12-14T12:17:57Z
transaction,a1c84e5b-59b3-47e0-9e9e-788af41c59c5,posted,Hair Salon Appointment,-4980.73,9ba032ed-30f6-4b41-a9cd-d8026bf367b2,6144.52,debit,cash-withdrawal,AU00000,2024-02-05T23:19:42Z
transaction,d684911f-499c-4277-9d82-5e95a45c2829,posted,Mobile Phone Bill Payment,-836.34,1d3a75bb-51df-4cc7-ab95-e2d874e79cc9,5308.18,debit,payment,AU00000,2024-01-01T03:40:41Z
transaction,4c5070ca-5fe0-4142-9049-821ce2d5f2f1,posted,CTRLINK CARERS Ref: 998R6789201610974V,-1211.33,476ebc77-06fa-4c74-a341-f38907f2697f,4096.85,debit,cash-withdrawal,AU00000,2023-08-04T19:46:42Z
transaction,6b48edc6-3552-4558-9214-a11fd30da9e1,posted,Pharmacy Purchase,-3817.0,23e297b1-b8e8-4527-8b97-7c0bef76d674,279.85,debit,payment,AU00000,2024-01-11T16:14:01Z
transaction,78dfb093-f2b6-4235-afc5-442a8069a662,posted,Public Transport Fare,-4896.91,2ff4bf18-8379-46ec-ae41-fdf990f78a48,-4617.06,debit,cash-withdrawal,AU00000,2023-10-23T19:17:18Z
transaction,1ac39b9f-9521-445d-ace1-361781497708,posted,Transfer Platnm Homeloan 346454,-1469.06,29d38346-f7d3-40e8-a2b3-793ae672afe0,14396.94,debit,bank-fee,AU00000,2023-07-11T20:11:51Z
transaction,33905ba8-2f1e-4a7e-b23c-6bd8b22be2c9,posted,Online Gaming Purchase,-1837.72,5ef00419-4461-4bdd-8bc1-9cfa20445324,12559.22,debit,cash-withdrawal,AU00000,2024-04-21T22:41:41Z
transaction,8ac25d77-dcee-4cc1-84d1-73792e64653f,posted,Payroll WFRMS 15439393,10481.77,56ed2fe4-75ba-4b4a-a0cb-f72f4b71c57b,23040.99,credit,transfer,AU00000,2023-06-17T10:25:20Z
transaction,144c5e3d-fc01-4980-9ef5-a4aecc9a2cf1,posted,CTRLINK CARERS Ref: 998R6789201610974V,-265.17,56fa9067-4106-4d81-9c27-f6c25860c533,22775.82,debit,cash-withdrawal,AU00000,2023-06-10T21:21:37Z
transaction,50e7eb8b-ec92-48a9-bcde-b3c2d9d3d592,posted,TFR Acc14000 TO 12389,-2943.77,ea95d2d4-78bb-4dae-9856-280052e2f0c1,19832.05,debit,payment,AU00000,2023-12-18T04:43:32Z
transaction,ec063ea5-a4a2-4001-b11f-179d0716c789,posted,Music Streaming Subscription,-4577.26,02c74b15-38d4-491a-8c88-5757cf1cf72c,15254.79,debit,bank-fee,AU00000,2023-09-24T22:29:07Z
transaction,17e66510-a1c3-4d90-9216-75d87fa98cf4,posted,Clothing Store Purchase,-2760.82,28b2f28d-913e-4a69-9ec2-1cfe163ec6bc,12493.97,debit,cash-withdrawal,AU00000,2023-12-13T17:34:19Z
transaction,4505f5cd-d2ba-4587-8cf2-fa07c1dfe525,posted,Netflix Subscription,-2902.27,6071ce6e-16d4-4f97-b73b-bcb9910cb6c0,9591.7,debit,bank-fee,AU00000,2024-03-17T11:20:13Z
transaction,613fe7f4-09fb-4fd2-9766-14309a95be56,posted,Clothing Store Purchase,-32.42,f2fa9a00-5030-462b-810b-86672390018b,9559.28,debit,payment,AU00000,2023-05-22T06:54:15Z
transaction,e042ee33-0238-4542-8237-cd0099ba3079,posted,Music Streaming Subscription,-3231.65,b90bef77-1d7f-41b8-91ce-ad1c01f6d162,6327.63,debit,cash-withdrawal,AU00000,2024-02-17T14:08:12Z
transaction,f6c265e5-2f9f-401f-8c5f-f35a3aba528d,posted,Gasoline Purchase,-2757.52,dfd1aeda-bac5-41c7-92ed-44e218ba558c,10956.36,debit,bank-fee,AU00000,2023-08-15T10:59:39Z
transaction,599175dc-e3a6-47b0-91c9-d5304ac6c54c,posted,TFR Acc14000 TO 12389,-3495.78,e870ec98-8afc-4e45-bc0a-2c8bda126209,7460.58,debit,cash-withdrawal,AU00000,2024-02-27T14:35:10Z
transaction,ae6daf6f-9509-48e0-9c92-3cb9608d4289,posted,Public Transport Fare,-4743.3,8fcb1a7e-fc46-41f1-be00-11d23ceea12f,2717.28,debit,payment,AU00000,2024-04-05T23:05:54Z
transaction,f955d5f3-bfc9-4d48-aada-7df7b5e1d5a4,posted,Travel Agency Booking,-3901.52,3e0d24d2-6347-438c-9d05-7796340a5d78,-1184.24,debit,bank-fee,AU00000,2023-09-19T16:16:36Z
transaction,88a217d8-9126-478d-bc0a-7ca1f68bdf91,posted,Transfer Platnm Homeloan 346454,-3337.6,ca048ba0-ca63-4ea8-8010-b5e28ffe0045,-4521.84,debit,bank-fee,AU00000,2024-03-29T14:27:46Z
transaction,817eb9ce-b76d-4518-8114-6ec7dccb0b6a,posted,Netflix Subscription,-84.18,14b08655-41df-43a8-8b67-64b311a223bf,-4606.02,debit,bank-fee,AU00000,2023-07-21T13:15:41Z
transaction,cc8039d2-90f0-44d5-8793-30ea9fbe736d,posted,Gym Membership Fee,-3357.02,be59dee4-2577-4019-806b-26908ebaa54c,-7963.04,debit,cash-withdrawal,AU00000,2023-05-31T16:28:20Z
transaction,cb9db242-d5d8-477b-a7a3-fc6b6fa56c4a,posted,Online Gaming Purchase,-4737.4,75b32418-962a-4a1d-a132-91e212dc319e,-12700.44,debit,payment,AU00000,2024-01-11T19:51:55Z
transaction,6f622352-b9ab-4671-9d12-6879662d5802,posted,Music Streaming Subscription,-4850.01,5f451d74-6846-4e2a-9c43-178423972b19,-17550.45,debit,bank-fee,AU00000,2023-07-19T23:32:40Z
transaction,c652c053-e152-4611-887e-cc437f38be3d,posted,Payroll WFRMS 15439393,11113.89,0abb4f2c-0980-4bfc-bccb-d2a3dc1f66ae,-6436.56,credit,transfer,AU00000,2023-10-02T05:48:47Z
transaction,a07fa654-8de9-4cfc-bf18-0467e2c54155,posted,Music Streaming Subscription,-4590.8,051ee770-55e3-423d-8d21-9ad4f78b4e24,11461.26,debit,payment,AU00000,2023-12-09T05:56:28Z
transaction,89daffa9-0f7c-4b93-94e4-aa741b44b781,posted,Hair Salon Appointment,-4861.76,4d11b0d9-8c05-49f8-9271-ef89eaf12752,6599.5,debit,cash-withdrawal,AU00000,2023-06-21T02:48:07Z
transaction,76f097df-04aa-48a4-bcba-cdd26954e6c9,posted,TRANSFER TO JOANNA SMITH CAMPING,-2272.45,1033e228-2c40-4121-9e2c-ce57e6e1cbce,4327.05,debit,payment,AU00000,2023-10-20T10:11:30Z
transaction,072b8ce1-9164-4d82-ac6e-13fc2bb05c77,posted,AGL RETAIL ENERGY LTD (GAS),-1592.6,2446466c-abbc-4182-b6da-823f003f34eb,2734.45,debit,bank-fee,AU00000,2024-01-25T01:37:48Z
transaction,3ff4e53c-d49a-46a2-801c-2eab994cb2d6,posted,Wdl ATM WESTPAC IGA BALGOWLAH BALGOWL AU,-571.9,00943f7a-9c3c-4e79-a500-13df1c35847b,2162.55,debit,bank-fee,AU00000,2023-12-23T10:19:21Z
transaction,18d79eb3-791e-40ab-ad37-26ab8ea7e382,posted,Netflix Subscription,-3806.77,16e33cde-dd18-4f66-b212-dc146a947ce6,-1644.22,debit,payment,AU00000,2024-01-07T01:57:09Z
transaction,0d06e62c-899d-4c5e-9d49-8378f6052721,posted,Music Streaming Subscription,-1778.07,699c9644-e94c-4b95-b167-b0a3d2b8c244,-3422.29,debit,payment,AU00000,2023-12-04T09:42:55Z
transaction,55fbe82e-1282-4afe-b376-36bf85678a23,posted,Manly Maths Tutor Wages,-900.19,ed4b67ee-a38c-4205-a229-9b583b732e38,-4322.48,debit,cash-withdrawal,AU00000,2023-05-14T00:17:05Z
transaction,7d818245-8710-4e6d-a00e-2710d29f44a4,posted,Hair Salon Appointment,-585.91,fbe8280c-435f-4fbc-bc3b-ff93150237c3,-4908.39,debit,payment,AU00000,2023-05-30T09:23:01Z
transaction,25479a77-9666-46ae-8a4b-e4a7d102641a,posted,TFR Acc14000 TO 12389,-3508.65,35598578-d7d2-439d-8ad9-baf182f9600b,-8417.04,debit,payment,AU00000,2023-06-01T13:09:37Z
transaction,02f12d7f-808b-41eb-a370-055af4805e93,posted,Gym Membership Fee,-521.99,e22e0356-f7fe-49ee-abce-d5504fb72f86,16895.21,debit,payment,AU00000,2023-06-27T21:27:58Z
transaction,28a16f36-707f-40a0-873d-ec50355f298d,posted,Clothing Store Purchase,-711.8,e0519ef4-85f7-46a2-811e-5c20eb229a02,16183.41,debit,bank-fee,AU00000,2023-10-27T05:58:34Z
transaction,ed9ff74c-f65a-402b-be19-dabdd91d4bcb,posted,Home Improvement Store Purchase,-4329.14,9d96fa8b-0394-4586-a7a3-073aa206cb5c,11854.27,debit,bank-fee,AU00000,2023-12-08T23:36:12Z
transaction,2c0aa1c1-3de1-4b2d-b4e8-205f5d342f1e,posted,Gym Membership Fee,-500.48,36838b02-e515-401f-b4e0-7ac38059f9cf,11353.79,debit,bank-fee,AU00000,2023-06-22T02:44:47Z
transaction,a7dfc1ec-af33-4ba9-9b0c-accc4d7050b7,posted,Travel Agency Booking,-1079.78,c8c39bf1-4c6c-4429-af3e-182f73fac3ec,10274.01,debit,cash-withdrawal,AU00000,2023-11-14T04:19:14Z
transaction,a0ff832a-e499-4105-8433-452eb36cde12,posted,Movie Ticket Purchase,-3013.04,7447ee7d-c23e-4993-8da1-abc4f35955a9,7260.97,debit,cash-withdrawal,AU00000,2024-03-20T20:56:59Z
transaction,241cae82-459a-47fd-b51c-fb6fead16a6f,posted,Bookstore Purchase,-4956.3,caed6c3d-06a6-4e29-8e84-50f4939cdc1d,2304.67,debit,cash-withdrawal,AU00000,2024-02-05T19:18:04Z
transaction,6dce5080-5ef3-44b0-a664-a387edfc8b70,posted,Transfer Platnm Homeloan 346454,-4077.7,c155a05e-faf2-42d1-a300-5749597d8cb2,-1773.03,debit,payment,AU00000,2024-03-27T13:03:41Z
transaction,31004ea4-716c-42dc-ab60-b700734b6089,posted,Uber Ride,-1628.85,55710a74-cb16-436d-8965-047b578f3454,-3401.88,debit,bank-fee,AU00000,2023-08-27T05:43:27Z
transaction,ea318169-0951-4ae4-a7e5-04e5ff39c683,posted,TRANSFER TO JOANNA SMITH CAMPING,-2209.9,76df1d65-63f2-431e-a7b7-5c487444782d,-5611.78,debit,payment,AU00000,2023-10-22T14:43:01Z
transaction,09f17567-f9d2-4a74-8929-404f1a886e82,posted,Bookstore Purchase,-3699.15,41dec131-3244-49ce-8213-6eaa8882d6ae,1635.45,debit,payment,AU00000,2023-12-30T10:44:41Z
transaction,9a4568c4-7cae-4a1d-8280-760b9db0b7a2,posted,CTRLINK CARERS Ref: 998R6789201610974V,-128.22,af69e663-65c6-47c9-a176-f0e641d0ffcd,1507.23,debit,payment,AU00000,2024-01-12T14:03:29Z
transaction,a0e5b14b-0c56-4fee-9eaa-b8f70c163e67,posted,Gym Membership Fee,-4225.84,16aa0ee3-3986-466e-b755-7ab21428dcdc,-2718.61,debit,bank-fee,AU00000,2024-03-24T08:33:22Z
transaction,8006add1-5973-480b-b7cf-369e8959265a,posted,Public Transport Fare,-3636.96,08955a4c-3bf7-4982-9aba-f531507544f1,-6355.57,debit,payment,AU00000,2024-01-09T01:54:56Z
transaction,40f38b99-b95d-4a7b-ae84-28610a459f4c,posted,Gasoline Purchase,-1682.98,e14a6dd5-323a-45a8-bae7-0ab58cbc07b7,-8038.55,debit,bank-fee,AU00000,2023-07-15T09:21:49Z
transaction,d9d221b0-6a6f-4c51-89f4-b88040abc275,posted,Manly Maths Tutor Wages,-3721.39,2194b7c8-d8ff-461e-b536-1f967321151d,-11759.94,debit,bank-fee,AU00000,2023-07-25T21:04:13Z
transaction,a4ee1be9-4443-4f02-a825-34a270fdab20,posted,TRANSFER TO JOANNA SMITH CAMPING,-2641.41,a7915046-2270-4103-892e-7ed688e36270,-14401.35,debit,payment,AU00000,2023-10-04T23:15:32Z
transaction,ce8a229c-fe5d-4880-b3be-a626359fc3f3,posted,Coffee Shop Purchase,-2735.36,19b9eb0f-d207-4f25-92bc-3d0074a8ad0d,-17136.71,debit,payment,AU00000,2024-03-12T16:46:59Z
transaction,317c25a3-e76e-4f79-a46d-908993886e93,posted,Non Hooli ATM Withdrawal Fee,-3555.34,95dbb995-2f1e-4575-8dc0-2569ea17be51,-20692.05,debit,payment,AU00000,2023-06-12T21:18:34Z
transaction,0d80d957-120b-4b61-b393-7fb763e130ac,posted,Gym Membership Fee,-2509.89,561aaafa-2dad-4bce-93f1-a06f7bf7d40b,-23201.94,debit,payment,AU00000,2023-11-03T18:15:03Z
transaction,d2561f90-9069-440d-98ff-751853b4fb1e,posted,Transfer Platnm Homeloan 346454,-3501.23,49933923-36c8-4b87-9d01-bd3a1e9ecc85,6733.63,debit,cash-withdrawal,AU00000,2023-11-09T03:45:49Z
transaction,96317133-5b83-40c7-a48a-7ab24014e2c2,posted,Payroll WFRMS 15439393,10615.76,f817601d-68be-4fd3-a743-283331ac9c26,17349.39,credit,transfer,AU00000,2023-10-11T06:49:15Z
transaction,11f15dda-758a-444a-93ca-853ff46bf725,posted,Netflix Subscription,-3443.95,101d4ece-efb3-4a7a-8a07-998d46a2e711,13905.44,debit,bank-fee,AU00000,2024-02-21T15:31:20Z
transaction,16daafb4-3076-46d5-83b3-2b71bdd5b9ef,posted,Netflix Subscription,-1340.74,f81460fb-7b9b-47ea-9376-28091d3e345a,12564.7,debit,cash-withdrawal,AU00000,2024-03-02T01:31:17Z
transaction,5ca361a6-49ef-4642-8d49-6af4c7e1d80d,posted,Clothing Store Purchase,-3001.09,bb524c26-2720-4101-9fe1-ec6aa4b45a65,9563.61,debit,bank-fee,AU00000,2024-02-03T23:59:09Z
transaction,efbbcbbe-3e56-43fd-841c-3f652a1a590f,posted,Electricity Bill Payment,-2079.7,45a9388c-e514-424d-889d-c029cace9a37,7483.91,debit,payment,AU00000,2023-10-04T07:45:10Z
transaction,de1afbc5-40bd-4795-8d4f-ba03d493111f,posted,Car Maintenance Expense,-3826.02,1894d782-fd5b-4d43-85b1-191e702e6c71,3657.89,debit,bank-fee,AU00000,2023-10-23T16:53:02Z
transaction,6cae54ed-5fde-48f6-8e30-118bfe0b02b3,posted,Hair Salon Appointment,-4812.49,d7718ff9-925d-4e1e-b2bd-ab7286c06650,-1154.6,debit,cash-withdrawal,AU00000,2024-01-28T08:32:29Z
transaction,301308ee-0286-4654-84ea-69fccc20cdce,posted,Gym Membership Fee,-4541.22,76b6dadb-e21d-458b-9f5a-aab6a6968bff,-5695.82,debit,payment,AU00000,2023-09-07T10:18:24Z
transaction,fa780b15-f17f-4fae-98c3-77910e515b6c,posted,TRANSFER TO JOANNA SMITH CAMPING,-601.01,1d4d7386-696b-4b7b-bf5a-3cedaefc9e8c,-6296.83,debit,bank-fee,AU00000,2024-02-07T03:04:17Z
transaction,c6cb41e0-54d0-4f35-866a-bb05dcac2753,posted,Coffee Shop Purchase,-1425.33,dead0c5f-0103-4455-af71-5163b73e6f12,6952.29,debit,cash-withdrawal,AU00000,2024-01-13T12:34:13Z
transaction,0b8cd2a0-031d-4fee-8c1e-8ec75ab5a9c5,posted,Online Gaming Purchase,-524.28,ad862287-6dcf-413f-90fa-12a70aa92a33,6428.01,debit,cash-withdrawal,AU00000,2024-03-24T02:25:44Z
transaction,8aba0478-c2d0-475c-8396-746c7b54f60f,posted,Non Hooli ATM Withdrawal Fee,-2623.97,b596277c-f664-4089-bac0-ea25643c1ad5,3804.04,debit,cash-withdrawal,AU00000,2024-05-05T03:37:57Z
transaction,17e01a73-7aa2-4e5a-9243-b2a6aa5bd303,posted,Mobile Phone Bill Payment,-3011.43,62db1521-af56-4daf-9bcb-faa4702ee711,792.61,debit,bank-fee,AU00000,2024-01-21T01:32:01Z
transaction,14530fcf-caf4-49c4-8a96-f2a7ef39cec0,posted,Mobile Phone Bill Payment,-3325.56,b9783702-0e70-411a-9b22-1876e145b825,-2532.95,debit,cash-withdrawal,AU00000,2024-02-03T09:47:42Z
transaction,f39c32c5-2902-47e1-b2ab-fe2a08393412,posted,Travel Agency Booking,-4192.24,6aaba175-cb1e-433b-944a-58e3a95a3bf7,-6725.19,debit,cash-withdrawal,AU00000,2024-04-10T08:56:04Z
transaction,b3484ef5-26b3-49cc-b40c-e8a81571f25b,posted,Home Improvement Store Purchase,-2183.16,d762cbc2-c4f5-4c0f-96f1-b6139fc17f00,-8908.35,debit,bank-fee,AU00000,2024-02-25T11:10:24Z
transaction,a66bca87-8ef7-4ed6-8140-f8977f274ecf,posted,Car Maintenance Expense,-2313.4,3073bff6-129f-4f14-862f-2fca236fdd2f,-11221.75,debit,payment,AU00000,2023-08-13T06:28:38Z
transaction,a2b5792c-adc1-4016-8e0b-c3b0f17cfe26,posted,TRANSFER TO JOANNA SMITH CAMPING,-261.26,033af6bc-9ecf-4e3e-b8f8-0083fdab43d4,-11483.01,debit,bank-fee,AU00000,2024-04-04T04:34:39Z
transaction,4e038227-59fd-4c12-bed2-12b679b6977b,posted,Pharmacy Purchase,-3229.03,64599158-bd7a-4f16-bf84-2e3d533c1c9b,-14712.04,debit,payment,AU00000,2023-11-15T12:25:07Z
transaction,cf10cc55-2ffe-4fe7-b551-a4e8f49eeda9,posted,Car Maintenance Expense,-1983.62,ad0e2e07-09e4-4614-916f-a0cd36c6abcb,7654.12,debit,bank-fee,AU00000,2024-04-06T17:09:42Z
transaction,f5c2a43d-1ed0-4181-aff3-0b2e909cd665,posted,Uber Ride,-1311.36,a1edc457-325d-4034-b1ae-417c955e7399,6342.76,debit,payment,AU00000,2023-06-15T15:10:08Z
transaction,62cdae20-5f87-4a43-9b93-75fa8162520b,posted,Netflix Subscription,-4731.57,eaf2fb71-31f2-4dc7-a8a6-39bafc565d71,1611.19,debit,payment,AU00000,2024-02-05T18:11:52Z
transaction,633f9a8a-4089-46d9-9903-ca697c04885d,posted,Amazon Online Shopping,-2505.99,42d36fda-4376-4555-a9c6-a05149dd896a,-894.8,debit,bank-fee,AU00000,2024-01-05T04:28:54Z
transaction,90d12a71-2a06-40e5-b60d-a64b4e547386,posted,Pharmacy Purchase,-2803.41,0154b9e8-1b5d-4f70-af59-e035112f328a,-3698.21,debit,payment,AU00000,2024-01-22T22:08:07Z
transaction,672d1716-93ae-4a27-8efe-4ee0f37e65ff,posted,Movie Ticket Purchase,-2122.54,ad358511-b172-4d69-8dea-0ba96f59fe23,-5820.75,debit,payment,AU00000,2024-04-21T07:38:03Z
transaction,c917a249-36af-4b31-a606-579f82f7437b,posted,Music Streaming Subscription,-3583.72,8a687333-8821-41b1-a453-8a11205c90e0,-9404.47,debit,bank-fee,AU00000,2024-03-31T23:55:27Z
transaction,819e63a6-7271-4a15-a903-108528f1639f,posted,TRANSFER TO JOANNA SMITH CAMPING,-4448.99,9e9fdb60-b610-46a4-a736-f767bd61bab4,-13853.46,debit,payment,AU00000,2023-05-24T04:38:52Z
transaction,12c41e1c-2f9e-4f7e-b0a1-0d8602658af8,posted,Clothing Store Purchase,-3356.05,da9afe43-23ac-44e7-b574-99da7bcaa6c6,-17209.51,debit,bank-fee,AU00000,2023-05-26T23:32:16Z
transaction,83731419-046f-4ba0-a640-9d7a5657ac1a,posted,Car Maintenance Expense,-1156.5,f728065e-ae1f-47b4-9743-74a5d88e1fa3,-18366.01,debit,payment,AU00000,2023-07-19T10:46:08Z
transaction,4220b59b-d4ae-4cb1-944b-cfd8861be91d,posted,Uber Ride,-1963.16,9246d858-dedd-4f2c-a0a0-421c42aad3cc,7617.27,debit,cash-withdrawal,AU00000,2023-07-06T20:14:49Z
transaction,f8259fe7-9251-4575-be27-9cdf4d5dee6c,posted,Travel Agency Booking,-2259.06,facf7d7d-8ebd-4bed-b52c-da5be8d381fa,5358.21,debit,cash-withdrawal,AU00000,2024-04-29T17:14:34Z
transaction,fc1fb1ab-7882-4c1a-b713-5312374f92d7,posted,Coffee Shop Purchase,-492.02,ab705732-61c5-4ea4-b096-d20836d9a53f,4866.19,debit,cash-withdrawal,AU00000,2024-01-05T16:35:18Z
transaction,9258d84c-d21f-48f8-9b9a-b2ff161aad29,posted,Uber Ride,-4378.02,03b907fe-9e50-4bad-8846-0042bd98cdd0,488.17,debit,cash-withdrawal,AU00000,2023-12-27T20:21:21Z
transaction,c045504a-d968-4922-97fe-3148442859af,posted,Amazon Online Shopping,-1020.38,0b20399c-da53-424f-a001-a6341fc644f6,-532.21,debit,cash-withdrawal,AU00000,2023-10-02T20:30:22Z
transaction,59bd2425-6550-4d64-85dc-c82f9ac11fdd,posted,Online Gaming Purchase,-680.93,fde9fc7a-0c75-429b-b74b-1664cc1c55d6,-1213.14,debit,bank-fee,AU00000,2023-12-12T00:16:53Z
transaction,4e708dbf-4785-4842-9bea-ba014aaa5ad8,posted,Coffee Shop Purchase,-2770.81,11b4159f-8c3d-421a-b23a-b7e7c09c44f5,-3983.95,debit,payment,AU00000,2023-10-07T04:45:08Z
transaction,717af904-d964-4913-b4af-a2da990cd701,posted,Wdl ATM WESTPAC IGA BALGOWLAH BALGOWL AU,-2477.9,334f2b0a-7e63-40cc-9d9f-1168bdcd49ce,-6461.85,debit,cash-withdrawal,AU00000,2024-03-24T17:28:57Z
transaction,826f2638-2b1b-4f6b-bd3c-1b9c7a6a824b,posted,Amazon Online Shopping,-4057.57,db96c21b-f361-40e0-8dd5-9af1650d7d00,-10519.42,debit,bank-fee,AU00000,2024-02-26T23:53:06Z
transaction,85556a6d-0593-472b-9c4c-b2d2f1dd11d8,posted,AGL RETAIL ENERGY LTD (GAS),-1176.16,28b5235a-4f07-4c84-a38e-958d84a1b8e4,-11695.58,debit,cash-withdrawal,AU00000,2024-04-18T00:45:16Z
transaction,900b4a7e-3903-4622-ab3a-ffbbbe8a8e21,posted,Gym Membership Fee,-4129.07,bc4349a3-0167-4776-a488-68cb9eaf7f1c,1161.17,debit,bank-fee,AU00000,2023-12-30T22:44:25Z
transaction,370e679c-5021-49d7-bff2-f425f028e7bd,posted,Clothing Store Purchase,-987.87,861ceb5e-400b-49fc-a9f7-85855296e8eb,173.3,debit,cash-withdrawal,AU00000,2023-10-30T20:58:25Z
transaction,bb586099-8605-4903-b903-fff46eca4fea,posted,Online Gaming Purchase,-1372.65,41ed80c4-faa6-4587-bbbd-1c2b190fd24b,-1199.35,debit,payment,AU00000,2023-08-26T06:16:54Z
transaction,a14018f7-83a3-4dea-b1f0-bdb3bb498b8d,posted,Mobile Phone Bill Payment,-4880.72,cd5a27da-d1b8-41d7-a045-24cecef2de66,-6080.07,debit,cash-withdrawal,AU00000,2023-05-16T16:22:49Z
transaction,55a3560f-c2d7-4392-b1d3-093847bb66cb,posted,Home Improvement Store Purchase,-3367.91,223ee47c-f049-49dc-820c-e4186bd1ebae,-9447.98,debit,bank-fee,AU00000,2023-10-17T02:52:07Z
transaction,28e4acfa-a720-4b27-9c52-bf3bd98429d0,posted,Travel Agency Booking,-3334.87,67af6e3a-27f7-44ff-915c-097e683de90d,-12782.85,debit,bank-fee,AU00000,2023-06-06T13:25:41Z
transaction,a7c57e0d-6cf0-4ab7-a743-2782ecaf5c46,posted,Gasoline Purchase,-1220.65,097ad60e-a1c0-4c67-bc8b-fda5c432ba02,-14003.5,debit,payment,AU00000,2023-09-11T14:45:45Z
transaction,66833bfd-cef3-41ec-9976-b4be2795ea4a,posted,Travel Agency Booking,-3436.25,1ed012ae-4dd5-482b-94d2-839431279cfc,-17439.75,debit,bank-fee,AU00000,2023-07-04T01:04:44Z
transaction,621680bb-503b-49d9-aa9b-8bb453a79364,posted,Restaurant Dinner,-1052.67,c8fca892-4d9e-4483-9e6c-b509663b1dae,-18492.42,debit,bank-fee,AU00000,2024-04-08T13:02:25Z
transaction,e97ce096-29b9-44be-8dfa-1cc4f897275a,posted,Payroll WFRMS 15439393,11058.55,04d110d4-e677-45f9-b900-5154ce14a9af,-7433.87,credit,transfer,AU00000,2024-04-26T13:08:52Z
transaction,0f51cd84-6ed9-475f-99d1-a960d28eee8a,posted,Movie Ticket Purchase,-3768.63,cf5e6e9c-7ba4-42f2-b52a-9c00d77a013d,5251.53,debit,payment,AU00000,2023-05-24T16:26:52Z
transaction,fec2aa9c-2679-4df4-9ebe-2e559e85beac,posted,Electricity Bill Payment,-1775.55,6191295f-38aa-4423-b9f3-c2aa4bfefaf6,3475.98,debit,payment,AU00000,2024-02-20T13:27:53Z
transaction,6febf1d3-8f71-4a2f-a324-0860a417f1b0,posted,Bookstore Purchase,-688.04,b0edbfa3-3a23-4a6c-be7d-4bef67331e3e,2787.94,debit,payment,AU00000,2023-07-04T13:06:05Z
transaction,287ff0ac-4c65-4062-aa3e-29ebff463825,posted,Car Maintenance Expense,-1848.33,a4b5e7d2-ff94-4f72-a321-cc90ca44a0e2,939.61,debit,bank-fee,AU00000,2023-06-15T10:47:47Z
transaction,c1c3933b-fdca-4511-a843-82760640f331,posted,Car Maintenance Expense,-599.06,43a0b543-5cf9-4293-b1a9-13adffc8e282,340.55,debit,payment,AU00000,2024-02-27T17:49:58Z
transaction,ec02f982-3d28-435b-b0c5-a78bb13e84a1,posted,Coffee Shop Purchase,-271.25,51026f1a-f973-474a-bd25-8b137e1ee645,69.3,debit,cash-withdrawal,AU00000,2023-07-20T15:33:50Z
transaction,a2681cc4-f940-4a72-a360-3cb9a33e7594,posted,Hair Salon Appointment,-2749.31,7e47222a-fd25-4044-81ca-60a3fff6b8a2,-2680.01,debit,payment,AU00000,2024-03-31T06:14:42Z
transaction,d9de02c4-cad1-4a75-80ac-43b69fc2bc24,posted,Gasoline Purchase,-1770.72,82b7236f-8f79-4b3c-b9a8-a62dd33feaa9,-4450.73,debit,payment,AU00000,2023-09-09T01:19:49Z
transaction,94bd6c26-669d-4b79-b81f-8c7e74a5a753,posted,Bookstore Purchase,-4545.65,5be6b77a-9499-45bd-ba06-97b5387d2e5a,-8996.38,debit,cash-withdrawal,AU00000,2024-03-30T15:11:59Z
transaction,afd1b06d-57a3-48f2-ab56-cfdf56cbbae8,posted,CTRLINK CARERS Ref: 998R6789201610974V,-3951.96,bcdd2d2f-8525-4e02-9ddf-74db8e803f14,-12948.34,debit,bank-fee,AU00000,2024-02-05T17:45:12Z
transaction,c7f04e91-0b7d-440e-8c6b-df32bc52a097,posted,Music Streaming Subscription,-4620.15,a5e9cb8c-76da-400f-baf3-ca891eb185d6,12289.54,debit,cash-withdrawal,AU00000,2024-02-22T03:36:55Z
transaction,7e7bbf33-c4fc-42b1-a510-80a6a2e7f767,posted,Uber Ride,-248.65,fa42ca11-5fbc-4113-b45d-7a99d6f6c8f9,12040.89,debit,bank-fee,AU00000,2023-12-20T12:36:43Z
transaction,171e01e1-dc45-4904-bb10-05d69461493f,posted,Netflix Subscription,-2769.63,65e3e087-d3e2-4ce7-8f8b-caafedf8e16c,9271.26,debit,payment,AU00000,2023-08-28T03:50:56Z
transaction,f2c95f54-16d9-487c-b245-225a20d1bb8b,posted,Car Maintenance Expense,-259.71,1de1c75e-ad4e-480e-9669-20d5ac55f665,9011.55,debit,payment,AU00000,2023-11-15T17:25:57Z
transaction,b0df00d2-4e62-44ae-bd2a-63b10a475dab,posted,Manly Maths Tutor Wages,-3272.2,92ed229a-35a6-460d-8202-292d8f9e3d6b,5739.35,debit,payment,AU00000,2024-03-16T21:49:23Z
transaction,edd59463-ab66-40bc-826a-a29adfb0ea86,posted,Clothing Store Purchase,-3792.6,bd7410bf-bad6-45ec-8033-9c4d36578de6,1946.75,debit,bank-fee,AU00000,2023-05-22T04:41:35Z
transaction,5662cb53-7bbb-4ad3-9a46-4a2d9e180775,posted,Clothing Store Purchase,-3186.3,25301acc-5921-4e6f-8b24-ed31f68e0aca,-1239.55,debit,bank-fee,AU00000,2023-07-14T09:35:39Z
transaction,2d19e7cd-c68f-4cb1-9daf-b04783a03074,posted,CTRLINK CARERS Ref: 998R6789201610974V,-2010.74,079aba17-d3ca-436a-a7a9-0d612a9e04b4,-3250.29,debit,bank-fee,AU00000,2023-06-05T20:24:37Z
transaction,df8e96b2-a52a-41cf-a941-0b48c596bd13,posted,Travel Agency Booking,-292.81,46857a80-1bce-471b-80b8-3e42d34261dd,-3543.1,debit,payment,AU00000,2024-02-11T19:43:39Z
transaction,a59689e3-824e-4346-8e7e-8bdec2330749,posted,Amazon Online Shopping,-1614.15,cc9403ac-60ff-4bea-935b-1b595da647da,-5157.25,debit,bank-fee,AU00000,2023-05-29T05:25:12Z
transaction,ea183dac-dda4-498e-bd76-a4a843e2efb1,posted,Mobile Phone Bill Payment,-3912.19,bec3df29-5fe4-49e6-b6ce-753c005826e4,11519.1,debit,bank-fee,AU00000,2024-02-02T19:46:38Z
transaction,01618ef0-3f78-4871-bb83-53b109dfef96,posted,Restaurant Dinner,-929.18,a2bc766b-bbe3-4928-a818-bbfd659728c5,10589.92,debit,payment,AU00000,2024-03-02T00:40:28Z
transaction,17314885-d84b-4fe1-9a69-e84928c84614,posted,Mobile Phone Bill Payment,-992.3,dcb18ddc-3aba-4b05-8960-ed8280517839,9597.62,debit,cash-withdrawal,AU00000,2024-01-24T08:03:17Z
transaction,681ed3c4-bbbd-450b-9b96-ae544f47e2f7,posted,Electricity Bill Payment,-2380.27,08bc760e-040a-4a63-b3ed-1206f7dd83de,7217.35,debit,payment,AU00000,2023-08-04T19:41:17Z
transaction,7d42ce86-fd24-4869-b8e9-277fbaa878cb,posted,Clothing Store Purchase,-4615.18,1a59d715-6d64-4118-bd23-1c219fea41fd,2602.17,debit,cash-withdrawal,AU00000,2024-04-22T01:16:38Z
transaction,452ca33a-50d1-4168-b067-62383523dc54,posted,Coffee Shop Purchase,-2280.84,af618b03-dcfd-4b22-a71e-a6ba4999c291,321.33,debit,bank-fee,AU00000,2024-02-01T11:01:44Z
transaction,0e350a4e-4171-455e-bf56-0fe7fd09e99d,posted,Netflix Subscription,-3573.96,13c28d64-05f9-416c-8082-0b79e6500f07,-3252.63,debit,bank-fee,AU00000,2023-06-12T02:56:53Z
transaction,b7b50aa6-4974-4872-be7d-63e0b9008358,posted,Uber Ride,-2824.84,e25b7265-2820-459c-a06b-318bd0e52359,-6077.47,debit,bank-fee,AU00000,2023-10-28T13:04:21Z
transaction,21c51978-1111-4147-89c4-db58e7dd904c,posted,Mobile Phone Bill Payment,-4005.01,53e67c3a-57ab-47cf-961c-3cfb57953665,-10082.48,debit,payment,AU00000,2024-04-04T15:11:51Z
transaction,74325fed-8b0e-4ae2-9a46-d18a1cd4cd3a,posted,Hair Salon Appointment,-4066.52,ba5a3769-c2ef-44d2-b401-b96f1fee2f22,-14149.0,debit,cash-withdrawal,AU00000,2023-11-16T06:00:39Z
transaction,e07a3229-a0b7-4669-82d2-df46a8bf0cfb,posted,TFR Acc14000 TO 12389,-3593.07,a94c0d4f-c526-4f6f-bbf1-33e1def438fe,15361.65,debit,bank-fee,AU00000,2023-09-29T16:59:05Z
transaction,9f8b3976-7a3a-4e95-b2da-ead05b347516,posted,Restaurant Dinner,-2516.08,d4bed4d3-25ac-4631-b237-deda32b36e53,12845.57,debit,cash-withdrawal,AU00000,2024-01-01T06:19:05Z
transaction,e513daad-92eb-4b80-ae3b-7ed10761563e,posted,CTRLINK CARERS Ref: 998R6789201610974V,-4481.68,8dbe543e-36b1-453c-a932-0c54659b5941,8363.89,debit,bank-fee,AU00000,2024-03-03T20:20:54Z
transaction,4c3f685d-c0e6-4df0-8b1f-562b337edd7f,posted,Pharmacy Purchase,-4783.64,f14cf581-df50-46cd-8f23-372c3c3a5c44,3580.25,debit,cash-withdrawal,AU00000,2023-09-07T07:58:05Z
transaction,4e3c396e-2ead-4fbc-892c-6f686c5b5bfb,posted,Movie Ticket Purchase,-3759.46,3509e6a5-1c08-429b-a9c5-1d6f740ecb01,-179.21,debit,cash-withdrawal,AU00000,2023-11-26T11:51:07Z
transaction,ae2dabc4-16f6-4fe5-a04f-57339cb887bc,posted,Public Transport Fare,-1036.62,b86db951-771a-4b50-9b0d-bda791997ebf,-1215.83,debit,bank-fee,AU00000,2023-09-13T17:06:27Z
transaction,a8b8387f-ae25-4e5c-bd3f-8d30a4d29d0b,posted,Netflix Subscription,-83.56,58129317-fea2-4cd0-8856-42507a0670dc,-1299.39,debit,bank-fee,AU00000,2023-08-27T21:59:23Z
transaction,4db31be7-a84a-4446-8b7c-99ce496a65bf,posted,Clothing Store Purchase,-1713.58,0f6a8b99-de29-47d1-98d5-b467b6d5d678,-3012.97,debit,cash-withdrawal,AU00000,2023-07-10T14:07:41Z
transaction,a1b4fb71-11ec-4480-8659-ee1c7bab7af2,posted,Pharmacy Purchase,-4304.62,c27b0d4b-8caa-402d-87f4-0d72bc180685,-7317.59,debit,bank-fee,AU00000,2023-06-02T09:42:50Z
transaction,15cc4678-740d-42ab-87a0-b607e5749d6e,posted,Car Maintenance Expense,-3065.59,89ba9a60-bf48-4162-9faf-0f98aa648c17,-10383.18,debit,bank-fee,AU00000,2023-12-29T10:45:25Z
transaction,1cc5dbbc-f166-422f-a0d6-c7b5e1241aaf,posted,CTRLINK CARERS Ref: 998R6789201610974V,-4363.25,91852137-2f4d-4b04-b123-36781bc9cc3b,1724.92,debit,payment,AU00000,2023-05-21T03:24:32Z
transaction,65813654-737d-4d39-87be-0c6f9b883ac0,posted,Movie Ticket Purchase,-2176.63,ece949e3-01b9-4a0c-89a0-1d7e2b26f8b3,-451.71,debit,bank-fee,AU00000,2023-09-18T11:47:24Z
transaction,86229c80-1b44-40e7-83d7-4b7e5c68e7b8,posted,Non Hooli ATM Withdrawal Fee,-2647.58,fe19943e-3645-4a94-862b-3ca8ff602939,-3099.29,debit,payment,AU00000,2024-04-08T06:06:47Z
transaction,83477daf-e833-4694-9440-91168bc121ac,posted,Public Transport Fare,-1525.58,40b78857-5740-4aa5-a125-369bc8981319,-4624.87,debit,payment,AU00000,2023-09-12T18:44:46Z
transaction,92b4446e-8e79-48dc-a547-52e99d9aab3f,posted,Transfer Platnm Homeloan 346454,-3640.78,b85ad355-fc87-4293-a4c0-a8fa706ee8f0,-8265.65,debit,cash-withdrawal,AU00000,2024-01-30T14:33:22Z
transaction,f3faddea-9679-402f-b16c-5dd567bb1bf8,posted,Travel Agency Booking,-2724.83,12599ee5-f80e-4bae-a6ff-190a4869d508,-10990.48,debit,cash-withdrawal,AU00000,2023-07-16T21:21:52Z
transaction,101c6559-c65b-466a-bb7c-9fe0ebc8ffdb,posted,Payroll WFRMS 15439393,11541.41,f94bc386-b9f0-491f-916b-6fa5267704e2,550.93,credit,transfer,AU00000,2024-01-30T03:33:47Z
transaction,566df564-a776-46eb-86b7-506872199c17,posted,CTRLINK CARERS Ref: 998R6789201610974V,-1100.04,b0f769d5-0f06-4f71-bfdf-d5854dd2f4b1,-549.11,debit,cash-withdrawal,AU00000,2023-12-29T13:03:31Z
transaction,58d571d9-85dd-4872-9034-66a162b3f421,posted,Bookstore Purchase,-1715.86,a91f5d85-bfc4-4171-9c7c-764e0af7a9fb,-2264.97,debit,bank-fee,AU00000,2024-02-10T00:45:27Z
transaction,8c691928-6c2a-4f6f-91fe-5319cffbd850,posted,Wdl ATM WESTPAC IGA BALGOWLAH BALGOWL AU,-1316.79,e91ac6e3-debc-4960-8598-0f2b7ba94287,-3581.76,debit,bank-fee,AU00000,2023-06-11T08:35:07Z
transaction,78590b96-fabf-4c65-8bdf-e73f8f92eb3a,posted,Home Improvement Store Purchase,-2755.79,1c3170c7-5bdb-440c-b85d-c4d8a753c487,11567.08,debit,payment,AU00000,2023-09-08T09:10:10Z
transaction,cdb97be2-5e8d-4d72-9137-c5cbf9521f64,posted,CTRLINK CARERS Ref: 998R6789201610974V,-3161.09,af880b08-c936-4215-95e4-65d241ae25a2,8405.99,debit,cash-withdrawal,AU00000,2024-01-19T08:47:54Z
transaction,52e90557-b29b-4773-8289-d88fb688375b,posted,Transfer Platnm Homeloan 346454,-1100.23,286b05ad-2c61-4722-88a7-89797df3e166,7305.76,debit,bank-fee,AU00000,2023-07-17T23:54:18Z
transaction,ec43b8d9-d837-40b4-929e-92c4af6815ea,posted,Movie Ticket Purchase,-3474.42,1daed64f-b0d4-4e31-bddc-15e5b71e3738,3831.34,debit,bank-fee,AU00000,2024-01-24T02:32:10Z
transaction,d295ac4f-3938-46b5-9077-2eb1b68d932a,posted,Music Streaming Subscription,-1179.61,03494679-e386-4f1a-8208-21dc9e731f7d,2651.73,debit,bank-fee,AU00000,2024-02-10T02:34:22Z
transaction,406d5902-bd77-4c1e-89ff-9f2f7b7fce32,posted,Bookstore Purchase,-4869.33,64fd8287-be33-4974-9848-8cd7c41f1cec,-2217.6,debit,payment,AU00000,2023-08-06T22:05:38Z
transaction,8cf144af-c626-416d-ba2e-9e132951ae03,posted,Payroll WFRMS 15439393,10317.44,72bf91b2-5e91-4041-93c4-8db42aef106c,8099.84,credit,transfer,AU00000,2024-01-25T07:36:42Z
transaction,875b7043-de2d-4b9b-8924-9031b712e4a6,posted,Clothing Store Purchase,-3504.13,04d8dff4-6dc8-4163-9453-288bb82cae47,4595.71,debit,bank-fee,AU00000,2024-04-04T19:58:39Z
transaction,b7e4829a-7526-4c77-a00e-0e81a0ddaed7,posted,Clothing Store Purchase,-3492.42,59a89b94-9f43-4526-bac2-828e9e277f3f,1103.29,debit,cash-withdrawal,AU00000,2023-10-18T08:17:53Z
transaction,e3468aad-92be-4625-8f37-9f2412b0f235,posted,Pharmacy Purchase,-265.97,709e8938-58ef-4971-b03e-5b5edb1455a9,837.32,debit,cash-withdrawal,AU00000,2024-02-24T16:32:19Z
transaction,1a76a1d6-7641-4cba-83fb-bc5914329aa4,posted,Wdl ATM WESTPAC IGA BALGOWLAH BALGOWL AU,-4098.15,1e992a04-ec73-4e04-9ca0-59a579426989,3763.93,debit,cash-withdrawal,AU00000,2023-06-16T22:56:04Z
transaction,809cebd7-edfe-49f4-b58a-41eb4887e6f1,posted,Payroll WFRMS 15439393,11533.95,aa802114-391c-42c3-9091-ec7428d9872e,15297.88,credit,transfer,AU00000,2024-04-05T10:50:28Z
transaction,ccf3c1d9-e324-4d51-bc9d-7f14087f3778,posted,Electricity Bill Payment,-598.5,eff8f7a9-ae88-4f09-b562-c5e66c8ca351,14699.38,debit,payment,AU00000,2023-11-30T08:11:44Z
transaction,0f94d04f-33a2-4cc2-a0ce-079804375a8f,posted,Manly Maths Tutor Wages,-537.52,f52a9b9e-de81-4f9a-a71b-7d632b0019cb,14161.86,debit,cash-withdrawal,AU00000,2023-07-04T16:58:53Z
transaction,f84fd8b2-aee4-42f6-840e-d39b9b724bdd,posted,Movie Ticket Purchase,-4361.21,9de7a01c-f0ef-475f-9a84-132e27f55fe7,9800.65,debit,cash-withdrawal,AU00000,2023-12-24T18:46:31Z
transaction,bde74072-ad1b-483b-a234-e03a2cd1d587,posted,Payroll WFRMS 15439393,10304.72,7fb3a2a2-dab0-4d75-8117-04c63e28fd41,20105.37,credit,transfer,AU00000,2024-01-31T01:08:37Z
transaction,b1762e1a-19dd-4a3f-a54a-a3f59d6b8a21,posted,TRANSFER TO JOANNA SMITH CAMPING,-411.07,8ae45a85-e330-4728-86ed-240f86d060fe,19694.3,debit,cash-withdrawal,AU00000,2023-09-15T03:43:28Z
transaction,d5ac9e02-3a72-431a-9810-e077ead3cbe5,posted,Coffee Shop Purchase,-2887.31,d110e663-dd4d-4ece-90df-62a1042422ef,16806.99,debit,payment,AU00000,2023-09-10T15:52:44Z
transaction,72dbe390-953c-4454-86a2-b3edfaa1907c,posted,Pharmacy Purchase,-265.02,d308f02c-37f4-40bb-a4cb-7ecca23f50ec,16541.97,debit,payment,AU00000,2023-10-08T20:03:51Z
transaction,6b21e049-6c1f-4331-8fa9-0bd0458d3679,posted,TRANSFER TO JOANNA SMITH CAMPING,-2583.75,3bdb5690-9850-49b4-8fc9-ba332f2f7e27,13958.22,debit,cash-withdrawal,AU00000,2023-10-03T22:56:15Z
transaction,be99929a-7c4e-43f8-8b9a-4c7ebd5b1338,posted,Clothing Store Purchase,-4249.25,b4ecc042-e58e-4afa-9443-912b31a52e2e,3087.43,debit,payment,AU00000,2023-07-01T01:05:19Z
transaction,91e502c2-de5a-48fd-bbb4-4c986f06a184,posted,Pharmacy Purchase,-1142.74,7e259fb1-a87f-487d-9c57-52301fbfdeee,1944.69,debit,cash-withdrawal,AU00000,2024-01-05T13:07:21Z
transaction,675e81fe-b337-4975-ac31-9c0aa8f2e3cc,posted,Restaurant Dinner,-3539.9,63ee44dc-db08-4893-bc7c-01757462d4a1,-1595.21,debit,bank-fee,AU00000,2023-10-07T08:06:38Z
transaction,31b3ef5e-0cb4-4805-96e6-c21502c4626c,posted,Hair Salon Appointment,-2838.8,dd304aab-8652-48b5-95e1-33cb861f1ba0,-4434.01,debit,payment,AU00000,2023-09-25T01:50:57Z
transaction,49568a4f-2535-4929-a49f-7167cabfdc41,posted,Clothing Store Purchase,-3954.01,0cbd17ad-d415-444d-8f09-4dd8e2afdcac,-8388.02,debit,cash-withdrawal,AU00000,2024-04-03T07:07:57Z
transaction,e5f40e23-f2fe-4fed-9cab-585fcc016802,posted,Gym Membership Fee,-1681.93,52b13541-0369-40af-821a-30caec6a7885,-10069.95,debit,cash-withdrawal,AU00000,2023-07-15T20:40:03Z
transaction,5ad569d0-e82f-4e1a-950b-769e82dbc69d,posted,Clothing Store Purchase,-2965.35,8a16da35-b5e0-48b0-b332-cd0ff0174def,-13035.3,debit,bank-fee,AU00000,2024-03-16T00:51:30Z
transaction,59f588e4-2809-4ca4-99cc-edb15eac01d5,posted,TFR Acc14000 TO 12389,-3311.94,3ec16e6a-044f-427e-9109-9b5ce9e823bf,-16347.24,debit,payment,AU00000,2023-10-25T17:47:05Z
transaction,3db003b9-d361-4c29-83dd-c19d1f024c82,posted,Payroll WFRMS 15439393,11136.08,45235917-7a60-402f-805e-9b6a4f271c61,-5211.16,credit,transfer,AU00000,2023-05-21T01:51:09Z
transaction,2c292979-a6c1-491a-aca5-11b7ffb8d5a1,posted,Travel Agency Booking,-3300.01,0f2a6c75-ae0f-41e1-b1f8-c64eae7d44c2,-8511.17,debit,payment,AU00000,2023-07-22T06:21:50Z
transaction,50e3783d-ec6d-4f77-97b4-af21e59c7c25,posted,Manly Maths Tutor Wages,-1507.75,34facd2d-3268-4383-ae7e-573df4f9f9c9,11061.41,debit,payment,AU00000,2023-12-16T10:16:26Z
transaction,60731dbb-c24a-4861-88ed-79d8d8e57211,posted,Mobile Phone Bill Payment,-2241.68,2fe8c800-cbd4-4294-895d-e408f967f25b,8819.73,debit,cash-withdrawal,AU00000,2023-08-08T16:31:19Z
transaction,1484b7ee-c614-42c8-bc66-521f1af9c7bb,posted,Movie Ticket Purchase,-3977.21,fbf57ab4-806d-40bb-8a47-d58d53572fe0,4842.52,debit,payment,AU00000,2023-07-28T22:40:50Z
transaction,7dcfce83-c69f-4c41-9dd9-e7abc074ac26,posted,Wdl ATM WESTPAC IGA BALGOWLAH BALGOWL AU,-676.02,6f262d16-f3be-47fa-9890-8b1a09a409c3,4166.5,debit,payment,AU00000,2024-03-07T13:40:23Z
transaction,cb68d0a4-558b-45b5-9515-1dde0e2ba36a,posted,Bookstore Purchase,-2953.4,3de4608c-f37e-4719-babb-70ff364b80f9,1213.1,debit,bank-fee,AU00000,2024-01-15T10:01:42Z
transaction,3b648030-a620-4d66-b146-1b0e708faa09,posted,Hair Salon Appointment,-3758.7,46f0fde8-6bea-408f-9d6f-7c4c8c4a9553,-2545.6,debit,payment,AU00000,2024-04-17T11:36:46Z
transaction,ec985af5-0828-463b-ad28-20f0909cc16f,posted,Gasoline Purchase,-728.37,e56dd3d5-6f1d-4029-bd63-995ad699a28e,-3273.97,debit,cash-withdrawal,AU00000,2024-01-18T22:49:02Z
transaction,63bad617-e7e1-4fec-a0fc-45c019b6fd58,posted,Travel Agency Booking,-2816.97,1f012746-76c4-459a-865a-9959953e360f,-6090.94,debit,bank-fee,AU00000,2024-02-05T05:02:02Z
transaction,47e28ef3-583a-43cd-b6c0-e671be301afe,posted,Amazon Online Shopping,-4752.23,43fa50e2-64e0-4624-a3d4-5300016fcdef,-10843.17,debit,bank-fee,AU00000,2023-11-18T15:27:31Z
transaction,a3d14f63-747a-4af2-b318-f3c61380a236,posted,Online Gaming Purchase,-3145.0,de9dae73-409a-4688-95ac-8f937fbdf626,-13988.17,debit,bank-fee,AU00000,2024-03-21T05:27:49Z
transaction,e3c95930-8c2f-456a-8db1-e726475f16ae,posted,AGL RETAIL ENERGY LTD (GAS),-1736.82,5f53b337-3690-4ead-8b5a-ef5d14cdaddf,17018.34,debit,payment,AU00000,2024-02-03T11:14:39Z
transaction,83c4f6f6-0c2b-49c4-8c12-70daece42c37,posted,Public Transport Fare,-2477.46,5b9add7c-df17-4e06-8b19-d9464cde2541,14540.88,debit,payment,AU00000,2023-06-26T22:32:13Z
transaction,84910b6d-cb13-4fde-8a67-681e7dbdf764,posted,Travel Agency Booking,-4052.27,ae30680b-6da1-41f6-96fc-069cf392bd5c,10488.61,debit,payment,AU00000,2023-05-13T15:39:43Z
transaction,92b8e0ef-7755-4b33-abe6-15d0fe2885b5,posted,Mobile Phone Bill Payment,-406.38,0f23ad03-93f5-4270-a6d7-6c5272851e39,10082.23,debit,cash-withdrawal,AU00000,2023-09-07T00:35:57Z
transaction,f8826c30-b760-456a-b7fc-2e511c6c7c6a,posted,Bookstore Purchase,-2670.78,01ba02ce-00d7-4e04-81a5-bb89635e2c83,7411.45,debit,cash-withdrawal,AU00000,2023-10-31T19:16:16Z
transaction,740888b8-9fae-4303-bcee-ee25c2dcc262,posted,Bookstore Purchase,-3133.85,fe687f75-cb16-4269-8c44-c112f24a711c,4277.6,debit,payment,AU00000,2023-10-13T21:29:45Z
transaction,5bc1bd2f-f374-4db1-9cc3-e987fca788b7,posted,Manly Maths Tutor Wages,-2094.58,29f014d0-ea0a-4857-bec7-5554f5d2f102,2183.02,debit,bank-fee,AU00000,2023-11-09T03:57:23Z
transaction,634a90e5-3e57-4add-84dc-d8abd4f6184f,posted,Coffee Shop Purchase,-1850.05,ffe37d20-34c7-4852-a692-59023a39bf51,332.97,debit,bank-fee,AU00000,2024-02-23T02:23:14Z
transaction,7018486e-8625-4dd1-a98a-8d41995be124,posted,Restaurant Dinner,-3608.85,f737d199-b82e-4c81-9abb-476521a15b2b,-3275.88,debit,cash-withdrawal,AU00000,2023-06-07T04:57:41Z
transaction,e2c82e4f-9693-4bab-adf9-76a9d0e5e503,posted,Clothing Store Purchase,-36.81,14e528d6-8934-4d58-830f-3a3f2c3c12d0,-3312.69,debit,cash-withdrawal,AU00000,2023-10-15T18:12:00Z
transaction,97c9619c-755e-4d9e-bc5b-dcaff15d5641,posted,TFR Acc14000 TO 12389,-179.31,02ae8231-3092-41c3-a847-cf50513cc75e,18047.71,debit,payment,AU00000,2024-04-28T15:24:29Z
transaction,7ea84f35-c148-4da8-8380-6335298cf069,posted,Home Improvement Store Purchase,-4352.06,73cf887f-6ecc-453d-bf7a-901005b00d5f,13695.65,debit,cash-withdrawal,AU00000,2023-05-28T02:45:56Z
transaction,b51b55f7-cf09-469c-a90a-fc7e5155431c,posted,Payroll WFRMS 15439393,10930.73,dfc1e4d3-8453-4e5b-8ea5-03e6901c2701,24626.38,credit,transfer,AU00000,2024-02-26T17:22:36Z
transaction,2774b92f-fbd6-4aba-8f77-8475d39af671,posted,Electricity Bill Payment,-2462.33,5b3de874-5cc7-4f06-b04e-4836e474f00a,22164.05,debit,payment,AU00000,2023-11-28T23:01:22Z
transaction,7cec7dae-db50-465f-9e73-758276b37fb9,posted,Online Gaming Purchase,-4828.06,8382524c-aff6-4d00-b443-dad1e0832268,17335.99,debit,cash-withdrawal,AU00000,2023-11-17T00:49:26Z
transaction,17508f1e-2d93-47e0-8011-7e693034681e,posted,Manly Maths Tutor Wages,-511.08,ca9738bd-1a03-4a81-aab4-93eae8188b38,16824.91,debit,bank-fee,AU00000,2023-09-28T18:38:23Z
transaction,591c4119-9c74-44d3-9d8a-02a39ffae4be,posted,Electricity Bill Payment,-1092.71,3fdcf6a3-fda5-4dfe-b59b-3a238f0fe9ed,15732.2,debit,cash-withdrawal,AU00000,2023-06-18T23:33:48Z
transaction,5d0dd2da-c407-4d88-89c8-18f53ff49d43,posted,Mobile Phone Bill Payment,-4377.28,40fff25f-1d4b-4514-bc12-aa14402ac77f,11354.92,debit,cash-withdrawal,AU00000,2024-02-10T04:44:50Z
transaction,6c228001-4aa2-4dba-b162-af4485503078,posted,Payroll WFRMS 15439393,11702.88,74ca4541-c25f-4e99-a8cd-aa33ed094da6,23057.8,credit,transfer,AU00000,2023-05-22T21:22:42Z
transaction,123c6c88-17e4-4baf-b90a-d9a43c224861,posted,Hair Salon Appointment,-318.91,b325a69f-724f-4b58-a0fd-e702a1a6f809,22738.89,debit,bank-fee,AU00000,2023-06-22T08:30:59Z
transaction,4665fd7e-e655-4764-9b47-1d02080f13fe,posted,Travel Agency Booking,-3326.5,141426fd-9ed6-4893-85a0-d37d1436a17a,5456.81,debit,payment,AU00000,2024-05-05T04:24:47Z
transaction,4897f2fe-037c-43a5-b364-b0a789e2abae,posted,Travel Agency Booking,-1634.31,237394ea-3a9f-42b1-92c3-139145a2fa5f,3822.5,debit,bank-fee,AU00000,2024-02-26T04:39:39Z
transaction,f380773f-73d2-4488-98fc-f756cc65ff20,posted,Home Improvement Store Purchase,-4269.47,412b9143-5a64-4bd6-b947-34e92ec14a50,-446.97,debit,bank-fee,AU00000,2023-07-22T16:54:42Z
transaction,075d76a8-e143-4e9f-b53c-6ca23c8abb3f,posted,TRANSFER TO JOANNA SMITH CAMPING,-4883.73,11abb09a-08fa-46bf-8cac-40402e553027,-5330.7,debit,cash-withdrawal,AU00000,2023-05-21T05:26:11Z
transaction,9382dff6-4fc0-4e2b-8510-fa7212ba74d6,posted,Coffee Shop Purchase,-3160.22,b2892bd4-fcfe-4c97-8b54-26d6df73791f,-8490.92,debit,cash-withdrawal,AU00000,2023-10-14T14:58:05Z
transaction,b45d6332-4522-4cec-8e9c-a978ee7dcbae,posted,Mobile Phone Bill Payment,-851.2,184db93f-bf70-47b1-bd0c-833df4a8730b,-9342.12,debit,cash-withdrawal,AU00000,2024-03-25T16:41:42Z
transaction,9c6d81c4-d7fa-4420-bbb3-d7aa682b845b,posted,Bookstore Purchase,-2477.57,6e98f636-06fa-4f57-baf9-2eaaa9b4b185,-11819.69,debit,payment,AU00000,2023-08-27T23:13:44Z
transaction,a03e198a-3b13-4321-b40a-4b4dc6d19236,posted,Bookstore Purchase,-798.53,0a250461-f4d1-48d0-9a8c-f1e2bb35cb6a,-12618.22,debit,bank-fee,AU00000,2023-05-14T05:12:12Z
transaction,84ebb124-c580-4bde-822f-c70ffa69075f,posted,Non Hooli ATM Withdrawal Fee,-4162.03,ecbcdca2-9b90-4dcb-bd51-28d3f45bd8ef,-16780.25,debit,payment,AU00000,2023-07-01T10:39:50Z
transaction,382ba553-0953-43cd-9f8a-f8c3da3fe9e5,posted,Electricity Bill Payment,-4913.24,560c9199-ae18-4348-8e8b-4b46b16d51d5,-21693.49,debit,payment,AU00000,2024-01-30T05:42:46Z
transaction,b524428d-35f3-4dcb-8a2d-70fd14fae105,posted,AGL RETAIL ENERGY LTD (GAS),-2551.41,af09f80c-0d44-4404-bef5-f2c5e70f0a02,15741.14,debit,cash-withdrawal,AU00000,2024-04-14T20:03:50Z
transaction,124b4d4b-4bbd-44cf-9a00-9e0c70bd841f,posted,Travel Agency Booking,-4410.43,bc5bf7f7-471b-4466-8e5b-b1d849ea49b2,11330.71,debit,payment,AU00000,2023-08-19T07:31:52Z
transaction,874b0320-754e-4577-98a7-80c262a3b70c,posted,Gym Membership Fee,-1133.2,4fd29573-5296-44c4-9436-c65153b6c23b,10197.51,debit,cash-withdrawal,AU00000,2024-03-20T22:21:21Z
transaction,94e72250-e24f-4969-816c-5cdf79e32f19,posted,Travel Agency Booking,-4238.48,c14aa64c-1e71-40f8-b363-5f3a287d8238,5959.03,debit,bank-fee,AU00000,2024-03-23T20:22:55Z
transaction,1ddb18ce-802f-4d80-ad9d-b469601338c3,posted,Non Hooli ATM Withdrawal Fee,-246.15,e38bbb0d-57b5-48f9-9d86-295bd32b0689,5712.88,debit,payment,AU00000,2023-11-25T02:33:58Z
transaction,ff7fd747-7d67-45c2-b46b-3df5bf9a1961,posted,Public Transport Fare,-4227.67,ae37d74d-dcab-4ff1-af11-dc5db57e95d0,1485.21,debit,bank-fee,AU00000,2023-11-21T09:25:02Z
transaction,ce08691b-fd69-4298-8e61-c0eaae2ee784,posted,Car Maintenance Expense,-4066.44,41570c23-59fa-41af-b9d9-db764d6bca66,-2581.23,debit,payment,AU00000,2023-09-05T08:35:36Z
transaction,a47e7f56-8398-4bd9-9610-281a74ada44f,posted,Travel Agency Booking,-275.55,c0155e3a-a315-41de-859e-128cf0458350,-2856.78,debit,cash-withdrawal,AU00000,2024-01-04T14:49:30Z
transaction,5ccff595-111f-465c-92f8-c82938cf1597,posted,Online Gaming Purchase,-2293.11,ef553d22-495c-45cf-9112-c8d3dad6bec1,-5149.89,debit,bank-fee,AU00000,2023-06-01T09:04:14Z
transaction,9264d8bc-0324-4d4b-816e-3e0598c4f5f3,posted,TFR Acc14000 TO 12389,-1081.24,b361562c-a36b-40d8-8487-7075f3266124,-6231.13,debit,payment,AU00000,2023-08-25T13:44:18Z
transaction,61d0c7e4-d86b-437d-9106-99be8585e1cb,posted,Home Improvement Store Purchase,-1289.19,bdd85769-e44b-4f5b-8e7f-9969785b86cb,13881.32,debit,bank-fee,AU00000,2024-01-05T23:04:40Z
transaction,e240c82c-ee2f-41cc-99d2-2e03d79da019,posted,Online Gaming Purchase,-476.31,12ebf0a0-4f56-4f98-9bcf-d083d30e6bde,13405.01,debit,bank-fee,AU00000,2023-07-16T02:38:19Z
transaction,9d04a603-2c2e-4f4d-8a70-acecedee7346,posted,Uber Ride,-218.52,d3fc8005-e3e4-4900-ae4e-1fad2ac3a398,13186.49,debit,cash-withdrawal,AU00000,2024-02-22T05:27:18Z
transaction,5aa534a2-d0d1-4cc5-829b-f114af96f162,posted,CTRLINK CARERS Ref: 998R6789201610974V,-3469.71,96b5ff2b-a296-4097-844c-d19b5c7e4955,9716.78,debit,bank-fee,AU00000,2023-12-17T03:09:05Z
transaction,c36cfa6b-c07a-43fa-b5ab-8ffcf5797dd6,posted,TFR Acc14000 TO 12389,-4923.62,ac1bcadd-c1a3-4530-ae5d-9e050ea1bde8,4793.16,debit,payment,AU00000,2023-06-18T18:11:42Z
transaction,c3625a1b-8a6c-44a7-8828-d0488b59d808,posted,Electricity Bill Payment,-1243.95,4e6ec048-c70e-4db3-86ec-ef7f1db8a08a,3549.21,debit,bank-fee,AU00000,2024-03-08T18:20:19Z
transaction,82e87206-3f7c-45f6-9dcf-01c5d3b5d6a6,posted,Gasoline Purchase,-261.21,e3ebb333-31fe-4460-bfb0-3e0d6a42c7b1,3288.0,debit,payment,AU00000,2023-06-20T22:32:46Z
transaction,05935b15-b9b0-48cd-b562-e81f37793d0d,posted,Clothing Store Purchase,-2118.49,be5ad75f-f050-4686-bef6-9f3f28c0dce0,1169.51,debit,cash-withdrawal,AU00000,2023-12-21T17:57:17Z
transaction,b5dfecee-fe68-42bb-bcaf-51d61be66b64,posted,Gasoline Purchase,-4187.69,5a69b654-4528-48aa-9dfc-cf38df0f0b4f,-3018.18,debit,bank-fee,AU00000,2023-10-11T08:32:35Z
transaction,f3b0594b-c883-4725-ae1f-c59183f021a4,posted,Mobile Phone Bill Payment,-1407.03,d9d7d6e4-f150-4ebb-bdc5-973b9c0dd213,-4425.21,debit,payment,AU00000,2023-09-15T18:47:03Z
transaction,0e06a20e-0c8f-4660-b55c-a39a5c0f7243,posted,CTRLINK CARERS Ref: 998R6789201610974V,-19.05,0db740d5-e5ba-4d87-8577-81e31a53b0ec,18072.27,debit,bank-fee,AU00000,2024-03-28T11:19:32Z
transaction,a9b4ebda-1c65-4296-93dd-e2d218b1d3d0,posted,Gym Membership Fee,-1083.51,db9b309d-3588-4275-92dc-73bf0f32b62c,16988.76,debit,cash-withdrawal,AU00000,2023-08-10T10:09:38Z
transaction,2eadc856-2656-47e2-adc9-a4f3da48d3a6,posted,TRANSFER TO JOANNA SMITH CAMPING,-4837.33,71b550a7-ed4c-4fd8-b513-9062de47426d,12151.43,debit,payment,AU00000,2023-06-14T19:56:24Z
transaction,a3d6de80-5ccf-4c84-aea9-d37d1bbd6cd6,posted,Movie Ticket Purchase,-1831.21,c13d41c9-1e21-4eec-93fa-a8a208b395f4,10320.22,debit,cash-withdrawal,AU00000,2023-08-16T20:57:05Z
transaction,0364a7f7-271d-4f1a-863b-d6a47353e129,posted,Clothing Store Purchase,-1552.39,6646e229-27f0-4242-bece-dd8edfaaeff6,8767.83,debit,cash-withdrawal,AU00000,2023-07-08T16:57:24Z
transaction,b28f489d-2dfd-43a7-b830-b1e6eb8b4f1d,posted,Amazon Online Shopping,-2021.57,99b3c6e9-5383-4733-883c-fb8e27d70dea,6746.26,debit,payment,AU00000,2024-01-30T17:43:49Z
transaction,1b4a6ef0-8ccc-41ad-9c34-42b73280d1fe,posted,Music Streaming Subscription,-1541.9,c0f291e3-59c9-47fe-b8bf-78304d200e47,5204.36,debit,bank-fee,AU00000,2023-07-31T20:37:43Z
transaction,abdd80d0-9df5-4e87-a459-875ce41f797c,posted,Payroll WFRMS 15439393,10750.61,abacf105-e701-42fe-90f4-50dc2f8ca3cc,15954.97,credit,transfer,AU00000,2024-02-20T20:48:59Z
transaction,a38fe1bf-346c-445b-8520-b09aa4bed116,posted,Transfer Platnm Homeloan 346454,-631.69,25035e3b-0d5d-4343-a996-24396f78c5dc,15323.28,debit,bank-fee,AU00000,2023-12-13T04:38:16Z
transaction,9eedc80f-9dca-49d6-a57e-36f6022ca4f1,posted,Amazon Online Shopping,-3787.48,54885ab9-03a8-44ec-801c-4d8420d8028a,11535.8,debit,cash-withdrawal,AU00000,2024-01-28T02:36:50Z
transaction,c7da8607-27e4-41c1-8faa-f1ef9c7ad1ce,posted,Mobile Phone Bill Payment,-2183.63,e99b318f-15ae-449a-ae1b-e4c66002b52b,15026.01,debit,bank-fee,AU00000,2023-08-11T13:57:00Z
transaction,08273f1a-7046-4ad3-a1ab-4cb8302de7af,posted,TFR Acc14000 TO 12389,-1794.8,7ed87aa4-79ec-4646-9d2d-da6e0f83a165,13231.21,debit,payment,AU00000,2023-07-06T13:34:41Z
transaction,0d5cfdb5-80c8-4a30-ba1c-37877252f8ce,posted,Gasoline Purchase,-114.61,80c999ae-b796-49a0-b5f9-080b21258dec,13116.6,debit,bank-fee,AU00000,2023-09-17T05:42:36Z
transaction,dc150f56-04d8-44b9-bf32-d2c39cd77a30,posted,CTRLINK CARERS Ref: 998R6789201610974V,-2779.73,41149af7-6002-4721-ae36-34afc0f63477,10336.87,debit,payment,AU00000,2024-04-16T16:04:25Z
transaction,5a1db3ba-a42b-4c15-91e6-773db1883854,posted,Mobile Phone Bill Payment,-678.71,18a0d084-1cf6-4fda-9e91-fcf17c2b5dcb,9658.16,debit,payment,AU00000,2023-06-30T20:15:52Z
transaction,a9669ae8-1141-407d-bf19-50123d9d17dc,posted,Uber Ride,-757.81,04d6beeb-79dc-4209-a986-aece5e9e7709,8900.35,debit,cash-withdrawal,AU00000,2023-08-19T08:29:50Z
transaction,c266fec8-8328-4f0c-83f2-ac8ebba4bb28,posted,Transfer Platnm Homeloan 346454,-3239.47,c2c2111d-0630-4c94-93c4-9925bb52f001,5660.88,debit,bank-fee,AU00000,2023-06-11T15:50:34Z
transaction,f149759e-3438-450a-863e-ca754d612339,posted,Car Maintenance Expense,-3739.26,b779a4e3-9c99-4e71-82a5-e8ea2c0a7073,1921.62,debit,payment,AU00000,2023-08-25T07:31:11Z
transaction,734e3a35-1fcc-4c79-bbef-5f31d62464e1,posted,Travel Agency Booking,-2434.24,31fc0405-b372-4f56-bb6d-02895dccc78a,-512.62,debit,bank-fee,AU00000,2023-08-20T01:51:05Z
transaction,f10a3b03-3d1b-4e0b-83cc-88b5c8988273,posted,Online Gaming Purchase,-649.1,c9974ea0-8ee3-46ee-ba2f-3febcbaf5152,-1161.72,debit,bank-fee,AU00000,2023-11-04T02:13:19Z
transaction,debc326b-afc1-4e66-8975-f4ec710bfabb,posted,Travel Agency Booking,-3095.71,a085095c-b0f1-450e-b3b9-16274e7d0766,5750.38,debit,payment,AU00000,2023-06-15T03:45:33Z
transaction,68f7926b-935f-4313-b325-62f4caa242d6,posted,TFR Acc14000 TO 12389,-4178.73,f45a6859-c179-4c51-8ef5-21cb5d23f64f,1571.65,debit,cash-withdrawal,AU00000,2024-01-03T08:10:17Z
transaction,b824beb6-ec69-46f2-a124-54cb9108f3a5,posted,Movie Ticket Purchase,-4999.71,18201dc1-50ef-40ab-90c1-4e1e01fd6b1a,-3428.06,debit,cash-withdrawal,AU00000,2023-12-15T22:54:04Z
transaction,d4c8c96c-14cd-4209-9c08-9f3ebef4c017,posted,TRANSFER TO JOANNA SMITH CAMPING,-1368.13,8f1c3a04-e6d3-4cb1-a221-18b7a777f20d,-4796.19,debit,payment,AU00000,2023-05-30T00:12:38Z
transaction,c782b65a-a483-4089-bf5c-a400ae3b2656,posted,Uber Ride,-4923.96,f8fbe5ad-2b45-44f6-972a-ffe0695c39fa,-9720.15,debit,payment,AU00000,2023-06-03T09:29:37Z
transaction,7c709706-6eaf-40dc-a1c5-7bb388891e5b,posted,Car Maintenance Expense,-3835.96,e1d25cc5-b25b-4ac1-b920-511e2def35d5,-13556.11,debit,cash-withdrawal,AU00000,2024-01-13T15:59:36Z
transaction,bed294b5-0fa6-4e02-8a24-56a23fe9d3d6,posted,Payroll WFRMS 15439393,11658.72,d82d8871-0e77-4d6f-b3f5-bb1e62b56165,-1897.39,credit,transfer,AU00000,2023-08-06T08:55:38Z
transaction,6a2bf41c-dc02-4190-83e6-24a73879d09b,posted,Travel Agency Booking,-2868.95,6978cb00-1c5d-4c4d-b2bb-3531f26a2ab3,-4766.34,debit,payment,AU00000,2024-01-28T06:37:03Z
transaction,666253fc-a80f-4733-b5d0-ac0b8b08d792,posted,Gym Membership Fee,-3256.7,bdd9631d-19fb-40fc-90db-38ee5ca6d97a,-8023.04,debit,bank-fee,AU00000,2024-03-12T05:31:05Z
transaction,07cdc37e-dc81-4fde-934b-41d4c0aa6a57,posted,Public Transport Fare,-3998.69,7676b1d4-a5de-4924-bcbc-f18fc88ba824,-12021.73,debit,cash-withdrawal,AU00000,2024-02-11T21:19:48Z
transaction,d51d444d-0d01-42c4-a5ce-6834c6b39929,posted,Electricity Bill Payment,-3715.28,df6d6079-d83a-4028-8fe6-09c702e94232,16213.96,debit,cash-withdrawal,AU00000,2023-08-01T20:12:25Z
transaction,0152d51a-b357-47c3-a1b6-e852ce70b448,posted,Car Maintenance Expense,-2928.91,89bf9da8-0389-4c30-9937-73ecc2c84895,13285.05,debit,bank-fee,AU00000,2023-11-02T02:32:29Z
transaction,24478811-1456-462a-96e2-02effd68f7e9,posted,Restaurant Dinner,-3433.4,ef737fdf-20b3-44f8-b42a-b48fbb4aa26e,9851.65,debit,payment,AU00000,2024-05-01T06:38:44Z
transaction,451c6a25-084f-4136-bd22-1d8270a4be87,posted,Clothing Store Purchase,-4728.85,bab473d9-2af8-470c-ab13-61cb199175bd,5122.8,debit,bank-fee,AU00000,2023-08-19T22:34:56Z
transaction,e23c873a-701b-4970-afc0-d3de7a883820,posted,Clothing Store Purchase,-3304.3,011dbc1c-57c8-4e51-882b-9a1c943b8062,1818.5,debit,payment,AU00000,2024-05-03T12:19:46Z
transaction,cb2594d0-e033-43ef-b1a7-4a5f536fe3af,posted,Payroll WFRMS 15439393,11701.36,91d55e9f-1131-4566-93e6-08f2b5d48b3f,13519.86,credit,transfer,AU00000,2023-06-08T16:39:24Z
transaction,6ec325ce-1465-4650-9e89-5effdc55557b,posted,Clothing Store Purchase,-1199.28,137e2472-e6b2-4ec6-b2e8-52587c45f531,12320.58,debit,payment,AU00000,2024-04-24T14:32:32Z
transaction,b7b78f41-ea93-47ca-b17f-ea40b9d23ca2,posted,CTRLINK CARERS Ref: 998R6789201610974V,-2926.95,bf9784ef-8d1d-4fd0-af43-d4cbfe33770d,9393.63,debit,payment,AU00000,2024-01-13T22:56:23Z
transaction,66fa02f9-1382-4a17-9168-d15f74a26df4,posted,TRANSFER TO JOANNA SMITH CAMPING,-1700.3,01be2659-3689-43b2-a718-7e0465682d5e,7693.33,debit,cash-withdrawal,AU00000,2023-08-30T22:18:17Z
transaction,0870858a-97da-4472-a55d-f833f869f828,posted,Manly Maths Tutor Wages,-1126.83,11823976-c414-4134-a015-10083b0bc68b,6566.5,debit,payment,AU00000,2024-03-18T04:30:58Z
transaction,808fc2e2-c82a-467c-97e1-260f713e0786,posted,Non Hooli ATM Withdrawal Fee,-4177.62,6cbefa4b-38ce-4a0d-aa64-48df864c7d85,1947.53,debit,bank-fee,AU00000,2023-07-16T06:06:32Z
transaction,64d8d6a9-778c-4137-b522-c7fbf4d3f36d,posted,Netflix Subscription,-1178.82,52f57c94-5713-4a1c-b68f-3f74c886ea0d,768.71,debit,bank-fee,AU00000,2023-09-20T18:20:07Z
transaction,b3a3ef2f-50a4-4233-a0fe-0974ebd7994b,posted,Bookstore Purchase,-1816.4,beae22dd-713a-47f8-ba82-5cd142eb21b5,-1047.69,debit,bank-fee,AU00000,2023-11-02T02:11:03Z
transaction,e55d73a1-4437-4cbc-84c0-011ce425d8cb,posted,Bookstore Purchase,-764.62,f5d9608b-9a12-4612-a9e0-3874fa5f03c3,-1812.31,debit,cash-withdrawal,AU00000,2023-12-18T06:15:14Z
transaction,359902b4-c031-4485-8a94-e6caa43fa94a,posted,Coffee Shop Purchase,-100.82,a0ed2cde-61dc-4dc9-9e99-a73e2b71d4ae,-1913.13,debit,payment,AU00000,2024-01-22T00:33:18Z
transaction,27de2f4c-9b6e-4cf3-9f5c-47477fc5c4fd,posted,Netflix Subscription,-2874.53,d8d5fa43-c63f-4cac-8b31-1f674c218e3f,-4787.66,debit,bank-fee,AU00000,2023-08-08T12:44:36Z
transaction,6f62fe25-2a85-497d-af38-e503e1993878,posted,Gasoline Purchase,-1081.24,363ecc8d-dc0b-42bc-8b51-fee84347d1c7,-5868.9,debit,cash-withdrawal,AU00000,2023-06-08T10:55:59Z
transaction,f2955904-cb78-4f40-99d6-269f60f13cb8,posted,Public Transport Fare,-3642.55,8be0f0b3-133a-4bdf-be8e-92be3cb735c5,-9511.45,debit,bank-fee,AU00000,2024-03-25T06:40:08Z
transaction,0e92105e-d875-455e-af94-2116b4e9db10,posted,TRANSFER TO JOANNA SMITH CAMPING,-3080.13,318253c6-1abf-4e17-8279-0038dffebe01,-12591.58,debit,payment,AU00000,2023-12-27T07:11:21Z
transaction,956aee9d-95df-47c1-bed1-5feaaf291766,posted,Amazon Online Shopping,-632.46,bba58a4f-d3b4-4ea7-bb09-fc51486bf3f3,-13224.04,debit,payment,AU00000,2024-02-13T01:02:56Z
transaction,714b7ee2-c629-4b4d-8ef3-616f1d88329b,posted,Mobile Phone Bill Payment,-483.66,c4ac8e43-820a-484b-855b-555797fe26ec,8520.46,debit,cash-withdrawal,AU00000,2023-10-16T16:12:42Z
transaction,720a5b3e-c90d-4bed-9784-f4254a875aa6,posted,Music Streaming Subscription,-3097.99,eae68dd2-2fb8-49ee-9cab-67f0508be293,5422.47,debit,bank-fee,AU00000,2024-03-07T19:14:39Z
transaction,d80d8d0a-af1c-49fa-acea-b40baf10d8b4,posted,Travel Agency Booking,-3059.95,7c65172f-5b6f-4cb2-abe5-399bf7a1a331,2362.52,debit,payment,AU00000,2024-02-06T00:02:59Z
transaction,5e0110ff-7824-4442-b70c-ef09dac2e3a9,posted,Music Streaming Subscription,-3197.31,34906cf7-200d-4426-a318-5cb96d63795b,-834.79,debit,bank-fee,AU00000,2024-01-29T21:52:16Z
transaction,8ef7ad60-5edb-49a6-8d86-baff7f8c7b3b,posted,Movie Ticket Purchase,-237.94,41088aee-2469-4efd-86ea-cca0a4c6a527,-1072.73,debit,cash-withdrawal,AU00000,2024-03-10T13:45:27Z
transaction,e75dec2f-dd68-4d5c-ab0a-b66f7527fed2,posted,Wdl ATM WESTPAC IGA BALGOWLAH BALGOWL AU,-2177.71,93722a01-4612-4b1c-8b91-964df3561e49,-3250.44,debit,payment,AU00000,2024-04-17T04:13:39Z
transaction,db18b329-f1f8-48d5-9eb3-6ab2d6729ff8,posted,Non Hooli ATM Withdrawal Fee,-1970.37,f5140824-4667-4dbd-8474-718d98e2d562,-5220.81,debit,payment,AU00000,2024-05-03T07:40:39Z
transaction,2e4bacbd-3018-4207-825e-c42254406c59,posted,Transfer Platnm Homeloan 346454,-430.94,9168f305-a0f3-443d-b9f8-68a6f746f9f8,-5651.75,debit,cash-withdrawal,AU00000,2024-02-26T02:55:12Z
transaction,dc3c204a-6589-4d4e-89d3-090094d432d9,posted,Netflix Subscription,-3212.3,74ae5f5c-e34f-42e2-89db-ab3ecfba760d,-8864.05,debit,bank-fee,AU00000,2023-05-23T07:17:15Z
transaction,71b1ef25-f2af-4e41-a667-9c2e4da36e72,posted,AGL RETAIL ENERGY LTD (GAS),-3032.36,4892180a-6130-4d90-868c-d1ba749a8e31,-11896.41,debit,bank-fee,AU00000,2023-08-23T07:51:33Z
transaction,a8368375-cbc0-4078-ab1d-20871ec339f2,posted,Uber Ride,-786.48,3427d8a8-bc52-49ce-9209-86c711107c10,17279.27,debit,cash-withdrawal,AU00000,2023-12-24T18:27:18Z
transaction,ef6298d5-3392-43ff-af18-29ef7cbcc9ae,posted,Pharmacy Purchase,-2449.16,aee91a82-3966-470c-a5d8-b36429c507ec,14830.11,debit,bank-fee,AU00000,2024-04-10T18:41:47Z
transaction,9c98f9fe-4568-4202-846f-7058f6c8ea20,posted,Uber Ride,-1588.78,fa30432a-7ada-4b8e-9d66-60bf7a459df8,13241.33,debit,cash-withdrawal,AU00000,2024-05-02T12:39:52Z
transaction,f4d4cbf3-6bc5-49e6-8123-d3fc7300cd8f,posted,Manly Maths Tutor Wages,-637.55,fceb6fcb-d4e4-439f-bb9f-3ee2e1d4347b,12603.78,debit,payment,AU00000,2024-04-18T00:09:56Z
transaction,21742e36-fbac-41a9-95cd-2d126a64dba5,posted,Gasoline Purchase,-3462.75,53ed5b1e-c10d-4a3b-a9fb-b6e81e0e9245,9141.03,debit,payment,AU00000,2023-07-19T08:57:20Z
transaction,1628186b-ce40-4aaf-9350-270a32948c20,posted,Gym Membership Fee,-3651.31,8777c1b5-ec7f-4dba-bf61-406a978db41e,5489.72,debit,payment,AU00000,2024-04-11T19:26:32Z
transaction,b95cf215-43f9-46ef-914f-46da57057798,posted,Car Maintenance Expense,-4072.37,f5e3d842-a5b6-468c-b174-8f85c533b50a,1417.35,debit,cash-withdrawal,AU00000,2023-11-03T01:13:16Z
transaction,b42d3eff-912e-4861-b856-643744a30d02,posted,TFR Acc14000 TO 12389,-1515.69,9419ef96-ea62-41de-a498-9ca94dd6a422,-98.34,debit,payment,AU00000,2024-05-04T03:49:27Z
transaction,0d24c9e5-167a-4451-817f-f429c67e1644,posted,Car Maintenance Expense,-95.27,26698912-f985-439e-8fa4-9537513a17cc,-193.61,debit,payment,AU00000,2023-06-04T12:30:56Z
transaction,e19bcfee-1514-4954-b1a3-fa34500b207a,posted,AGL RETAIL ENERGY LTD (GAS),-4516.84,09a09657-1e6c-4b26-bb74-c2c263e900fc,-4710.45,debit,bank-fee,AU00000,2023-10-10T19:56:20Z
transaction,47dc9094-6003-4512-97c7-7972ce530473,posted,Transfer Platnm Homeloan 346454,-1905.84,21909573-c831-465d-b328-4bdf4004ddcc,14715.1,debit,cash-withdrawal,AU00000,2024-02-03T01:44:29Z
transaction,9f241585-ff68-4cb2-8107-0919385fa11b,posted,TFR Acc14000 TO 12389,-1531.1,a97ecc37-fb6a-4226-afdb-6c7854d2b878,13184.0,debit,cash-withdrawal,AU00000,2023-11-28T12:38:54Z
transaction,2e515ed9-f6c2-496f-a5b9-517b1100b072,posted,AGL RETAIL ENERGY LTD (GAS),-1008.44,653dab63-6e1e-4ae2-9a08-b8b26696ffdb,12175.56,debit,payment,AU00000,2023-11-06T09:03:13Z
transaction,90609d28-12d1-4439-97d5-7520357fee57,posted,Pharmacy Purchase,-3585.21,821d3280-85d5-473d-ac55-47b8bffb1554,8590.35,debit,bank-fee,AU00000,2023-08-07T05:29:17Z
transaction,e9344d92-f1a0-46fa-ba80-8bd3cb223bea,posted,Payroll WFRMS 15439393,10035.34,3d5f19f5-2d5b-4d1c-a482-62b072dd0ae3,18625.69,credit,transfer,AU00000,2023-08-30T13:05:15Z
transaction,53a0108d-07bd-4a39-9901-5968ffa3f127,posted,Movie Ticket Purchase,-1781.07,aa95a673-ddc2-423c-b71b-dd3d622a0ff9,16844.62,debit,bank-fee,AU00000,2023-06-04T10:52:22Z
transaction,a304f449-f646-488b-9cb1-a8018b8aded6,posted,Netflix Subscription,-2501.14,bd306c1b-60b7-452b-8a1e-21210d51e8a0,14343.48,debit,bank-fee,AU00000,2024-02-25T16:31:38Z
transaction,b5ce8c35-d6bd-43d2-9442-b9b5c9f6ccc2,posted,Pharmacy Purchase,-4852.66,80ef4a5f-90ce-4ee2-b1aa-07305ab2ec1e,9490.82,debit,bank-fee,AU00000,2023-07-23T18:35:02Z
transaction,b0301978-f5fd-469b-a318-dad4c608554d,posted,Public Transport Fare,-943.19,f12d7185-a8e9-4bb1-bf09-d8eab630717b,8547.63,debit,cash-withdrawal,AU00000,2023-10-25T09:06:43Z
transaction,9f410c9f-5143-47b1-ab8e-89b9b17dccb2,posted,Movie Ticket Purchase,-4144.78,83d05319-27c0-4122-8975-1c69fd8da91c,4402.85,debit,cash-withdrawal,AU00000,2023-08-04T02:50:46Z
transaction,ace1001e-3c2a-415f-bacf-5f1ee0feac95,posted,Non Hooli ATM Withdrawal Fee,-1982.14,03b9bca4-9f61-4626-ba6d-46b7561897d5,16491.29,debit,payment,AU00000,2024-02-15T17:29:25Z
transaction,369c06aa-0158-443c-983d-63c7c21ffdcc,posted,Public Transport Fare,-4400.75,ad137646-0cfa-46b5-83a0-18e00f9bea0e,12090.54,debit,bank-fee,AU00000,2024-04-15T21:35:08Z
transaction,eaa66d87-e910-4a4f-a7e2-fa514fb82167,posted,Payroll WFRMS 15439393,10513.84,556a1ed2-b725-430f-ad0f-4bdf8869abdc,22604.38,credit,transfer,AU00000,2023-12-02T05:46:47Z
transaction,231f4977-fd34-4cb0-9f49-8dfed47e43e1,posted,Coffee Shop Purchase,-3734.75,e5288767-7929-4571-935e-cba5639a75d7,18869.63,debit,payment,AU00000,2023-10-13T19:34:04Z
transaction,4a0e57f8-22b8-484a-b287-049d3af5aacb,posted,Bookstore Purchase,-4927.44,0791c243-3573-44e1-82b8-abae246a6e12,13942.19,debit,bank-fee,AU00000,2023-08-23T21:05:54Z
transaction,5ea6be65-1b83-4aff-bb7b-2285e55af131,posted,Uber Ride,-3819.12,e8a5691f-da3c-423a-8eb8-bfdb33583465,10123.07,debit,bank-fee,AU00000,2023-07-04T18:27:24Z
transaction,37697156-4d0a-49b4-9b22-7e7ccb7ec44b,posted,TRANSFER TO JOANNA SMITH CAMPING,-1415.09,a0f67e07-1ef2-4bd9-815d-a854cb1679fd,8707.98,debit,cash-withdrawal,AU00000,2024-03-23T02:57:18Z
transaction,2f12181c-5072-40fa-8993-f701f8b3eb6b,posted,Public Transport Fare,-3907.27,e5585a1a-ee32-4b0f-ab9e-842bae92a7ed,4800.71,debit,bank-fee,AU00000,2023-06-14T22:18:38Z
transaction,0871c1d5-05b7-4e35-8657-9932368b7578,posted,Music Streaming Subscription,-3229.53,aa382844-689b-4ddd-8e0b-a7b45ff437e2,1571.18,debit,payment,AU00000,2023-05-23T08:00:21Z
transaction,cd7de51b-af40-4aa1-8ebc-a4e26c702bd9,posted,Non Hooli ATM Withdrawal Fee,-4436.34,e9a6c4b0-a210-4449-961c-36553ab9c4c7,-2865.16,debit,bank-fee,AU00000,2024-04-22T16:55:22Z
transaction,bd70e472-aff5-49d1-bfbe-4f8e9c6075bc,posted,Restaurant Dinner,-411.32,7d166c2b-4ca7-49ad-8a0f-5598932a21be,17244.4,debit,payment,AU00000,2023-12-11T07:47:05Z
transaction,b202227b-b875-433c-945e-73bd6b20c6da,posted,Gym Membership Fee,-582.12,ad0e2132-7974-4b83-9274-be137ef55d12,16662.28,debit,cash-withdrawal,AU00000,2024-01-21T04:59:35Z
transaction,7ed20bba-02ab-4847-a493-9a8639c3ecf6,posted,Restaurant Dinner,-3022.36,69b59c4b-a733-4d53-bed9-cb5100435ff9,13639.92,debit,cash-withdrawal,AU00000,2023-12-10T07:45:44Z
transaction,c7b885b6-2265-47d8-9987-0052b01a1c7f,posted,Netflix Subscription,-709.09,67afde3b-1f80-4078-96e0-d5b1348ef720,12930.83,debit,payment,AU00000,2023-06-26T04:36:09Z
transaction,6501c5ef-1e32-496f-bb19-b13925ddca21,posted,Amazon Online Shopping,-3851.14,b3b89066-cfc0-4840-a453-c643541df4ad,9079.69,debit,payment,AU00000,2024-03-09T19:34:51Z
transaction,b6d05cd6-e9ec-488d-a004-ff4eb1e3686d,posted,AGL RETAIL ENERGY LTD (GAS),-14.05,dc3dfdc5-389c-4f61-b1ce-79accf827b21,9065.64,debit,bank-fee,AU00000,2024-01-05T17:47:04Z
transaction,5cddd75d-be76-40bd-874c-fa63c05fc6b2,posted,Movie Ticket Purchase,-4842.48,99a8b2e2-37b6-4b58-ab94-ef4896af9454,4223.16,debit,cash-withdrawal,AU00000,2023-05-17T15:06:11Z
transaction,850ade2b-1228-4df1-95f2-eb68b6ba5192,posted,Non Hooli ATM Withdrawal Fee,-815.73,ce79e6e0-ca76-484e-9d78-0173bd9b42ef,3407.43,debit,bank-fee,AU00000,2023-06-28T22:08:39Z
transaction,7d9d31b5-3c07-408f-bab5-02afcc26ca15,posted,CTRLINK CARERS Ref: 998R6789201610974V,-4900.66,a1550bc2-5a48-4135-a4f4-784eb1341698,-1493.23,debit,cash-withdrawal,AU00000,2023-12-29T03:04:10Z
transaction,ab8eb677-122c-4644-9054-e598c245b8bc,posted,AGL RETAIL ENERGY LTD (GAS),-1359.03,2a89d1d3-6b2c-4491-a860-d3a277087825,-2852.26,debit,cash-withdrawal,AU00000,2023-05-31T11:46:44Z
transaction,b5548739-8e93-4246-aab4-546fb96ba5ca,posted,Pharmacy Purchase,-62.89,962284de-e482-47ce-b7a7-62489c48bfe4,10655.04,debit,bank-fee,AU00000,2023-06-17T20:48:53Z
transaction,fe039531-4ed3-4dc2-9565-08b79f08ceba,posted,Music Streaming Subscription,-461.85,a65d6708-0ad3-4e37-9680-c6b0de8d41e3,10193.19,debit,payment,AU00000,2024-01-25T07:21:25Z
transaction,b0aed25a-732f-419d-bf9a-9064ac497a0d,posted,Car Maintenance Expense,-823.42,3f1fbe08-ed2c-45f3-b1b3-b9ee4df7b4d5,9369.77,debit,cash-withdrawal,AU00000,2024-02-12T21:59:12Z
transaction,93038222-04ed-4b51-af49-5a1e728339d0,posted,Mobile Phone Bill Payment,-3147.06,d7529943-9e5f-449b-bdc0-42d2c8c5a152,6222.71,debit,bank-fee,AU00000,2023-08-16T05:09:08Z
transaction,0758afe0-098c-4002-a4ee-4e36f787f84a,posted,TRANSFER TO JOANNA SMITH CAMPING,-1526.91,1b699693-d139-46ee-be1c-931781564f84,4695.8,debit,bank-fee,AU00000,2024-04-15T17:37:20Z
transaction,07f689af-173c-46d1-ba8d-1027eae6525c,posted,TRANSFER TO JOANNA SMITH CAMPING,-702.27,4be95053-4a65-4ae0-8238-ac174a7932e0,3993.53,debit,bank-fee,AU00000,2024-01-01T21:00:32Z
transaction,71b19ec5-5d58-4faa-80e6-54bf3910afcc,posted,Travel Agency Booking,-2038.67,d03be74f-7e10-4a8e-9b00-c9b661cf1816,1954.86,debit,payment,AU00000,2023-11-09T11:00:47Z
transaction,963a43a6-a608-41c5-9bf6-8f062812c67a,posted,Clothing Store Purchase,-451.37,db9b6d64-4f0c-43f4-97ef-341dd6572570,1503.49,debit,bank-fee,AU00000,2023-12-02T15:46:45Z
transaction,7c1b1d11-4de4-4bf1-80c5-503af5e7dcea,posted,Pharmacy Purchase,-1452.48,de9088ad-a26b-4ba0-ad64-412908ef65b6,51.01,debit,bank-fee,AU00000,2023-11-12T05:55:46Z
transaction,9aa87c84-366e-45bf-a160-5f272c04f5f4,posted,Public Transport Fare,-1764.92,eb3b0074-16ce-4ce6-8963-9508137278e5,-1713.91,debit,cash-withdrawal,AU00000,2023-07-23T04:26:07Z
transaction,e2a63f5c-f0f3-41bb-a480-ce97988583bf,posted,Electricity Bill Payment,-135.82,ffda0fbd-485d-48d4-9cce-a8c566956cd7,15136.35,debit,cash-withdrawal,AU00000,2023-06-09T00:41:45Z
transaction,cdd6fca2-97f4-478b-b019-7dc68c667172,posted,Gym Membership Fee,-1422.06,1f11f1be-ff85-4718-8b66-18d48211d4d1,13714.29,debit,payment,AU00000,2023-10-07T05:12:24Z
transaction,286773be-be6d-4067-b753-b0d5fd28ffa6,posted,Gasoline Purchase,-3572.96,66afc608-ee87-45c6-81c3-0c00bda2390b,10141.33,debit,bank-fee,AU00000,2023-08-03T13:25:06Z
transaction,5a1cabac-c3eb-40ef-99e4-ed77a5caa3c3,posted,Car Maintenance Expense,-4349.47,ab865d80-06e8-4e1d-ab9f-efa404360404,5791.86,debit,bank-fee,AU00000,2024-02-15T05:25:58Z
transaction,c5125644-3179-41a5-b046-2f9be9dc5b95,posted,Car Maintenance Expense,-4433.83,e02bbd1d-a994-40a1-b1bb-f40ede5642bf,1358.03,debit,bank-fee,AU00000,2023-10-29T22:26:13Z
transaction,32bd3274-cb39-494d-afb5-e025255517c1,posted,TFR Acc14000 TO 12389,-4903.92,1756ae1e-ec88-40c5-a9e7-af3a9af6cf58,-3545.89,debit,payment,AU00000,2023-06-14T21:31:13Z
transaction,0b7943b5-d2bc-4c25-adaa-bd997cbfdd22,posted,Public Transport Fare,-4620.75,2c7b6e94-b898-4c83-8713-8a65b139b4c2,-8166.64,debit,bank-fee,AU00000,2024-02-29T08:51:43Z
transaction,d4cf8421-d447-45e8-97d5-da3350b53c02,posted,Coffee Shop Purchase,-4745.08,77cc191b-1b16-4659-8cc4-7fc1a2f8681e,-12911.72,debit,payment,AU00000,2024-04-13T18:11:14Z
transaction,4ed49281-4354-4a79-8847-433284114334,posted,TFR Acc14000 TO 12389,-2044.37,f5181619-3e82-4fa4-8d08-df862ee22e24,-14956.09,debit,payment,AU00000,2023-09-01T18:54:32Z
transaction,ee4fa182-e269-49c8-813b-2ed331e705e3,posted,Travel Agency Booking,-4596.54,b0c22836-0ae4-4136-9960-d8c93ecb5a96,-19552.63,debit,bank-fee,AU00000,2023-06-29T07:21:50Z
transaction,e4c36956-86be-4893-9370-b2c2aaec4b76,posted,AGL RETAIL ENERGY LTD (GAS),-696.08,3f5a8c49-7caa-4991-b318-aae4e6b7dc79,12422.98,debit,payment,AU00000,2023-08-22T16:29:49Z
transaction,6eb80a0e-4be0-497a-a678-b016d06a2b48,posted,Public Transport Fare,-3407.23,3fd297c8-9d5e-44b5-97c3-4d67f2837e6a,9015.75,debit,bank-fee,AU00000,2023-06-24T15:10:08Z
transaction,8dabe404-d0da-4ca6-960a-221d16d576b8,posted,Movie Ticket Purchase,-521.8,94bdbb29-c946-461a-b2fb-f669f3bb460b,8493.95,debit,cash-withdrawal,AU00000,2023-12-10T05:20:34Z
transaction,de118cc0-ea22-41d8-8b74-a958221d81a5,posted,Pharmacy Purchase,-3025.22,39345b09-43e4-4b1f-9256-07758be0ee79,5468.73,debit,payment,AU00000,2023-06-02T12:44:26Z
transaction,71a50336-a8ea-44af-a7cf-5ffe14e67002,posted,TFR Acc14000 TO 12389,-4935.68,e3a28e6e-9d7d-4c8b-a759-02d2fe050fe9,533.05,debit,payment,AU00000,2024-01-15T14:35:43Z
transaction,9489b1b9-9f11-4a8a-8d0b-c7392b5a3c00,posted,Hair Salon Appointment,-1612.57,3bcd7ecf-d784-46d7-82a6-47140d3754d4,-1079.52,debit,cash-withdrawal,AU00000,2024-02-01T10:00:19Z
transaction,980bcacf-b35c-41a2-85dc-0f507e058c38,posted,Clothing Store Purchase,-1947.3,5d1a8e0c-a6f8-49a7-be13-8056f540601d,-3026.82,debit,cash-withdrawal,AU00000,2023-09-19T15:04:42Z
transaction,3d136577-a4ec-4546-b5bc-d7313be51226,posted,Gasoline Purchase,-2545.86,82bb56b1-557c-4fbe-bc7d-89eb95581583,-5572.68,debit,payment,AU00000,2023-09-18T18:53:46Z
transaction,3e93638a-eea5-4006-9181-cbf341f1a406,posted,TFR Acc14000 TO 12389,-3089.32,db42d4e2-c772-4c7d-8f71-152560e9f531,-8662.0,debit,payment,AU00000,2023-12-26T12:05:14Z
transaction,3b1ef607-042c-43dd-826e-a56384cca8cc,posted,Hair Salon Appointment,-3164.05,eec09809-43a6-4f22-8bd8-724fbc7bc36f,-11826.05,debit,cash-withdrawal,AU00000,2024-05-09T00:26:16Z
transaction,5f6dbbd7-4442-4cf6-a5c3-cdb8485568c4,posted,Hair Salon Appointment,-3000.94,88fa84da-9de0-4c37-a51a-aac3326e08a7,13127.0,debit,bank-fee,AU00000,2023-11-24T22:08:59Z
transaction,5c01ef9c-2ee7-4074-b080-dee6f1d951dc,posted,TRANSFER TO JOANNA SMITH CAMPING,-4540.03,5778009e-462f-48cf-aa2e-6f6d7cee3889,8586.97,debit,cash-withdrawal,AU00000,2023-09-06T07:31:02Z
transaction,ba4606b8-1dc2-4dea-aae4-d517b2553210,posted,Gasoline Purchase,-661.73,856d3fde-a49b-44a6-953f-8943dbba60fb,7925.24,debit,bank-fee,AU00000,2023-12-25T14:54:16Z
transaction,3dc1eb28-4e19-4d44-b49e-52a6b84e183f,posted,Uber Ride,-3332.05,a1962aa5-d422-447d-9dda-cc70230a319b,4593.19,debit,bank-fee,AU00000,2023-05-19T03:01:54Z
transaction,73391c64-72e6-4d84-ad39-50984f861617,posted,Home Improvement Store Purchase,-4220.04,c6d6887c-af07-4c4c-a20a-3d10c35180ae,373.15,debit,payment,AU00000,2024-05-01T02:04:23Z
transaction,f1e7c9ca-e17a-464b-8f1f-72f6a5eca9fb,posted,Electricity Bill Payment,-1564.78,883db222-1a46-4ccb-968a-ddb9dbd6b643,-1191.63,debit,bank-fee,AU00000,2023-09-04T08:06:31Z
transaction,d8426cbb-9093-4827-b828-c462cbb76589,posted,Amazon Online Shopping,-4896.18,edc28c56-bf66-4690-9515-fb461eafebb8,-6087.81,debit,payment,AU00000,2023-09-26T16:45:20Z
transaction,9b8123a3-9fb6-44c9-a6a0-00328542005f,posted,Gym Membership Fee,-3326.57,d210bd3a-bcb1-4a99-a5fd-2d0299f3c351,-9414.38,debit,bank-fee,AU00000,2023-09-20T18:46:52Z
transaction,cf1584eb-d834-4f15-8c97-955db4d20505,posted,Payroll WFRMS 15439393,10104.28,7eb10331-d140-4cfc-8882-c33381bba4bd,689.9,credit,transfer,AU00000,2023-07-21T16:56:51Z
transaction,c9f80eff-af6f-465d-add4-6c2cdcd356e5,posted,Travel Agency Booking,-2970.55,59e0806c-303f-4cf9-9e5b-5af14b5d63e9,-2280.65,debit,cash-withdrawal,AU00000,2023-06-11T17:24:27Z
transaction,a23e421e-30e1-4e46-ad0d-d5772dce6a59,posted,CTRLINK CARERS Ref: 998R6789201610974V,-2905.04,8accfb35-cd2f-43c1-9829-1b1df1ae8561,11282.84,debit,cash-withdrawal,AU00000,2023-11-11T08:09:30Z
transaction,80595bfb-9eef-4e87-bbec-c01682b812bb,posted,Travel Agency Booking,-199.7,65b4cdd2-81de-4e7e-831c-c4bb44cebdcf,11083.14,debit,bank-fee,AU00000,2023-05-13T01:52:55Z
transaction,0329d073-f628-49e5-9464-35679f493898,posted,Uber Ride,-3871.31,b5d448ea-8003-4541-9983-3639673c638f,7211.83,debit,cash-withdrawal,AU00000,2023-05-22T04:07:05Z
transaction,316a2343-24da-48aa-9172-b7bd78e41097,posted,TFR Acc14000 TO 12389,-4981.72,71eb1078-9efe-4910-95f3-5f0298b8d3d6,2230.11,debit,payment,AU00000,2023-06-01T00:39:15Z
transaction,7e675baf-80d4-4ad8-9ed9-cf98bdfadd4f,posted,Movie Ticket Purchase,-4658.86,d9bba225-1a84-40bc-bc07-1d99b012a43f,-2428.75,debit,bank-fee,AU00000,2024-01-29T15:28:47Z
transaction,e51933cb-4627-415e-ad07-bc8a3db579ff,posted,Music Streaming Subscription,-185.11,c4e882ff-701a-4b8f-bfad-00487aeb3a76,-2613.86,debit,cash-withdrawal,AU00000,2024-01-20T11:50:18Z
transaction,ddf5fe34-938d-4c81-865b-3815fc3f2b35,posted,Uber Ride,-1340.01,4cc78457-0cca-4588-bd1b-16fc2b8e9d48,-3953.87,debit,payment,AU00000,2023-08-12T09:43:08Z
transaction,cf2e5b5f-51df-4690-b788-19e840c58c23,posted,Electricity Bill Payment,-2141.23,7815eed8-0b3b-4fe3-979c-609f079b3e6f,-6095.1,debit,payment,AU00000,2024-03-11T16:50:01Z
transaction,46f33a47-5973-401a-93fd-1fdf0af2b7a4,posted,Coffee Shop Purchase,-35.45,7106ab2c-f2b6-459e-a2c9-a51303f1ab57,-6130.55,debit,bank-fee,AU00000,2023-09-02T11:39:14Z
transaction,c5ca8476-8233-43eb-b4a1-1436b50c5ba1,posted,Coffee Shop Purchase,-2859.8,cc44b46b-cb50-44cb-801d-5189a218b9f0,-8990.35,debit,payment,AU00000,2023-06-03T07:55:28Z
transaction,63f94f59-95a7-4e0b-9833-43d475882e75,posted,Clothing Store Purchase,-266.19,37a626de-6168-4ea5-b780-90907211352d,8169.11,debit,cash-withdrawal,AU00000,2023-10-22T09:38:55Z
transaction,6fc62653-2247-4c5f-a3ec-4ae74e4d85c8,posted,Non Hooli ATM Withdrawal Fee,-1832.18,0525afc1-943c-4a15-825a-2aed0abb9b5d,6336.93,debit,payment,AU00000,2023-07-11T15:06:40Z
transaction,2de30f89-b5d5-4ab8-a8d2-362fad52bd48,posted,Bookstore Purchase,-1607.49,37a52119-5c75-4006-8827-fac46853f241,4729.44,debit,cash-withdrawal,AU00000,2024-03-02T18:02:16Z
transaction,0ba28cc9-d361-4643-9919-f9098af4ee1c,posted,Music Streaming Subscription,-954.29,98088191-8890-40d6-8bb1-b273494fd726,3775.15,debit,payment,AU00000,2024-01-03T16:50:45Z
transaction,818dd250-5678-45a4-b2b6-1f7ef9931fce,posted,Bookstore Purchase,-650.19,bac259cd-951c-4e7e-b428-7c100e6391a8,3124.96,debit,cash-withdrawal,AU00000,2023-10-10T07:40:16Z
transaction,23b71352-fa78-4acb-a0c0-4d5747f4230d,posted,Coffee Shop Purchase,-2585.12,bdd83cac-e8c9-4dc5-9060-1e35b9b63af0,539.84,debit,bank-fee,AU00000,2023-05-28T07:19:53Z
transaction,69b3a379-062c-4d7e-948b-c5934701e4e8,posted,Mobile Phone Bill Payment,-367.04,789426e2-9b89-47f7-9dcb-3bbf331582fe,172.8,debit,cash-withdrawal,AU00000,2023-07-16T14:24:09Z
transaction,ac02274f-4af6-4b9e-b957-bd070a02b87e,posted,Gym Membership Fee,-4936.16,b004d4d2-c728-442c-a82f-3a7f06d9f3a0,-4763.36,debit,payment,AU00000,2023-07-11T16:24:34Z
transaction,e433c6b1-cfbc-45bd-b798-3a81141e2283,posted,Gasoline Purchase,-2203.35,2a85f866-09af-45e5-bcfe-107543ab1817,-6966.71,debit,payment,AU00000,2023-12-22T19:43:35Z
transaction,38c57548-61c6-44d2-8de6-a1c86a255c2a,posted,Clothing Store Purchase,-1732.46,ab0dc55d-beb1-4bfa-9124-53b0df10247c,-8699.17,debit,cash-withdrawal,AU00000,2023-12-12T20:30:23Z
transaction,23a70dc5-81fc-481e-bf10-e62c49a17b38,posted,Netflix Subscription,-2704.06,4edd59dd-fc9e-4448-afba-2db272307b82,4742.87,debit,cash-withdrawal,AU00000,2024-01-03T23:39:47Z
transaction,26d245ef-a3db-4961-8ebe-7d534b7c620c,posted,Netflix Subscription,-1921.59,28788c78-4cf3-4bc8-876b-3a26c3a331e5,2821.28,debit,cash-withdrawal,AU00000,2023-11-08T18:35:47Z
transaction,f64ab2c5-4aa9-4aba-88f3-94e277991ea8,posted,Online Gaming Purchase,-1704.77,84789734-742b-4f4e-800f-5ac297eb6790,1116.51,debit,payment,AU00000,2023-11-29T00:10:40Z
transaction,5bc1979a-8371-4b2f-aa65-5d2c876f9bcf,posted,Home Improvement Store Purchase,-1079.52,819db2cd-d3cd-46f3-8c35-a8a4ce7a7a5a,36.99,debit,payment,AU00000,2023-12-12T06:31:27Z
transaction,528ce2dd-af3f-4f81-a9fb-bd0540fed5b5,posted,Music Streaming Subscription,-1175.32,99f04c69-f187-46d8-a6ff-f09784c77561,-1138.33,debit,payment,AU00000,2023-06-09T07:33:30Z
transaction,fd2133fa-cb0f-4535-86c5-decb136d7ea1,posted,Hair Salon Appointment,-2928.53,43eaaac4-ecbf-4946-bb62-72f0b9ea0b01,-4066.86,debit,payment,AU00000,2023-09-06T00:08:46Z
transaction,4dbf6220-41e2-4d3f-a3cf-9dd602d67941,posted,Mobile Phone Bill Payment,-2553.09,cde0c63b-cf21-4559-98c0-1705decfb9a2,-6619.95,debit,bank-fee,AU00000,2023-05-14T05:11:08Z
transaction,2ec7941a-03fb-42ee-8839-58d1b4c7bbaf,posted,TRANSFER TO JOANNA SMITH CAMPING,-2436.41,4ac3cc5f-4f1f-4761-97e1-89a6daf34f4c,-9056.36,debit,cash-withdrawal,AU00000,2023-07-19T05:08:17Z
transaction,8ee28ed6-c66d-466d-a879-625b69368864,posted,Netflix Subscription,-3337.33,bd681a4d-793a-46d3-a6a1-c043c62a62e5,-12393.69,debit,payment,AU00000,2024-03-03T21:46:21Z
transaction,5b04ff9a-5078-46c0-b0e4-974a535c87e9,posted,Payroll WFRMS 15439393,11721.05,c997a036-4f77-4065-a8df-f4f2b912fb58,-672.64,credit,transfer,AU00000,2024-04-04T21:36:35Z
transaction,e8781ab1-b8b0-470d-8f48-bbe4a13ba48d,posted,Payroll WFRMS 15439393,11375.58,fe548089-644e-4702-bd8d-3a220d5c88ff,18183.53,credit,transfer,AU00000,2024-03-18T12:15:17Z
transaction,c84ccd95-6714-49de-8c4a-cee3e8f6b924,posted,Transfer Platnm Homeloan 346454,-1433.28,31f906b0-fbeb-454a-aa44-6540b1b90c86,16750.25,debit,payment,AU00000,2024-03-26T22:09:59Z
transaction,9efdf54d-5bb6-4d50-a6c3-0a759859b10d,posted,Movie Ticket Purchase,-4958.05,b3e7fe07-9406-4562-b6a6-a1eee2688e88,11792.2,debit,bank-fee,AU00000,2023-09-27T15:02:18Z
transaction,d5a3a7c0-f518-4efa-9b6a-55efbeb60ef4,posted,Movie Ticket Purchase,-3398.51,e8e6bd55-eed2-47bc-a352-b020ab50f72f,8393.69,debit,bank-fee,AU00000,2023-12-11T08:22:53Z
transaction,538072e2-1350-4b38-aa65-2f323dfe20e3,posted,TFR Acc14000 TO 12389,-2800.02,e9ff98ce-4454-4099-96b2-0f5dfd678e02,5593.67,debit,payment,AU00000,2024-03-25T08:16:12Z
transaction,0331b941-e912-46c9-8256-63c358f7d809,posted,Online Gaming Purchase,-4989.22,824d1b97-22ee-41a7-bfcd-65a42fcf268c,604.45,debit,bank-fee,AU00000,2024-01-08T09:59:11Z
transaction,59e68958-3041-40e6-be2d-f9a2eeeece31,posted,Netflix Subscription,-3428.32,2b1d5fb6-ca80-402d-b48b-7771ab794f03,-2823.87,debit,bank-fee,AU00000,2023-08-18T20:01:11Z
transaction,c415b3a4-b0a2-4a88-9a15-1b454ce764e9,posted,Mobile Phone Bill Payment,-690.54,485d86e8-4cbe-4045-aef6-3918357a3424,-3514.41,debit,bank-fee,AU00000,2023-08-17T07:45:05Z
transaction,0b3a5cd0-677e-4a1d-80aa-11ff039f3e16,posted,CTRLINK CARERS Ref: 998R6789201610974V,-3294.25,19d569a5-f21a-4951-9aee-8f35e5660e7c,-6808.66,debit,cash-withdrawal,AU00000,2024-04-07T10:14:51Z
transaction,5da3e96f-6c3e-4e6a-a6b6-ba6341b0c157,posted,Wdl ATM WESTPAC IGA BALGOWLAH BALGOWL AU,-1408.16,134a45c3-1074-42ec-9da0-b763b1eabc43,-8216.82,debit,bank-fee,AU00000,2023-12-16T17:24:43Z
transaction,b8a79992-4e57-4588-ad65-b60d14c68bbd,posted,Coffee Shop Purchase,-4893.19,1844cfdc-fa3e-4b07-b6ce-8ee82e17226c,3323.4,debit,payment,AU00000,2023-09-25T10:51:51Z
transaction,2d1ec6ed-0c1c-4439-824d-1192ccff495d,posted,TRANSFER TO JOANNA SMITH CAMPING,-760.22,ade319c4-8d1b-4dc0-aa5e-b9d694a15cfd,2563.18,debit,payment,AU00000,2023-09-13T18:55:32Z
transaction,0ec5d7a0-50b3-45c7-9e92-89c88cb65a33,posted,CTRLINK CARERS Ref: 998R6789201610974V,-111.18,9776813d-f934-489a-afda-5b2ba3dade1c,2452.0,debit,payment,AU00000,2023-11-10T06:24:59Z
transaction,5556187e-66f9-4cd4-9654-3556d28bc391,posted,CTRLINK CARERS Ref: 998R6789201610974V,-1492.72,ca873374-634d-4777-adc4-991163e004be,959.28,debit,payment,AU00000,2023-12-22T09:09:28Z
transaction,35b5bcf2-6499-4ed5-b744-670d0ae96279,posted,Netflix Subscription,-3379.25,d1e11f1d-5f69-472b-9957-242f74acac54,-2419.97,debit,payment,AU00000,2023-09-15T01:53:55Z
transaction,259553bc-c2c7-4010-a249-c14135badc0c,posted,Amazon Online Shopping,-1913.82,52a3874c-c894-4385-a128-65ddea86cc38,-4333.79,debit,bank-fee,AU00000,2024-01-03T19:13:38Z
transaction,773cc7af-8a46-433f-b3e5-cd0f61f9eec1,posted,Public Transport Fare,-729.42,f8cefc01-e2e2-4dd9-a6bc-c1736ada5c8e,-5063.21,debit,bank-fee,AU00000,2023-11-18T06:45:08Z
transaction,5bdb63f7-2eb7-4663-aaa5-425990f0990b,posted,Home Improvement Store Purchase,-2765.6,d7e90933-2d0c-469b-90cd-d7aec6a647eb,-7828.81,debit,payment,AU00000,2023-11-26T12:09:21Z
transaction,9343edab-afa2-40ae-aed3-a269188502e2,posted,Uber Ride,-290.39,328fcbab-87a6-49b2-97bc-f1bdd1c70bd9,-8119.2,debit,payment,AU00000,2023-09-16T02:46:51Z
transaction,6d475efa-4cfe-4881-b7a9-e8d9af1f4ac8,posted,TRANSFER TO JOANNA SMITH CAMPING,-4776.75,7a14b83b-c253-4687-8cf6-c9aab91cae59,-12895.95,debit,payment,AU00000,2023-08-30T14:22:52Z
transaction,fde8353f-f85a-430b-81ab-9814570aed69,posted,Bookstore Purchase,-1384.96,c0af21f3-3b96-411e-ba73-cb1119f4e093,12340.17,debit,payment,AU00000,2023-11-21T18:20:45Z
transaction,7fffbf65-900a-469d-a253-63b93dd0817b,posted,Amazon Online Shopping,-3375.86,5365b952-1796-471a-ac39-675ddc3bccaa,8964.31,debit,cash-withdrawal,AU00000,2023-07-23T01:16:20Z
transaction,4603480f-34e8-4fd5-a8a8-39c3f5fb3a28,posted,Home Improvement Store Purchase,-3923.54,19d8f8db-78ef-4cea-aa12-a80c1131a53d,5040.77,debit,bank-fee,AU00000,2023-12-31T11:11:13Z
transaction,7394a7eb-59eb-4239-be95-e48325f62c2e,posted,Public Transport Fare,-1569.22,cdcb55fd-fb0d-490f-bd89-30b1063f1c04,3471.55,debit,cash-withdrawal,AU00000,2024-02-26T23:42:47Z
transaction,a07f67c4-fd5d-4f0e-9cde-148620718eca,posted,Music Streaming Subscription,-4158.03,71117173-0c8e-486e-8903-bb0715945618,-686.48,debit,payment,AU00000,2023-07-09T18:54:35Z
transaction,634e9e11-fb3b-42d8-a86b-f442dd9739ee,posted,Uber Ride,-1783.75,9197cae2-51a2-4a6e-a6c2-258880b10ecf,-2470.23,debit,bank-fee,AU00000,2024-04-25T23:10:31Z
transaction,d48192bb-cba3-420f-b679-3dfcb9bd805a,posted,AGL RETAIL ENERGY LTD (GAS),-558.77,f10165b3-fea8-4eac-962e-cca9cd7688bf,-3029.0,debit,payment,AU00000,2024-03-01T17:29:17Z
transaction,08352117-7af6-4787-bc81-f5aa27a977ba,posted,TRANSFER TO JOANNA SMITH CAMPING,-2048.85,39e92651-f9ad-41e9-b8ad-befef1876bd5,-5077.85,debit,cash-withdrawal,AU00000,2023-07-24T05:49:53Z
transaction,13b82c81-6ba5-41cc-aedc-a317d6b943bd,posted,Clothing Store Purchase,-1761.84,dba8c245-4d20-4e30-ae75-dbf95554c983,-6839.69,debit,payment,AU00000,2023-11-17T11:47:25Z
transaction,799016db-7b68-4eea-a66b-cc75422cec80,posted,Gym Membership Fee,-3968.52,ba3ff699-57a8-47e8-be00-a4fe36b4159a,-10808.21,debit,bank-fee,AU00000,2023-06-14T22:37:10Z
transaction,44f60c6e-5f90-4f0b-8b1d-25d279a4602c,posted,AGL RETAIL ENERGY LTD (GAS),-2385.77,f3a4d65e-beff-4a3e-8dd5-03c2cad42165,3479.12,debit,payment,AU00000,2023-12-05T21:07:09Z
transaction,589b068c-f980-4541-b191-99c2a7dee45e,posted,Amazon Online Shopping,-241.28,d3eadacb-0e88-416f-9703-73a2e0d271bb,3237.84,debit,bank-fee,AU00000,2024-02-08T09:34:13Z
transaction,0508837d-edef-4b1f-ade3-2805ee848166,posted,Gasoline Purchase,-499.35,9d530913-a4f2-4a07-80a8-5bd5c84beaa5,2738.49,debit,payment,AU00000,2023-05-14T04:59:22Z
transaction,f8ee8688-f1fa-4b32-942f-c7079eb38273,posted,Car Maintenance Expense,-1615.02,75bd3e45-c6df-4751-ac6a-011df751bd16,1123.47,debit,payment,AU00000,2023-06-21T18:12:14Z
transaction,8e36d1f8-52b3-4ee4-b7c5-715d06ddce21,posted,Travel Agency Booking,-4156.07,d70cf86b-d7ca-4304-910f-3a156f22fe65,-3032.6,debit,cash-withdrawal,AU00000,2023-09-09T21:44:01Z
transaction,f117387e-e680-4d82-bcc8-c58133da2727,posted,Music Streaming Subscription,-2643.72,7f75812c-8e7e-4581-a31b-dbf8848bf95a,-5676.32,debit,bank-fee,AU00000,2023-09-23T11:14:10Z
transaction,1b02ab4a-e392-4288-9a58-e84f9751ca4c,posted,Amazon Online Shopping,-4859.11,c3875194-96ee-45bb-9f42-7a94a85ce504,-10535.43,debit,cash-withdrawal,AU00000,2023-11-09T16:55:01Z
transaction,21de8f1f-10d4-47e1-a52d-88b2701b7415,posted,Hair Salon Appointment,-4449.25,ebfe113a-2d67-4979-b924-71202639dd82,-14984.68,debit,bank-fee,AU00000,2023-12-11T17:15:48Z
transaction,66ef9605-a7bc-419f-8c08-21637a018941,posted,Non Hooli ATM Withdrawal Fee,-4604.8,41d5ae1e-94f1-48d9-a2ff-7917862656e2,-19589.48,debit,cash-withdrawal,AU00000,2023-07-27T20:41:47Z
transaction,2c347f90-0928-46da-afc8-8cbefffc2844,posted,Online Gaming Purchase,-4401.98,2aa982d6-c969-455e-bf77-939080e3204a,-23991.46,debit,payment,AU00000,2023-05-20T13:51:16Z
transaction,cec30270-db7d-4d31-ba97-a0a43a7ea54f,posted,Hair Salon Appointment,-3772.95,5419abde-e990-40d7-8b1d-b0abc6713b9e,3084.41,debit,bank-fee,AU00000,2023-07-08T23:15:19Z
transaction,e1bfa408-fdd9-4bd2-9a52-20a50940eef7,posted,Netflix Subscription,-2661.31,147b317e-e750-41e5-8304-e41f498f5efe,423.1,debit,payment,AU00000,2023-10-01T02:07:35Z
transaction,caedda53-5c28-472f-9f64-a48df34a8839,posted,Music Streaming Subscription,-4844.63,bcdfcf02-bbb5-4049-bd38-98cf9f321046,-4421.53,debit,payment,AU00000,2023-06-06T11:57:03Z
transaction,6b0f8686-d712-4ac5-bc76-e4f1d86df93c,posted,Gasoline Purchase,-3542.67,4fc242d7-f384-4ec9-afec-eb251febb0df,-7964.2,debit,bank-fee,AU00000,2024-02-06T20:24:54Z
transaction,0d16280a-d1ad-400e-895f-8b544ae712c9,posted,Gasoline Purchase,-4660.38,f6e22836-f52a-462b-b8c2-6abf65c76361,-12624.58,debit,cash-withdrawal,AU00000,2023-10-05T19:02:32Z
transaction,528d9fad-b71f-4388-9502-1308a64cb851,posted,Non Hooli ATM Withdrawal Fee,-2533.72,c857e807-19f2-402a-b86e-d9746ec6fe86,-15158.3,debit,cash-withdrawal,AU00000,2024-01-15T19:13:44Z
transaction,8d4f8178-76de-4293-a536-2d94c2f7b69c,posted,Car Maintenance Expense,-1684.0,4ed2d073-c931-4b1c-a9ae-657ba92773a9,-16842.3,debit,payment,AU00000,2024-04-01T11:37:00Z
transaction,0e8b183b-cd46-435f-9e79-79c27319bc1e,posted,Non Hooli ATM Withdrawal Fee,-1731.17,031cb180-777e-4568-8fdd-c5c839d44601,-18573.47,debit,cash-withdrawal,AU00000,2024-02-04T08:17:34Z
transaction,e474bb1c-f136-4f3b-8506-47a00d8ebf40,posted,Amazon Online Shopping,-2758.52,f2cedef5-7e3d-4eb3-909e-35b0a63a255b,-21331.99,debit,cash-withdrawal,AU00000,2024-03-18T05:50:21Z
transaction,dd90c593-3c2c-4ec1-88fb-24697e0720f6,posted,Movie Ticket Purchase,-463.06,43857dec-523e-4939-9a6a-1b85466137c8,-21795.05,debit,bank-fee,AU00000,2023-10-16T05:36:55Z
transaction,49a8d29d-cf01-41a3-b319-6b7944514090,posted,Gym Membership Fee,-4446.81,1fe2141e-67b0-4b91-b950-9feb483e6134,13747.84,debit,cash-withdrawal,AU00000,2023-09-26T18:26:03Z
transaction,898e3386-0484-4401-8024-33a6de0de779,posted,Payroll WFRMS 15439393,11734.87,a1202080-9d76-4bb3-b14d-3236870c9bd4,25482.71,credit,transfer,AU00000,2023-08-05T23:12:47Z
transaction,9f09e2aa-a12b-4727-80c2-21502fc735b8,posted,Car Maintenance Expense,-1942.49,b9d3f517-3266-45cf-be77-3043df45adc6,23540.22,debit,cash-withdrawal,AU00000,2023-06-24T20:59:56Z
transaction,56fc6817-5d3f-4b05-bda7-278c31e9e334,posted,Uber Ride,-1884.97,518ab56a-c3c8-41bf-abcb-92d24caa52f9,21655.25,debit,bank-fee,AU00000,2023-09-07T05:25:04Z
transaction,3e19f9fc-60c3-4d74-ac77-574821ae8cd5,posted,CTRLINK CARERS Ref: 998R6789201610974V,-3007.96,c31a5a44-855a-4d4a-bfb2-1659a9078e16,18647.29,debit,bank-fee,AU00000,2024-04-07T01:04:48Z
transaction,29d42992-d255-4681-ae32-c8f6b002b857,posted,Car Maintenance Expense,-936.69,19b1afe0-3c9b-4126-9fc4-815bcf00d522,17710.6,debit,payment,AU00000,2024-04-30T09:43:37Z
transaction,e2d981fb-9393-42a6-bb24-abc6abc83526,posted,Gasoline Purchase,-2735.53,d2711c94-a3ca-4e03-a63d-b14610b7d365,14975.07,debit,cash-withdrawal,AU00000,2023-12-22T18:05:01Z
transaction,2e6607de-21e0-4db1-bf42-72f6c7dc3961,posted,Pharmacy Purchase,-1215.2,ef1da421-e09e-43d4-897e-4caf1a4ea102,13759.87,debit,payment,AU00000,2024-04-14T21:50:53Z
transaction,5dc306e3-e7c2-43e0-a84b-049eb041cc2b,posted,Gasoline Purchase,-4121.19,0e7f224f-3dee-4962-aac3-e035be184b07,9638.68,debit,cash-withdrawal,AU00000,2024-03-13T13:33:38Z
transaction,79980721-3d92-4779-9dbb-cfd4e5df7ad8,posted,Public Transport Fare,-2067.8,70e7ab70-0f91-4cd8-8f90-9d022e1a87b7,7570.88,debit,cash-withdrawal,AU00000,2023-05-20T05:07:32Z
transaction,19b137c5-c053-49a3-ba5c-955955d2bcae,posted,Mobile Phone Bill Payment,-3914.55,cf62d241-a89c-429a-8ccd-1db29c56a9d0,12377.48,debit,cash-withdrawal,AU00000,2023-07-25T00:46:28Z
transaction,179cd211-7401-47df-8d3c-879fbfaff16b,posted,Restaurant Dinner,-4171.68,3113ab87-649f-468c-a8b7-7c91dfd6359b,8205.8,debit,cash-withdrawal,AU00000,2023-12-15T01:23:20Z
transaction,33c4b429-2147-4e73-8514-6a78948ee26f,posted,Mobile Phone Bill Payment,-2142.67,4cae7422-0bf4-4653-b70a-325abd0672d3,6063.13,debit,cash-withdrawal,AU00000,2024-03-12T23:25:20Z
transaction,ba1b58fb-4cd1-4fd1-a9ad-0213da67c628,posted,Clothing Store Purchase,-3593.95,ab1302f9-7e78-418c-8966-db01dd68a8d2,2469.18,debit,bank-fee,AU00000,2023-12-07T02:05:42Z
transaction,bb037a34-8ec9-482d-83b6-54bc434bc7ce,posted,Online Gaming Purchase,-991.83,97740d45-861f-4ce0-9489-fa06bdcbdaa8,1477.35,debit,bank-fee,AU00000,2024-01-29T21:38:02Z
transaction,d74c24a3-a0f5-4654-816b-d08b8a9f697b,posted,Amazon Online Shopping,-2255.01,9043823c-b857-493a-8b3f-3a7dede202d9,-777.66,debit,bank-fee,AU00000,2023-12-18T05:08:32Z
transaction,e168ab23-6255-4df1-80e5-8c60580ca9f8,posted,Mobile Phone Bill Payment,-4340.57,aac62186-0a99-4c7b-bd94-cab90694a9cb,-5118.23,debit,bank-fee,AU00000,2024-02-04T11:49:09Z
transaction,8ec634cb-3958-450a-bc4d-503c236ef039,posted,Movie Ticket Purchase,-2178.79,0a18cbb3-9091-4773-8c49-3e9390b09c62,-7297.02,debit,payment,AU00000,2023-09-25T22:49:50Z
transaction,7b1e2ca7-10b9-4485-9694-2277d8d71e5d,posted,Coffee Shop Purchase,-2593.83,000756c8-d8f1-4aa5-a356-1499cd8d60d4,-9890.85,debit,payment,AU00000,2024-02-18T01:16:35Z
transaction,82a295a7-1c5a-4cb1-8ea7-25224baf2ea1,posted,TFR Acc14000 TO 12389,-2797.88,f38fb519-e5dd-4b69-ae20-ae58fa4ed046,-12688.73,debit,cash-withdrawal,AU00000,2023-08-19T21:54:22Z
transaction,314bb722-cd48-4a82-9919-21753a6fc4e7,posted,Pharmacy Purchase,-1725.04,aeadc235-af15-4054-91fd-94a3010c061a,5354.46,debit,bank-fee,AU00000,2023-09-27T17:57:55Z
transaction,f7352a0c-2b08-4353-a86c-a6c5164efc48,posted,Non Hooli ATM Withdrawal Fee,-2777.87,509f5e03-53a1-40fa-8e55-30de8be25fd6,2576.59,debit,payment,AU00000,2023-06-12T18:53:04Z
transaction,82e4143d-9e2c-43f3-a313-488873b83669,posted,TFR Acc14000 TO 12389,-2295.74,cc3309d8-851b-4aeb-861a-f1376c754ce4,280.85,debit,cash-withdrawal,AU00000,2024-02-12T22:52:39Z
transaction,79522c91-d1b4-46f8-89eb-d90ff16b7fc1,posted,Electricity Bill Payment,-2721.4,2e1b97ad-9a1a-4872-9129-6d7db47d4e75,-2440.55,debit,payment,AU00000,2024-01-08T02:13:13Z
transaction,825e5714-d343-4c7f-a394-2b86c24ddd3a,posted,Coffee Shop Purchase,-3546.4,9ae3d105-e74c-4fea-a234-f02c695332bb,-5986.95,debit,bank-fee,AU00000,2024-03-28T02:40:36Z
transaction,8b96a8f5-4678-48d7-adea-1ebb4f2ad69d,posted,Coffee Shop Purchase,-4765.88,3c616d13-7e15-4f28-a60b-cbc08cedde30,-10752.83,debit,payment,AU00000,2024-01-03T23:50:17Z
transaction,0f222481-90ff-4e06-89d0-a894dfc1554f,posted,Gasoline Purchase,-4488.35,7c605e83-1b81-471a-a5e9-3d0a53644d42,-15241.18,debit,bank-fee,AU00000,2023-11-21T00:33:41Z
transaction,17eee2f5-b75e-4c84-a71f-cf629f74a531,posted,Home Improvement Store Purchase,-4362.8,a9239aa6-0c37-4c1b-a901-8e62b953629a,-19603.98,debit,payment,AU00000,2023-09-22T14:58:26Z
transaction,d84a71bc-e3cc-43c9-8a88-884063c3903d,posted,Uber Ride,-3097.73,827b1db6-78a2-44cb-906d-43f3db6e551b,-22701.71,debit,payment,AU00000,2023-08-19T00:26:56Z
transaction,4d562825-f085-4abc-af30-f51ba411c78d,posted,Clothing Store Purchase,-27.49,ef323c4c-4978-4711-88fa-5c375ba1d4db,-22729.2,debit,cash-withdrawal,AU00000,2023-10-26T02:57:10Z
transaction,02b26b49-9f4f-4d9d-ab70-d00c4d321ca8,posted,Coffee Shop Purchase,-3338.08,41d09244-f551-403a-a0cd-1835036c6641,10918.5,debit,cash-withdrawal,AU00000,2023-09-25T08:20:08Z
transaction,e953f74e-89ac-41b1-b373-22c4548e70fa,posted,Amazon Online Shopping,-3513.02,c03c9bb3-2346-44cc-bfba-dc30e93f9784,7405.48,debit,bank-fee,AU00000,2023-07-14T23:28:51Z
transaction,82216e44-0d41-4043-bbea-a3f0d5b095cd,posted,Gasoline Purchase,-859.6,b3ec91d7-a9cd-40ed-aa15-d8af83c5f5ac,6545.88,debit,bank-fee,AU00000,2024-01-29T20:09:19Z
transaction,ab795a58-7364-4c2b-8108-7ba90e7e445d,posted,Hair Salon Appointment,-3760.71,09fa8e2a-5d88-43f7-a046-a8954c2e0dbe,2785.17,debit,payment,AU00000,2023-09-14T07:59:49Z
transaction,727a8eff-bc55-4cd5-955f-7dccf45c8015,posted,Gasoline Purchase,-4814.47,3e317993-e7e5-46a3-87cc-b89828e1d088,-2029.3,debit,cash-withdrawal,AU00000,2024-03-31T11:55:07Z
transaction,59c3640b-dc33-47f2-8130-20e3e91912d5,posted,Public Transport Fare,-4088.32,bb309c02-8f6d-4bc4-8672-ef137b7f23a3,-6117.62,debit,bank-fee,AU00000,2024-03-07T21:48:42Z
transaction,d1264e2b-460f-4472-aa26-1fc9c9a62f98,posted,Uber Ride,-1345.03,0efefd1b-ec6c-42de-b0ee-9daa5224f7fc,-7462.65,debit,bank-fee,AU00000,2024-03-27T18:05:37Z
transaction,4e96c119-c7e0-480a-b04e-756379fc1ca8,posted,Electricity Bill Payment,-1361.17,5c478017-d0c3-49b8-aa41-6492938b720f,-8823.82,debit,bank-fee,AU00000,2023-11-07T04:16:35Z
transaction,eda43590-c670-4f39-89c0-6c1ab6172fd8,posted,Amazon Online Shopping,-603.13,e81c9475-7040-4171-ab38-4aae9b509982,-9426.95,debit,cash-withdrawal,AU00000,2024-01-07T11:23:43Z
transaction,f5573ecf-db68-4b9e-bee0-ebb317c31177,posted,Manly Maths Tutor Wages,-1951.94,4d253a40-ffb8-46e1-af61-27af02be212f,-11378.89,debit,payment,AU00000,2023-06-21T00:05:12Z
transaction,0837faec-18ad-4471-a1b0-c6fbcfc62651,posted,Manly Maths Tutor Wages,-1114.44,a80f5ceb-da4b-48ec-a6e7-95f6849f00b8,16820.94,debit,cash-withdrawal,AU00000,2023-06-08T08:19:45Z
transaction,164cb5dc-a373-406b-828e-1705d67ca9b6,posted,Transfer Platnm Homeloan 346454,-997.67,15821f2d-cc1f-421f-87cc-276810e30cbc,15823.27,debit,payment,AU00000,2023-07-05T04:30:42Z
transaction,f9f1c82f-c2fd-4723-91cf-f79f94ebe0d0,posted,Amazon Online Shopping,-4763.03,fb921f77-004c-40ff-b4f6-a5a0a9bfb4a5,11060.24,debit,cash-withdrawal,AU00000,2024-02-06T08:42:15Z
transaction,25105796-d07e-4850-9695-65ba203872d7,posted,Netflix Subscription,-3223.98,f5b47dcf-7b74-4e57-864e-0895654b2973,7836.26,debit,payment,AU00000,2024-03-06T21:29:11Z
transaction,0c047ee1-4368-4ff3-b548-8b63929d34ac,posted,Travel Agency Booking,-1548.49,49d24fed-0ea6-4022-99b7-b00eb5ac91b6,6287.77,debit,payment,AU00000,2024-04-27T18:33:26Z
transaction,e97b2d9f-87e1-41c3-8d08-c8e9991d9aaf,posted,Uber Ride,-3390.89,8ff64173-9308-4a9e-b453-141b8d1815e8,2896.88,debit,bank-fee,AU00000,2024-01-31T04:08:36Z
transaction,f498bb40-cb1e-4870-b900-648d23e95c55,posted,CTRLINK CARERS Ref: 998R6789201610974V,-759.36,32f41fe4-772f-4dfd-a18e-9cb9cff04cf5,2137.52,debit,payment,AU00000,2023-10-01T05:06:36Z
transaction,e5f74dfe-f067-431d-8c05-91eb4d09f414,posted,Transfer Platnm Homeloan 346454,-1618.63,93af053c-14d3-4fe1-b4d9-e9870e3ada39,518.89,debit,payment,AU00000,2024-04-25T11:17:17Z
transaction,2d165078-02a0-46a8-af14-ee4fad855005,posted,Mobile Phone Bill Payment,-1682.39,dc0f79ff-8b0c-4f8f-8022-241dd6cb1e6f,-1163.5,debit,bank-fee,AU00000,2023-09-08T23:18:31Z
transaction,3866b9a7-70a5-41db-a7cc-c240825fb2b7,posted,Gym Membership Fee,-1059.39,36e4714e-ba44-4fef-85f2-b07596bf8f0f,-2222.89,debit,cash-withdrawal,AU00000,2024-02-03T12:13:21Z
transaction,6707d44e-e4b4-455d-879e-32bc0485edf3,posted,Bookstore Purchase,-2396.03,1fdae524-d9d8-44c8-8c15-a630c5c1b7b7,16889.61,debit,payment,AU00000,2023-06-19T22:44:07Z
transaction,2b256bc8-57f5-4738-8163-ceb82810d225,posted,Non Hooli ATM Withdrawal Fee,-1666.1,104991ff-6d68-4a92-9f3f-f341bb7986d2,15223.51,debit,cash-withdrawal,AU00000,2023-10-07T13:50:40Z
transaction,46ef672c-3364-4519-9222-0bb5b781bbb0,posted,Music Streaming Subscription,-349.39,e649f43d-1076-40c8-bd46-4ef18e43abde,14874.12,debit,cash-withdrawal,AU00000,2023-10-16T09:29:09Z
transaction,74c34ba5-66f1-4347-9f8c-82e7ed49fe59,posted,AGL RETAIL ENERGY LTD (GAS),-969.9,ddc34723-dd7f-4e9c-ae0b-a7d285793028,13904.22,debit,bank-fee,AU00000,2023-07-20T17:38:34Z
transaction,db567a9a-9f20-4c98-b9c0-1169a3ebcee8,posted,Non Hooli ATM Withdrawal Fee,-423.41,2ce90f46-66f5-44c9-b10d-c1e7ae35c2ea,13480.81,debit,bank-fee,AU00000,2023-10-14T04:15:50Z
transaction,73a051c4-8608-4fa2-82da-43ab8da0dd33,posted,CTRLINK CARERS Ref: 998R6789201610974V,-4019.53,0a25bdd1-0bbc-4255-a930-7eb058702920,9461.28,debit,cash-withdrawal,AU00000,2023-05-13T19:10:08Z
transaction,f66e88ec-5180-4f4a-8e45-1113021c706a,posted,Pharmacy Purchase,-12.67,1e89830c-85b6-4c45-ab86-8d33ade30aaa,9448.61,debit,payment,AU00000,2024-04-18T03:56:37Z
transaction,5b933d53-6fb2-4d3d-bfa1-794b374bdb29,posted,Home Improvement Store Purchase,-2938.43,edf7e60b-2b05-4d16-b7c4-45e39cae745d,6510.18,debit,payment,AU00000,2024-03-25T04:05:04Z
transaction,c677b893-7134-4967-a9bd-6b91a13520f0,posted,Gasoline Purchase,-1740.8,3811401e-82a0-4687-919d-c450b9bd5d24,4769.38,debit,cash-withdrawal,AU00000,2023-11-30T00:07:37Z
transaction,7b46ce8c-1cef-40ed-9881-8684da2d04e6,posted,TFR Acc14000 TO 12389,-1146.62,a10fe96c-bc4b-4661-ae1e-691d6b722d10,3622.76,debit,payment,AU00000,2023-10-29T14:13:15Z
transaction,eced3287-c806-4fc5-937b-a34d0b02f8ae,posted,Gym Membership Fee,-4921.26,1d1a9d2a-32af-4b68-bab4-2a20d6fb57ce,4822.9,debit,bank-fee,AU00000,2024-03-08T05:44:28Z
transaction,665d9833-f6c5-470e-ac36-1902bc7dd233,posted,Payroll WFRMS 15439393,10153.93,1bf50e97-6c08-432f-a378-b139830d9988,14976.83,credit,transfer,AU00000,2024-04-06T08:01:17Z
transaction,a60b73f8-1e01-42d3-9bbf-c96461aa1521,posted,Clothing Store Purchase,-3096.56,7ebe591f-5a6c-4f54-a3f9-46a2cd329dce,11880.27,debit,payment,AU00000,2023-08-08T00:00:07Z
transaction,04804941-5dfc-465b-bfa1-5e20b7b31c87,posted,Amazon Online Shopping,-1164.45,7586a74e-fe1d-4a3b-8c0f-9d960f0ac05e,10715.82,debit,cash-withdrawal,AU00000,2024-03-01T22:18:16Z
transaction,04363706-c2fe-41cc-a115-74e73f67d345,posted,Netflix Subscription,-2139.84,e4745ab4-c392-4d99-8dc7-e24c338ca396,8575.98,debit,bank-fee,AU00000,2023-08-09T09:03:26Z
transaction,cb6b0a6e-c05b-4f1d-a12c-2992174aaa6d,posted,Transfer Platnm Homeloan 346454,-3984.96,979003bb-4393-48ab-a30b-30eaaaf10cac,4591.02,debit,cash-withdrawal,AU00000,2023-06-10T12:34:46Z
transaction,e04f37b0-0165-4d07-9011-7c3017ca2cfb,posted,Uber Ride,-1342.2,5c43e730-ae3b-4503-8580-09ffac686c1a,3248.82,debit,bank-fee,AU00000,2024-01-07T14:20:16Z
transaction,56818226-ef50-465c-8f4a-840792b7fb46,posted,Electricity Bill Payment,-793.91,fe940fff-fe14-4e36-849e-94eb48a90bda,2454.91,debit,cash-withdrawal,AU00000,2023-07-06T11:45:08Z
transaction,227f4753-f6a5-4c92-87bb-2b0815f01733,posted,Gym Membership Fee,-4254.14,7f09171c-9688-4dce-89f8-127be6f04678,-1799.23,debit,payment,AU00000,2023-07-24T12:25:15Z
transaction,926d31d8-857b-4b43-8b71-c46cba8da2be,posted,Pharmacy Purchase,-3310.06,e3d030d5-a92e-477d-832b-e7eb37fecc25,-5109.29,debit,bank-fee,AU00000,2023-10-12T19:49:46Z
transaction,50f0353c-dfa9-41d2-8089-7da5b59a54fe,posted,Restaurant Dinner,-518.03,dad3644e-b0d2-4eac-a1a9-cbcf0a7ab588,12452.53,debit,payment,AU00000,2024-02-19T10:43:30Z
transaction,ff2b468a-7895-4f4f-b0f5-ac62dfa495d3,posted,Home Improvement Store Purchase,-399.52,7e95b20a-8446-4146-96f7-1ab34b20d337,12053.01,debit,cash-withdrawal,AU00000,2024-03-10T00:33:19Z
transaction,1234d1b6-29e3-4c72-b76a-c583516036f1,posted,Home Improvement Store Purchase,-3852.12,c5ffc0b6-76f7-4bb5-8718-c25b3ef4a9c7,8200.89,debit,payment,AU00000,2024-02-17T14:40:05Z
transaction,628cc349-2102-4306-8047-61ea51bccd8f,posted,Wdl ATM WESTPAC IGA BALGOWLAH BALGOWL AU,-4145.38,2f9abadd-5509-492d-bb2c-48c95b5bff94,4055.51,debit,payment,AU00000,2023-05-16T15:21:56Z
transaction,c31ac11b-379f-4649-9d7e-19c3634ede74,posted,Netflix Subscription,-3237.58,ca39afa6-be22-4440-9ff3-93d7ff2a5ea8,817.93,debit,payment,AU00000,2023-10-09T02:20:27Z
transaction,9f2e591f-284b-4bf4-a4a6-b51bd6fc9faf,posted,Gasoline Purchase,-2124.17,d79e22d7-b6c2-4333-831e-f3f7a535b6ec,-1306.24,debit,bank-fee,AU00000,2023-09-18T20:18:51Z
transaction,99ca74d4-9b33-4647-bf82-84f4bf9276a8,posted,Netflix Subscription,-2523.23,217ad59e-d431-426f-b23f-2b047577327b,-3829.47,debit,cash-withdrawal,AU00000,2023-11-03T02:53:04Z
transaction,b9a6dc30-a495-4e45-a956-e4d3913fa9ca,posted,Gasoline Purchase,-1268.42,ba6bc73a-4ddc-498e-a310-bd788aa186bb,-5097.89,debit,payment,AU00000,2024-02-11T06:24:35Z
transaction,117230be-a2f1-41a4-8d7b-9ebdf95e2dad,posted,Hair Salon Appointment,-226.8,b7fc2d9e-05e5-4119-aedf-e3349b5f0d9f,-5324.69,debit,cash-withdrawal,AU00000,2023-06-17T08:00:01Z
transaction,f6d94803-87d0-4b59-8048-3f134bf76323,posted,Travel Agency Booking,-1610.92,10be3917-c7b1-4bc6-bef7-c1ecadf88882,-6935.61,debit,cash-withdrawal,AU00000,2023-07-25T10:07:14Z
transaction,43723e3c-4c86-47ca-9b40-60b957051281,posted,Wdl ATM WESTPAC IGA BALGOWLAH BALGOWL AU,-4876.75,a0e5e73e-cf6c-4d61-b8e0-c1d3a9d8e7ae,8257.26,debit,payment,AU00000,2023-10-24T07:31:52Z
transaction,9bac71ee-9f86-40b3-bad6-6c82ff611d06,posted,TRANSFER TO JOANNA SMITH CAMPING,-170.5,24271d5e-24a6-4893-ba9c-b0cb824fb943,8086.76,debit,bank-fee,AU00000,2023-08-20T18:59:44Z
transaction,d8f0098e-8bf9-42e1-b96d-12236d62ae7e,posted,Pharmacy Purchase,-3439.82,98edebc0-869d-4f71-827a-e52e729bdb3f,4646.94,debit,cash-withdrawal,AU00000,2024-03-12T07:56:02Z
transaction,59809ccf-8471-4705-87a4-cb3f615ee6c8,posted,Car Maintenance Expense,-3143.73,94769f15-b11f-46d6-b3c8-b45106c64204,1503.21,debit,cash-withdrawal,AU00000,2024-02-26T22:54:30Z
transaction,0d35f750-49db-4ca3-9523-09a08e4b3721,posted,Pharmacy Purchase,-908.29,c30b81b9-600e-4373-a916-fbd66f49d038,594.92,debit,bank-fee,AU00000,2023-05-30T11:06:48Z
transaction,daa3d704-60ce-428f-9a78-17228b566c41,posted,Gym Membership Fee,-4238.2,29bdcc0e-37a0-4f28-9537-b1a122f83a01,-3643.28,debit,payment,AU00000,2023-09-15T17:44:44Z
transaction,a4bda3d2-f028-4126-98bf-b9ef255d40ab,posted,Hair Salon Appointment,-1588.07,40791a4d-50d0-488f-8709-da36c5212fac,-5231.35,debit,payment,AU00000,2023-11-27T16:53:53Z
transaction,d4a0c8ec-4a2d-4e17-9e08-52bb82460b95,posted,Hair Salon Appointment,-2766.84,74b99b3e-99dd-479f-b264-7df750080056,-7998.19,debit,bank-fee,AU00000,2023-12-03T07:29:17Z
transaction,eb8697c3-29a5-4aee-ab31-cdec621c9a03,posted,Hair Salon Appointment,-3039.51,0eaee580-2fce-42c8-b20d-0cf46f318cb8,-11037.7,debit,bank-fee,AU00000,2024-04-09T20:06:24Z
transaction,75c88588-beda-4bfc-b992-cf3620af0fd8,posted,Bookstore Purchase,-4055.17,b5848bb8-e0c9-4f7c-85c4-9ddf9938d076,-15092.87,debit,payment,AU00000,2023-08-22T05:02:22Z
transaction,e805e0c5-d503-47ef-b7a1-818b2a9b0047,posted,Gasoline Purchase,-1587.1,65d4e008-c1ef-4c7b-b517-89223bda9141,12743.18,debit,cash-withdrawal,AU00000,2024-03-22T13:58:28Z
transaction,41af65e0-9f7c-48f2-a079-cc4f3129df84,posted,Gym Membership Fee,-1981.06,a86dcd40-9016-46bc-942b-0f4e516beb29,10762.12,debit,cash-withdrawal,AU00000,2023-11-30T16:22:28Z
transaction,92a17062-053b-401d-9da8-7c8e43806e33,posted,Clothing Store Purchase,-3834.05,1fc73f84-a758-42ba-bbab-108faae03f71,6928.07,debit,cash-withdrawal,AU00000,2023-09-30T02:40:35Z
transaction,e0eac022-3fe1-4588-b5a9-59b2a2d6035e,posted,Coffee Shop Purchase,-2363.12,53998f95-11eb-47a5-8e3e-ae3b39fac7ee,4564.95,debit,cash-withdrawal,AU00000,2024-02-16T10:38:58Z
transaction,24bea833-7497-4fd1-a126-d3c70f4cd86b,posted,Online Gaming Purchase,-2397.17,a3208940-18c5-49b0-a8dd-6fb9fdfb6f76,2167.78,debit,payment,AU00000,2023-09-22T18:35:14Z
transaction,8e43756b-7b2c-4881-a5bf-37054e64156f,posted,Wdl ATM WESTPAC IGA BALGOWLAH BALGOWL AU,-269.76,2aa5ff19-0449-498d-a9f5-b86c0fc3bd98,1898.02,debit,payment,AU00000,2024-05-09T10:05:40Z
transaction,d257ecd7-21cd-4c88-87af-e714ab3c1d11,posted,Music Streaming Subscription,-4890.59,b16dd082-d779-4f4d-936e-e0cfd02e6dbe,-2992.57,debit,bank-fee,AU00000,2023-07-21T10:59:36Z
transaction,c17b6bac-9030-49b7-93d4-c12acfdbb654,posted,Coffee Shop Purchase,-787.12,f32a8a09-663f-4c46-9342-6c6a7579a62c,-3779.69,debit,bank-fee,AU00000,2023-12-20T05:13:16Z
transaction,7e1fce7c-9813-48d2-ad9a-86155033534c,posted,Pharmacy Purchase,-11.49,907efecd-0834-4ebf-9d2c-b83ec34d3674,-3791.18,debit,cash-withdrawal,AU00000,2023-11-04T17:42:29Z
transaction,d62a34ee-5a2d-4e78-90c1-24d149d0fb0b,posted,Clothing Store Purchase,-3547.19,7cf3f9a1-96b7-4b21-b477-9f41bd7c834e,-7338.37,debit,bank-fee,AU00000,2024-05-02T23:23:17Z
transaction,d1fa991c-542b-4fba-b6ca-76ff472a72e8,posted,Bookstore Purchase,-2575.83,c84b81ef-e62c-4bf0-aea6-12ff08577968,4192.02,debit,payment,AU00000,2024-04-27T16:20:26Z
transaction,32e677cb-a17e-452d-a446-44f6cba0f7bc,posted,Public Transport Fare,-2726.7,d1de31a2-4775-4826-9fc0-1c150e9d68a2,1465.32,debit,payment,AU00000,2023-09-06T13:03:43Z
transaction,b3d02a78-079a-4ee7-a391-c7c6a17e5862,posted,Public Transport Fare,-4474.64,697e0300-0be6-4e06-ae53-ed81b4436d83,-3009.32,debit,cash-withdrawal,AU00000,2023-08-28T12:33:45Z
transaction,a3532f4b-4bb0-43a7-9acd-36574fffebea,posted,Home Improvement Store Purchase,-3218.83,40393737-6eba-4957-a199-ebe9c408aa3f,-6228.15,debit,cash-withdrawal,AU00000,2023-09-30T01:35:55Z
transaction,1850eaa7-9d41-43df-8398-8f26493f338a,posted,Coffee Shop Purchase,-2810.49,344d186a-7f4a-4c42-ab13-fd2e5992124b,-9038.64,debit,cash-withdrawal,AU00000,2023-12-25T14:31:38Z
transaction,5af37aa3-b985-4335-aaa3-d9eb42f1505a,posted,TRANSFER TO JOANNA SMITH CAMPING,-334.14,a11db3da-9a58-4f19-9182-e9f0d4f16566,-9372.78,debit,payment,AU00000,2024-02-18T02:24:42Z
transaction,20e68201-7cdb-4469-83b1-0de62c529db9,posted,Manly Maths Tutor Wages,-3462.5,31f2b44d-5d52-4205-b773-97d7c4985ef4,-12835.28,debit,cash-withdrawal,AU00000,2023-09-21T03:54:06Z
transaction,b026c20e-0831-4444-9c6b-0b0f4ee676a2,posted,Car Maintenance Expense,-1616.26,08518bad-e397-435b-a5fc-e9d896b75607,-14451.54,debit,bank-fee,AU00000,2023-11-10T23:33:46Z
transaction,6cc4ac87-7ea9-43f3-ba7c-3c77a15519e7,posted,Non Hooli ATM Withdrawal Fee,-1813.95,4cca3e62-778a-4f3e-b69d-7d72c7299f79,-16265.49,debit,payment,AU00000,2023-08-10T11:05:12Z
transaction,0e202433-30b3-4e52-9e48-1d3aa99bccb8,posted,Amazon Online Shopping,-1379.66,0d06e667-1148-4d11-bd89-020006a396a3,-17645.15,debit,payment,AU00000,2024-02-06T16:34:11Z
transaction,767bc428-448e-48b3-a2ba-b4aa1db88554,posted,Transfer Platnm Homeloan 346454,-2798.39,e226ab75-b12f-4801-86bc-6d0d9868c7cb,5159.58,debit,cash-withdrawal,AU00000,2023-11-25T15:59:03Z
transaction,1a6ab920-741c-452a-a6d7-591f978e1f81,posted,Home Improvement Store Purchase,-4977.26,2c1c5895-5b3d-4f92-b1c4-766c1853182f,182.32,debit,bank-fee,AU00000,2023-06-16T13:36:38Z
transaction,cb85c9df-ae9a-480f-9903-c2cf5f5dc261,posted,Gasoline Purchase,-3197.42,1bf083ec-3912-43bb-a9ce-0cb5ea8e2136,-3015.1,debit,cash-withdrawal,AU00000,2023-06-17T16:59:52Z
transaction,8a0c6695-409b-4de6-a94d-006b39a25a69,posted,Wdl ATM WESTPAC IGA BALGOWLAH BALGOWL AU,-2015.13,8dd86572-24d0-42df-b59d-004cfb02e5c3,-5030.23,debit,cash-withdrawal,AU00000,2024-02-04T00:58:09Z
transaction,609b0ccf-a119-4960-9396-8e980daf4949,posted,TRANSFER TO JOANNA SMITH CAMPING,-2191.64,1f7fe8be-1872-4449-b523-944babc5af02,-7221.87,debit,payment,AU00000,2024-01-12T18:57:40Z
transaction,4955571f-88b2-41e2-9506-1e260e22f3e7,posted,Amazon Online Shopping,-2380.84,f8c83811-98bc-4b36-8855-6fd8ca5d4c5c,-9602.71,debit,cash-withdrawal,AU00000,2023-05-20T18:07:38Z
transaction,2a79d45a-eda4-4985-92f7-0957f00aa4fe,posted,Gasoline Purchase,-720.65,e1d620dc-54eb-4fb8-bf10-099810608bf2,-10323.36,debit,payment,AU00000,2024-02-24T16:19:29Z
transaction,93d78aef-c985-4cd1-af79-2bde40654f8f,posted,Electricity Bill Payment,-2850.27,1eef35ab-c047-4649-bbea-962012b5b30d,-13173.63,debit,bank-fee,AU00000,2023-10-02T09:21:47Z
transaction,85a4a99e-5b73-4cc7-8914-63eedb0266f2,posted,Pharmacy Purchase,-3675.0,6ad47001-573b-4ea3-8799-db509d99893a,-16848.63,debit,cash-withdrawal,AU00000,2024-01-26T08:50:17Z
transaction,2e0c378d-ae48-4a15-92c2-af4488930443,posted,Mobile Phone Bill Payment,-4954.46,8547a602-7355-4a37-a222-88016fa6d1fd,-21803.09,debit,bank-fee,AU00000,2024-04-01T10:14:37Z
transaction,6440ce44-c36e-4b34-86a9-4dc567dbba9d,posted,Home Improvement Store Purchase,-3776.72,0133dd2d-720b-493d-8358-380da33ddbc0,14939.59,debit,bank-fee,AU00000,2023-06-25T15:50:02Z
transaction,3174c455-3bfb-4abb-8f7a-31cb8fbabdc0,posted,Music Streaming Subscription,-3946.71,144c1a3d-6261-48eb-af2a-7fff2577151d,10992.88,debit,bank-fee,AU00000,2024-03-19T11:44:33Z
transaction,2b862c1b-0a2c-479d-83df-16a67cf41612,posted,AGL RETAIL ENERGY LTD (GAS),-2624.67,8bd1a1b8-13e9-45eb-9336-9cbf25808e10,8368.21,debit,cash-withdrawal,AU00000,2023-12-12T15:43:24Z
transaction,e31f2668-0f86-4c95-b106-1bf3eb3e25f6,posted,Pharmacy Purchase,-3707.63,eb0771cf-9f66-4e2d-a723-fb80883158e0,4660.58,debit,bank-fee,AU00000,2023-08-30T09:24:11Z
transaction,569777e4-8f7a-4c1a-bf2f-17ddb642f8e9,posted,Pharmacy Purchase,-224.41,274f46e1-8b3c-40c0-a1cd-5dcc1336c7dc,4436.17,debit,cash-withdrawal,AU00000,2023-05-13T04:31:46Z
transaction,6e2db083-a69a-43d3-8fcd-da09e6f8e21a,posted,Non Hooli ATM Withdrawal Fee,-1803.67,5b73c71a-3c98-440f-80d2-034aa3448039,2632.5,debit,cash-withdrawal,AU00000,2023-06-30T05:47:44Z
transaction,0b5a7405-00f2-4c47-9370-66deb99ef7d5,posted,Movie Ticket Purchase,-3012.53,cd2c4b20-695b-451d-9349-49b12c232ded,-380.03,debit,cash-withdrawal,AU00000,2023-06-29T01:43:10Z
transaction,b37ed709-1695-4717-8a3e-dbae91105e4c,posted,Electricity Bill Payment,-1237.15,adfe3085-7307-4b37-b9c6-d8dfc4cef3d2,-1617.18,debit,payment,AU00000,2023-08-13T03:37:20Z
transaction,29399009-8d7b-47ff-bf68-08041d60c43c,posted,Hair Salon Appointment,-1833.2,ad7b953d-65fd-4d65-8a4d-bd60ac8387a1,-3450.38,debit,payment,AU00000,2023-08-17T18:25:02Z
transaction,44d34177-172d-4d2c-a6b7-c36935182017,posted,Wdl ATM WESTPAC IGA BALGOWLAH BALGOWL AU,-3204.71,3a8b53bc-1654-491a-8f4b-bb3a1b65f943,-6655.09,debit,bank-fee,AU00000,2023-08-13T04:16:32Z
transaction,749a17bb-537e-4b1d-b0e6-5bdc26db4298,posted,Mobile Phone Bill Payment,-1338.02,51b0ea47-ec5d-4254-9492-40ef3a62fc00,10332.92,debit,cash-withdrawal,AU00000,2024-01-03T10:18:14Z
transaction,030afd5a-bfba-4bf8-ba65-fd70e0e69bb1,posted,Uber Ride,-3561.19,58a5baeb-df7f-4af8-a725-8716016221a8,6771.73,debit,payment,AU00000,2023-12-29T09:06:02Z
transaction,f967c2c5-fdd3-433a-a53c-c8d0408607f9,posted,TRANSFER TO JOANNA SMITH CAMPING,-3173.55,9fc7961f-2da3-4de2-ac69-96be9c1ec511,3598.18,debit,bank-fee,AU00000,2023-05-16T01:31:23Z
transaction,61c35d8e-5068-46a6-9e1a-eff9a1f46119,posted,CTRLINK CARERS Ref: 998R6789201610974V,-1391.98,607e6ef1-c727-428f-ba8c-2b20287b2ba1,2206.2,debit,bank-fee,AU00000,2023-07-27T15:12:02Z
transaction,c891ee25-e8cf-47b2-b14a-5e4a8ec9cec0,posted,Manly Maths Tutor Wages,-4493.83,0b141155-a94b-4454-96be-5e17881dbc01,-2287.63,debit,payment,AU00000,2024-04-13T11:59:26Z
transaction,9fff060c-e542-4b50-a273-e31442583f41,posted,Online Gaming Purchase,-3495.12,63509f8d-4acd-4171-9cc5-de5ec6a610cf,-5782.75,debit,bank-fee,AU00000,2024-04-02T13:14:49Z
transaction,26b328c9-d803-45a5-be44-f223909266e5,posted,Music Streaming Subscription,-6.88,c0c0bb58-2825-4818-afbb-9b2ad3dbc12e,-5789.63,debit,bank-fee,AU00000,2023-12-30T06:22:11Z
transaction,6137a8d9-e2fb-4e6f-b4d7-4ea1c91d3f9e,posted,Non Hooli ATM Withdrawal Fee,-2057.66,5d004ea6-cd38-4805-bbb6-0f90ac0a5e06,-7847.29,debit,cash-withdrawal,AU00000,2023-07-05T23:52:11Z
transaction,1fafe118-0829-4284-8ee1-0c27e63c3312,posted,Online Gaming Purchase,-655.49,46b63cdd-4a2a-4145-92bb-8920e8373b18,-8502.78,debit,cash-withdrawal,AU00000,2024-04-09T20:06:07Z
transaction,c16ca456-6277-4bc6-9c32-c791fe958070,posted,TRANSFER TO JOANNA SMITH CAMPING,-217.59,560d5ae0-9dd4-44f0-a1c0-bd0d62f6f068,-8720.37,debit,bank-fee,AU00000,2023-11-08T16:08:56Z
transaction,4c1b1f17-52a8-4065-b7c6-184262dc1b1e,posted,AGL RETAIL ENERGY LTD (GAS),-4518.23,21dcbbbe-e0ab-4834-ae33-0cb4fa05b7be,2095.27,debit,cash-withdrawal,AU00000,2023-08-25T05:31:57Z
transaction,37ad5ba4-1124-4759-a6dc-6fcaf698da5a,posted,AGL RETAIL ENERGY LTD (GAS),-2739.47,19a271c6-1d33-480f-b98b-ce5d28a67680,-644.2,debit,payment,AU00000,2023-06-19T17:34:22Z
transaction,47305ab7-10e2-489e-a480-fef037bd2c4a,posted,Electricity Bill Payment,-3270.88,8d215a93-fc9b-404d-b20d-98913d913742,-3915.08,debit,payment,AU00000,2024-03-30T21:10:44Z
transaction,d261d8d7-d4b4-4a08-a441-0a8df8ed63be,posted,Home Improvement Store Purchase,-2504.27,e5899c45-d123-4748-b6e0-dadb46d6e2ce,-6419.35,debit,payment,AU00000,2023-07-17T08:14:07Z
transaction,9ddef4ac-d90a-4788-959d-b5772477a02c,posted,Gym Membership Fee,-303.17,7005d7b8-918e-4931-9f59-f6414572de73,-6722.52,debit,bank-fee,AU00000,2023-09-24T09:22:06Z
transaction,bc628987-39d8-4160-87c5-c2a4c41f4b20,posted,Mobile Phone Bill Payment,-1205.02,87d6218a-ba77-4998-9014-681721febc22,-7927.54,debit,cash-withdrawal,AU00000,2023-12-31T19:48:32Z
transaction,345ba165-a4ea-4ac2-9d3e-adb6233fb440,posted,Wdl ATM WESTPAC IGA BALGOWLAH BALGOWL AU,-4332.58,3895337b-92f7-49e6-8715-5a093670105d,-12260.12,debit,payment,AU00000,2023-10-07T17:28:02Z
transaction,1fdaf3b8-8b4d-4c4d-840f-8e93e643fdce,posted,Pharmacy Purchase,-2147.3,6afd64fe-a9eb-486c-96bf-864593648e78,-14407.42,debit,payment,AU00000,2023-10-26T05:07:07Z
transaction,99588180-566d-4e90-a85b-22d41b494be9,posted,Music Streaming Subscription,-953.88,69f91ec8-ca44-4d79-b37c-582ee184ea26,-15361.3,debit,cash-withdrawal,AU00000,2023-08-01T22:38:08Z
transaction,b1562829-2959-4b07-8154-e5b7e1ebbfcb,posted,Transfer Platnm Homeloan 346454,-4459.07,710de086-78be-4ba0-92b6-44f7a6e66ae0,-19820.37,debit,payment,AU00000,2023-05-20T20:44:48Z
transaction,e7a9f25b-b580-41b5-9c24-9f4cf08f7a71,posted,Restaurant Dinner,-2970.86,2d65bb4c-cf01-48ca-9e3d-401997c44918,9999.64,debit,bank-fee,AU00000,2023-12-19T07:12:21Z
transaction,87914fd0-b951-44bd-b067-4825526fd911,posted,Manly Maths Tutor Wages,-4403.62,915bdb1e-1916-4994-98d2-48264543ed5a,5596.02,debit,cash-withdrawal,AU00000,2023-09-13T07:57:43Z
transaction,694e5ab8-737e-4ca6-88b6-4edd4f8c3892,posted,Movie Ticket Purchase,-3956.05,d3c768a3-7a04-4342-81f6-1db1cc35a443,1639.97,debit,bank-fee,AU00000,2023-05-30T08:26:23Z
transaction,09c4eae2-ac84-4c3b-b774-08e19645725a,posted,Netflix Subscription,-4743.22,904f461a-8d6a-4d0a-87cb-98eb0f5c9fbc,-3103.25,debit,payment,AU00000,2023-08-23T18:43:28Z
transaction,5cdf4047-43d6-42bd-80d0-166e4277db0f,posted,Public Transport Fare,-3033.53,b7b48453-2a48-4b17-9242-fff07055aeda,-6136.78,debit,payment,AU00000,2023-06-01T04:47:14Z
transaction,db866534-6bb0-4ce7-b973-5a1cc0ce64cf,posted,Travel Agency Booking,-2246.79,e840376b-d13e-4ca4-bf80-1f31afd24060,-8383.57,debit,cash-withdrawal,AU00000,2023-12-21T23:38:46Z
transaction,eb36aad2-0e83-4b69-87cd-2a1bfa68e8dd,posted,Amazon Online Shopping,-1253.12,6b840007-0558-4913-88c8-64c294320f37,-9636.69,debit,payment,AU00000,2023-05-27T14:59:14Z
transaction,2ef1bb49-cb50-468f-b3af-0bbb9f5d12cb,posted,CTRLINK CARERS Ref: 998R6789201610974V,-1375.22,30198cac-8ff8-4cdf-b2b6-73d4dac3a37c,-11011.91,debit,payment,AU00000,2024-01-23T10:12:57Z
transaction,d7f09470-8e42-4fc4-a9ea-dfe110597754,posted,Transfer Platnm Homeloan 346454,-3040.72,585396ec-4e28-4b2b-9268-0b0dcb943389,-14052.63,debit,payment,AU00000,2024-02-29T05:40:08Z
transaction,a7a87a44-c91b-49a2-8a92-58ce528ed5b0,posted,AGL RETAIL ENERGY LTD (GAS),-1521.63,063a6e7c-5d93-4746-b90e-7219e0050024,-15574.26,debit,bank-fee,AU00000,2023-08-14T22:50:00Z
transaction,e6d6661f-5503-4122-8c9a-b113f4b7f393,posted,Hair Salon Appointment,-2344.27,bfb6233d-4af2-4f2b-81fe-cc24b939589d,17613.08,debit,bank-fee,AU00000,2024-02-23T12:17:52Z
transaction,f5c9afff-49b9-46ba-8148-b20968215d37,posted,Clothing Store Purchase,-927.71,05f4ea7e-4a50-43d6-91d3-e90b74ecabbf,16685.37,debit,bank-fee,AU00000,2024-02-02T11:34:36Z
transaction,26293406-9f12-4b43-a141-fce291f8ad7d,posted,TFR Acc14000 TO 12389,-2664.91,201ebab8-d79a-4b1e-97a1-41ee04e1b595,14020.46,debit,payment,AU00000,2024-03-14T16:46:39Z
transaction,7d6956ab-ca70-4223-b6b0-f3989c5068d2,posted,CTRLINK CARERS Ref: 998R6789201610974V,-3494.62,f575a3fd-c4e0-4ba5-94cd-21c8b410a9bb,10525.84,debit,cash-withdrawal,AU00000,2024-01-20T02:21:04Z
transaction,96a85135-0e22-4483-b836-6d950b787290,posted,Pharmacy Purchase,-1827.99,94c5b924-8511-478a-a894-61a71c666a68,8697.85,debit,payment,AU00000,2023-08-20T17:29:24Z
transaction,1d18d8ae-2a5c-4342-ade7-3d2e3f45f0cd,posted,CTRLINK CARERS Ref: 998R6789201610974V,-2710.65,1dcff680-0efe-4e10-a50b-1834337c7164,5987.2,debit,payment,AU00000,2023-05-25T01:54:20Z
transaction,3c950f1a-ea64-4581-bf66-21fb236965e9,posted,Car Maintenance Expense,-1142.28,66a67e93-e0e1-4a5e-a9ff-d46e0d01f3a9,4844.92,debit,cash-withdrawal,AU00000,2023-09-05T14:28:09Z
transaction,83948588-7e40-4e53-a805-0d30e4f33195,posted,AGL RETAIL ENERGY LTD (GAS),-1589.34,9040aecf-542d-4599-84a1-dd8666cb9ec8,3255.58,debit,cash-withdrawal,AU00000,2024-02-13T21:38:23Z
transaction,2df94e21-3cf0-42da-b572-2d1684a5cd70,posted,Bookstore Purchase,-2315.99,9347d6e7-1bd7-4237-8db7-94b361be0160,939.59,debit,payment,AU00000,2023-08-25T11:28:13Z
transaction,831f1404-1197-4216-b338-134583456008,posted,Uber Ride,-865.08,be75c670-0354-458f-87d0-57950b36e515,74.51,debit,cash-withdrawal,AU00000,2023-12-08T19:52:53Z
transaction,f0e895aa-2414-4015-b1e2-1feddde4dfb6,posted,Movie Ticket Purchase,-4804.92,627e774f-568d-4723-a988-839133c3d721,8054.64,debit,bank-fee,AU00000,2024-02-29T20:22:28Z
transaction,87a6f387-0e47-4aa4-a9ce-d3408cbdc0b9,posted,Restaurant Dinner,-3300.73,978a47cf-3432-419e-b311-9da17d152e1c,4753.91,debit,payment,AU00000,2023-08-12T06:28:29Z
transaction,b2eafe89-4ef1-4d7b-bb8d-58c136284705,posted,Hair Salon Appointment,-532.74,6cd105fc-f344-4002-8ce0-8e4c96f88e1b,4221.17,debit,bank-fee,AU00000,2023-08-02T18:01:22Z
transaction,00b074d4-d263-4483-85c8-bdf204d5cbc8,posted,Electricity Bill Payment,-3358.98,ba61965d-95d8-4d80-ae53-9753fd715323,862.19,debit,cash-withdrawal,AU00000,2024-02-13T20:24:09Z
transaction,bf8582f2-d51e-4c60-9ac5-60f56e1fcbcf,posted,Online Gaming Purchase,-2743.64,581f7614-b215-4822-9f77-3139401ed3d9,-1881.45,debit,payment,AU00000,2023-10-12T23:41:02Z
transaction,5c058a3d-addf-461b-aeb6-9c4d3f15c04a,posted,Transfer Platnm Homeloan 346454,-2725.65,426b66a0-7de2-423f-abd8-e9e01cb7a6c3,-4607.1,debit,cash-withdrawal,AU00000,2023-11-20T17:02:28Z
transaction,d2b7b5d2-d499-4b45-9683-014e55259554,posted,Transfer Platnm Homeloan 346454,-1154.14,dbe4ad4c-b608-41a8-8599-60e4c6e0ea89,-5761.24,debit,bank-fee,AU00000,2024-02-12T21:44:27Z
transaction,54e72749-b46b-4ce5-ba7c-6acc00cf7dde,posted,Transfer Platnm Homeloan 346454,-3006.11,580a433f-bedf-4d9d-9f57-5515d75047c8,-8767.35,debit,payment,AU00000,2024-01-28T02:15:19Z
transaction,80695348-4ef4-4a5e-b543-831a7f5438f0,posted,AGL RETAIL ENERGY LTD (GAS),-3968.2,f6a03496-b748-42d0-9c63-d84c9d8f615d,-12735.55,debit,cash-withdrawal,AU00000,2023-07-12T12:01:52Z
transaction,e4cbbc2c-4c89-4fb2-9e51-56d6ab5646bf,posted,Movie Ticket Purchase,-767.34,c0721943-203b-4d3f-9b78-b4df7a5e3447,-13502.89,debit,bank-fee,AU00000,2024-03-15T05:54:59Z
transaction,2014efd6-7bb6-4ca2-a2bd-241be08d9006,posted,TFR Acc14000 TO 12389,-1015.65,7a754979-378d-40ad-a33a-b505e768e2f2,14187.78,debit,payment,AU00000,2024-03-30T07:38:33Z
transaction,923dcff1-5ffc-481e-85db-43122e9b31c7,posted,Travel Agency Booking,-3905.26,533dcd36-48dc-4c2d-95df-2e2a7996443b,10282.52,debit,payment,AU00000,2023-07-05T20:12:29Z
transaction,51fb4b7c-7165-45a2-81ff-af4174d43e3b,posted,Clothing Store Purchase,-4965.24,ed69467f-6017-4d65-a3b9-0b1f3da3d5c8,5317.28,debit,bank-fee,AU00000,2024-01-02T13:36:08Z
transaction,1f528c30-30e8-4d5d-82e7-8826703500ba,posted,Coffee Shop Purchase,-3474.98,efc7d0d6-e102-42fe-9dea-1e1aecda18cd,1842.3,debit,payment,AU00000,2024-04-04T10:59:01Z
transaction,9ad6e26b-415c-42cd-9f1c-1203546129eb,posted,Restaurant Dinner,-3418.4,a79e1d6f-ba81-43e8-a5b9-b89dcaf08412,-1576.1,debit,payment,AU00000,2024-03-12T02:00:28Z
transaction,bd45e00e-dbe3-439c-8d6f-bb3ea35bd80a,posted,Bookstore Purchase,-1627.22,28681f12-cf0f-4c21-bc20-939e7d47aef0,-3203.32,debit,payment,AU00000,2023-10-23T02:25:55Z
transaction,4cdf3772-4441-46da-a6f6-464d59d3608a,posted,Wdl ATM WESTPAC IGA BALGOWLAH BALGOWL AU,-3636.13,07fb70d2-9875-46bc-b9d8-67512f555715,-6839.45,debit,payment,AU00000,2024-03-20T12:24:09Z
transaction,426dc44e-69ce-4be5-944f-ae902c1f81dd,posted,Music Streaming Subscription,-4257.97,6e0cea73-64b5-48e7-8464-c0a54ce440e2,-11097.42,debit,cash-withdrawal,AU00000,2024-02-05T23:18:22Z
transaction,8ed84dea-8dee-4e8d-9c7b-863a282a556a,posted,Transfer Platnm Homeloan 346454,-822.59,ba3795a3-c516-4ea6-b4ea-c95b311c2a1a,-11920.01,debit,cash-withdrawal,AU00000,2023-06-21T23:00:55Z
transaction,9f0b0330-fc5f-47b4-8070-d384e0cb9246,posted,Wdl ATM WESTPAC IGA BALGOWLAH BALGOWL AU,-4106.54,4d3aa0ea-27c9-429b-baa9-bd8e196ef1b0,-16026.55,debit,payment,AU00000,2023-07-22T03:01:15Z
transaction,b4a4fca5-7028-4dce-a5c6-b4a35450ff78,posted,Clothing Store Purchase,-1257.72,2274645e-aaf8-486c-a8a0-473f7233d3a6,6487.03,debit,cash-withdrawal,AU00000,2024-04-14T14:21:36Z
transaction,662fdb3c-9169-423a-8d58-12def30b42b0,posted,Clothing Store Purchase,-4694.88,94bb96c0-14a3-444f-aaf2-69b11792d0e3,1792.15,debit,cash-withdrawal,AU00000,2024-02-01T02:46:05Z
transaction,dad0d28f-df32-407f-b6cb-2f313d45a9d7,posted,Online Gaming Purchase,-646.59,022f50a2-327d-47ed-a171-ee9b0bf9622a,1145.56,debit,payment,AU00000,2023-05-15T05:22:37Z
transaction,2e42c0ee-4cf0-4ed0-b130-37ec2d1367bd,posted,CTRLINK CARERS Ref: 998R6789201610974V,-15.61,83977797-a2c1-45a0-bd84-c7d4d2a1e777,1129.95,debit,bank-fee,AU00000,2023-12-02T13:58:57Z
transaction,a0401a66-050a-462d-9632-ad3050cdfcf7,posted,Non Hooli ATM Withdrawal Fee,-3634.74,3a5a3919-efbc-4219-889c-420eec5ef845,-2504.79,debit,bank-fee,AU00000,2024-03-15T08:49:22Z
transaction,a7d8f167-b874-456e-bf32-f7f07cc5575c,posted,Manly Maths Tutor Wages,-2416.8,3ff6d28c-3bca-4599-8222-52245e3a49af,-4921.59,debit,bank-fee,AU00000,2023-11-24T18:03:56Z
transaction,9449e483-27ee-4683-b22c-b876f8004db1,posted,Netflix Subscription,-3753.74,b0ad0fd6-dec9-407e-9b38-b822719483bf,-8675.33,debit,cash-withdrawal,AU00000,2024-01-21T22:47:51Z
transaction,e8b9d42a-748a-4128-886b-2d0a80ad3120,posted,Wdl ATM WESTPAC IGA BALGOWLAH BALGOWL AU,-1954.94,f6e46c25-c0a9-48c5-a90b-9d134cb77510,-10630.27,debit,bank-fee,AU00000,2023-05-12T21:57:10Z
transaction,42037930-5bc3-4831-b0d6-2ab71d28826a,posted,Mobile Phone Bill Payment,-1607.41,afb1718a-464b-4e49-9ec5-d6c82acb0270,-12237.68,debit,bank-fee,AU00000,2023-11-20T20:24:57Z
transaction,c8614c37-afb5-466c-a536-a737abbb8f59,posted,Pharmacy Purchase,-1498.76,7138911c-1100-4b31-ab0d-fca3c3e61822,-13736.44,debit,cash-withdrawal,AU00000,2023-12-24T13:16:54Z
transaction,989b8d95-64b1-443a-91f7-82c674fee58f,posted,Transfer Platnm Homeloan 346454,-1713.79,901d4cb8-3274-4ea3-85a2-c8f5053dd014,15987.88,debit,cash-withdrawal,AU00000,2024-02-18T13:04:42Z
transaction,1dfae03f-53ea-4be5-a4ff-eba6e1e79aac,posted,Hair Salon Appointment,-1800.56,6f9c195e-7091-49cc-a9de-54e3e82d1d14,14187.32,debit,payment,AU00000,2023-07-11T18:08:01Z
transaction,39834bb6-b154-4a1d-8e60-c3918b46e304,posted,Payroll WFRMS 15439393,11592.74,4a07f5cb-1a25-4499-ac6b-e0f24ea9f208,25780.06,credit,transfer,AU00000,2024-02-29T03:24:56Z
transaction,2c023865-5982-40c0-82c6-fca99d81e336,posted,Restaurant Dinner,-440.55,7c68e78c-bf17-4190-badf-940968074c29,25339.51,debit,payment,AU00000,2023-06-26T18:40:50Z
transaction,29813131-4117-4e8f-be41-88d21514427f,posted,TRANSFER TO JOANNA SMITH CAMPING,-3393.71,a3ea7e41-c67a-4344-a676-34afb381c4a3,21945.8,debit,payment,AU00000,2023-06-14T08:38:28Z
transaction,6204150e-472d-42d2-ba5d-42772560e084,posted,AGL RETAIL ENERGY LTD (GAS),-695.47,75c7af56-6c08-4265-9428-be353f8210f3,21250.33,debit,cash-withdrawal,AU00000,2023-09-17T03:55:43Z
transaction,004a7add-79bf-47cf-8091-8cdf5e52d0b4,posted,Mobile Phone Bill Payment,-4718.11,328906c4-c4ad-402f-8f91-cab5a18b6036,16532.22,debit,bank-fee,AU00000,2023-11-14T21:32:54Z
transaction,e073fee2-38ff-46e7-a721-a74e19fd0739,posted,Coffee Shop Purchase,-1703.26,4bfb8122-6800-4e6c-82b3-1bfaa7daf54a,14828.96,debit,bank-fee,AU00000,2023-05-25T03:07:28Z
transaction,9e5bf104-0c3e-4f96-baf0-318a7d29fc52,posted,Pharmacy Purchase,-1742.92,54a38475-c43b-40f4-bcb4-0493424e97e0,13086.04,debit,cash-withdrawal,AU00000,2024-02-21T15:59:47Z
transaction,884891a5-a531-4876-a851-620c43fe7610,posted,Online Gaming Purchase,-4263.52,c9a6c426-c64b-4627-b38e-0794ae1aaa86,8822.52,debit,cash-withdrawal,AU00000,2024-02-14T01:36:10Z
transaction,ea8e280f-3566-4644-b90b-4aba076e300b,posted,Electricity Bill Payment,-3246.47,7e47f5c6-bc30-4f08-8358-7e375e4a746e,4515.46,debit,payment,AU00000,2023-09-10T13:35:00Z
transaction,eb33435a-23f8-4394-9b91-690c85f1dce1,posted,Online Gaming Purchase,-1015.68,0234eed8-d896-45ca-b397-146d3017d369,3499.78,debit,cash-withdrawal,AU00000,2023-08-30T01:12:11Z
transaction,814c5dc4-60cb-4764-88ba-7ffcf61fad86,posted,CTRLINK CARERS Ref: 998R6789201610974V,-4883.38,37d00ddf-bd94-4582-93e5-56f8398143c3,-1383.6,debit,payment,AU00000,2023-12-08T02:06:05Z
transaction,f5ff2010-7cc9-469e-84dc-60cfcdf59942,posted,Uber Ride,-2877.97,dc80e398-bc0a-4714-8661-0833c0413189,-4261.57,debit,bank-fee,AU00000,2024-02-14T09:33:02Z
transaction,fcdff2be-cedf-4fdc-8efa-4f1b61fdc252,posted,Bookstore Purchase,-243.09,a68c8623-975d-451b-ba42-c406bc1f8644,-4504.66,debit,payment,AU00000,2024-01-17T14:18:23Z
transaction,82e70637-d7ab-4fec-a654-32a46f0c7cf1,posted,CTRLINK CARERS Ref: 998R6789201610974V,-3080.15,c0caded3-bb89-4677-8214-e19b049c3339,-7584.81,debit,bank-fee,AU00000,2023-06-25T13:16:18Z
transaction,2348af7e-5846-431b-bf5e-f58f0188caee,posted,Wdl ATM WESTPAC IGA BALGOWLAH BALGOWL AU,-4216.65,8961f49d-9c79-4e4f-a48c-4b5119997dca,-11801.46,debit,bank-fee,AU00000,2023-12-14T07:16:43Z
transaction,05b79619-6f43-41cb-8691-95860651e36b,posted,Gym Membership Fee,-277.11,171194fb-a7fa-4e97-b4fb-a61cc7ca031a,-12078.57,debit,cash-withdrawal,AU00000,2024-01-03T19:15:44Z
transaction,376ffef3-bbcc-4db2-a07e-728371431cce,posted,TFR Acc14000 TO 12389,-2280.34,3102d258-697e-4876-9423-dc2228c66a96,-14358.91,debit,cash-withdrawal,AU00000,2024-04-07T12:53:11Z
transaction,ea72be84-fcaf-4dbd-a86e-1720c0eb1384,posted,Mobile Phone Bill Payment,-1869.73,84ff56e1-cdeb-4034-8f3b-94d7ea4e444a,-16228.64,debit,payment,AU00000,2024-01-17T21:45:37Z
transaction,c362063c-4d21-403b-a1a3-d5ebc720e0e3,posted,TRANSFER TO JOANNA SMITH CAMPING,-795.77,4d553ac4-2452-42bc-b561-890940031ac7,14449.11,debit,cash-withdrawal,AU00000,2024-03-14T10:49:50Z
transaction,46e4a2c1-2d1d-4008-876a-4e1c14518340,posted,TFR Acc14000 TO 12389,-2634.5,bcf9d2d8-e67e-43c6-9b09-709c057c7063,11814.61,debit,bank-fee,AU00000,2023-06-11T04:04:47Z
transaction,80f88e67-0d2a-4277-97e7-54e25a85ed4a,posted,Non Hooli ATM Withdrawal Fee,-3363.66,4bef50ed-0468-45e6-bbd8-b31be603a651,8450.95,debit,payment,AU00000,2024-04-27T16:43:36Z
transaction,8ca205ea-5d68-45d8-992b-b0bb15775fcc,posted,Non Hooli ATM Withdrawal Fee,-459.27,b43d1ec7-3dbd-4789-b9e9-3142fd0af3eb,7991.68,debit,cash-withdrawal,AU00000,2023-10-20T13:00:38Z
transaction,b03873d2-2dd9-49ca-86e7-a6a8fbcac37e,posted,Hair Salon Appointment,-2730.88,a7169525-3c20-4a41-bec6-3b5cb280e1d4,5260.8,debit,cash-withdrawal,AU00000,2023-05-13T17:44:16Z
transaction,e068397e-ebe4-4bf9-a3ae-5c331b1c8aca,posted,Home Improvement Store Purchase,-334.0,2caf34a5-0528-423c-8aba-7407d2491708,4926.8,debit,bank-fee,AU00000,2024-02-03T07:38:15Z
transaction,6acf10f7-b389-417d-b993-06b17684f4d7,posted,AGL RETAIL ENERGY LTD (GAS),-2178.9,2abc2265-bcf3-480b-9da8-cccd7a516da0,2747.9,debit,payment,AU00000,2023-07-15T04:40:06Z
transaction,b33ef988-fed2-435c-a187-d44f31c5a124,posted,Transfer Platnm Homeloan 346454,-2062.77,dc0e9922-7057-4277-a23c-581ab13eb56e,685.13,debit,cash-withdrawal,AU00000,2023-07-18T23:18:35Z
transaction,0ee7c0cb-39e6-41ab-84f4-95f1bba87533,posted,Gym Membership Fee,-2016.83,5f27c2f1-8533-47bb-8b63-ea3f02be0f36,-1331.7,debit,bank-fee,AU00000,2023-08-14T05:12:18Z
transaction,51bdf439-bbfd-4dee-b0c5-2089974db383,posted,Music Streaming Subscription,-655.0,3a1ad8d6-ea66-42be-a7ad-16f95f13d27c,-1986.7,debit,cash-withdrawal,AU00000,2024-03-01T02:23:46Z
transaction,320b3804-4283-44d5-8b01-5b3187be4f3e,posted,Online Gaming Purchase,-4272.55,e55a2042-041c-4443-b2ae-8e78b51053a7,3123.81,debit,payment,AU00000,2024-02-24T15:03:05Z
transaction,21e50226-80ee-4c5c-8d0b-bc2d61d64c5c,posted,Non Hooli ATM Withdrawal Fee,-3581.5,013cb6f5-3fbe-415b-bfc0-0b26ef88b879,-457.69,debit,cash-withdrawal,AU00000,2023-09-09T06:32:43Z
transaction,8c11fbb7-1a3c-4abe-a589-317a5b46a59d,posted,Public Transport Fare,-1738.4,a4927bd0-0329-4db5-8a3f-42fece78edbf,-2196.09,debit,payment,AU00000,2024-03-06T05:00:20Z
transaction,987565ef-8ebf-456a-9f4b-310bb6075ff3,posted,Mobile Phone Bill Payment,-799.28,d360da35-7e0e-4c56-8cf8-ca225e7099c4,-2995.37,debit,payment,AU00000,2023-05-17T19:06:22Z
transaction,0655874d-c1b8-4a64-810a-dc0f6736f2d5,posted,TFR Acc14000 TO 12389,-3159.19,e14b6ea5-1716-4ae1-a763-ddc4c981aea9,-6154.56,debit,bank-fee,AU00000,2023-06-04T04:03:46Z
transaction,9f9bb54d-a332-491e-8b21-9df88b8c118c,posted,Bookstore Purchase,-3957.54,cbc60a89-ffc8-4862-ab09-4452be97a518,-10112.1,debit,bank-fee,AU00000,2024-03-25T06:05:41Z
transaction,b44d87d1-c512-4268-b870-d1ff610a7fe2,posted,Music Streaming Subscription,-3966.69,9c114aff-0679-409b-8293-d3e7b4f66901,-14078.79,debit,cash-withdrawal,AU00000,2023-09-16T01:48:28Z
transaction,b17ef662-1342-442e-8cf7-90fccf5076c5,posted,Netflix Subscription,-2364.62,2ba555f0-5862-41a6-b2a1-40d037c26be4,-16443.41,debit,payment,AU00000,2023-08-23T05:44:49Z
transaction,45753286-a794-4878-90a2-209da1b9f7df,posted,Restaurant Dinner,-4994.94,ce832b56-7c77-45e1-b908-d9788c215119,-21438.35,debit,bank-fee,AU00000,2023-12-21T12:45:37Z
transaction,184879c8-fff9-4821-9a2d-2a974211d744,posted,Hair Salon Appointment,-1977.24,87443e33-c446-48bf-87a4-aad011f24de2,-23415.59,debit,payment,AU00000,2023-08-17T16:47:25Z
transaction,8f61c5f7-d7db-4f75-9111-f55709976d36,posted,CTRLINK CARERS Ref: 998R6789201610974V,-2010.88,15775e00-645a-4e38-ae81-7a56fbf15550,10532.36,debit,bank-fee,AU00000,2024-04-02T03:00:36Z
transaction,5ab36dbb-b570-41be-a2cf-0e3b7437c86c,posted,Coffee Shop Purchase,-1795.3,792ebf85-8571-4114-914e-d99125a456d4,8737.06,debit,payment,AU00000,2023-05-13T19:37:20Z
transaction,e811b32a-555e-40e5-a561-bf6d6f998528,posted,Home Improvement Store Purchase,-3655.45,d4255ae7-b0cd-4ab5-8ee9-0ba4c62a623b,5081.61,debit,cash-withdrawal,AU00000,2024-02-14T14:45:33Z
transaction,2887a223-6b19-41be-8208-6e4fc852d18f,posted,Transfer Platnm Homeloan 346454,-2006.65,ebbbde83-69eb-45c5-a5ac-6cdd3b7b8424,3074.96,debit,bank-fee,AU00000,2023-05-19T21:40:35Z
transaction,24beac88-1e58-43cc-a417-d0ebe2ee06d1,posted,Pharmacy Purchase,-2283.87,474590d5-d580-4045-ac0f-044320156605,791.09,debit,cash-withdrawal,AU00000,2023-08-19T12:16:20Z
transaction,139eb7a0-4de2-4cfa-b41d-8462d3b85e20,posted,Gasoline Purchase,-4765.33,4ac3decc-4a61-46d7-8ba0-2afd27a23fc9,-3974.24,debit,payment,AU00000,2024-02-10T02:52:27Z
transaction,f40b76b5-3a95-4fee-a17a-d3b2927ef6ea,posted,Movie Ticket Purchase,-3372.01,d3351556-a3ae-4bb9-a6d1-e4ded2fbe1c5,-7346.25,debit,payment,AU00000,2024-04-08T21:29:10Z
transaction,c5b56d78-d0b2-4442-a2ef-15d5380d004b,posted,Manly Maths Tutor Wages,-255.51,304f2ac5-462d-45ae-b34c-86281c304537,-7601.76,debit,bank-fee,AU00000,2024-03-04T02:49:17Z
transaction,e574f258-eb65-4e68-acc4-9f57434b1e4e,posted,Coffee Shop Purchase,-736.71,1770807d-d935-4446-a0c6-bd92d0911433,-8338.47,debit,bank-fee,AU00000,2023-12-08T12:29:36Z
transaction,aa8172b1-88db-4e86-8398-fe8d674d1ccb,posted,Car Maintenance Expense,-4948.87,85f6e5ae-bd79-4fed-8805-aaaf052b66ea,-13287.34,debit,payment,AU00000,2023-06-04T16:25:17Z
transaction,ed9981f9-108b-4ba1-b200-e83389d1693d,posted,Movie Ticket Purchase,-4854.4,f31ed259-611f-4c31-ae85-2c8a8dc6bb4a,10024.3,debit,cash-withdrawal,AU00000,2023-12-13T19:36:25Z
transaction,b25cd85b-700d-4107-813a-bdb515c454f1,posted,Amazon Online Shopping,-2998.42,7419a364-ed79-439e-b53b-3513b21b05cb,7025.88,debit,payment,AU00000,2023-12-11T10:29:07Z
transaction,9f604785-1f8f-466f-8b62-b9b97405561d,posted,Car Maintenance Expense,-1929.29,a02b17cb-fe8e-4f59-a5d6-facb28c6665a,5096.59,debit,bank-fee,AU00000,2023-06-18T09:56:52Z
transaction,62dabcf4-49f8-4f97-8438-f6ddb7f8e832,posted,Uber Ride,-4925.98,22ed3557-de42-41a1-86e4-0fa60c8735e3,170.61,debit,payment,AU00000,2023-08-02T19:43:57Z
transaction,c521f92e-3fc9-4ada-81c3-77432d5ace0d,posted,Restaurant Dinner,-4094.29,d948b582-a893-4c92-acb6-9224337fa4e6,-3923.68,debit,cash-withdrawal,AU00000,2023-09-04T14:34:36Z
transaction,b5994cc2-b8c7-430b-bf1b-48280df93691,posted,Public Transport Fare,-886.79,b5528197-67ec-4aa9-bc73-ba24253e0fcd,-4810.47,debit,cash-withdrawal,AU00000,2024-04-06T22:19:22Z
transaction,9886dafd-29eb-4ddb-872f-9e7b59173784,posted,TFR Acc14000 TO 12389,-1345.26,5d2bf86d-7995-4e3d-a2b1-d74031e67dd5,-6155.73,debit,bank-fee,AU00000,2023-07-25T22:44:43Z
transaction,64ae3b1f-76ca-44d7-ae3f-54d66ea45d6c,posted,Electricity Bill Payment,-4989.66,6de7dc5a-63ca-40b5-9cc4-da1d2ad55084,-11145.39,debit,bank-fee,AU00000,2024-01-31T04:16:42Z
transaction,97e77412-6e79-4d44-a04e-6430e39f4f16,posted,TFR Acc14000 TO 12389,-1034.25,1f05c8b6-5669-4400-a07a-c390982f876d,-12179.64,debit,cash-withdrawal,AU00000,2023-06-04T10:04:46Z
transaction,9a3c6a05-34bc-4dc0-b5a2-489ae9af50ff,posted,Home Improvement Store Purchase,-1585.08,0cbc02c0-01e2-41df-bd86-789bfb55f8d8,-13764.72,debit,bank-fee,AU00000,2023-05-30T20:14:27Z
transaction,f477710a-1eb0-494b-a4f1-2c7d6cc37c4d,posted,Hair Salon Appointment,-4238.38,cc4aeabd-6c23-4bf5-8168-9143bac942a2,5400.86,debit,cash-withdrawal,AU00000,2024-04-02T21:25:53Z
transaction,431493f9-5573-409d-a3be-022daebbfabe,posted,Gasoline Purchase,-3798.1,748899f9-ce29-42fc-9cfb-7ff2810fec81,1602.76,debit,cash-withdrawal,AU00000,2023-10-17T22:04:48Z
transaction,e1917188-e303-4380-a082-7fa4b873e7b9,posted,Pharmacy Purchase,-1370.28,ffae9137-1034-4b6a-99db-645490113a32,232.48,debit,bank-fee,AU00000,2024-01-26T03:17:49Z
transaction,38d21831-f7d4-41f3-be5d-d05c1e0b98c6,posted,CTRLINK CARERS Ref: 998R6789201610974V,-4099.6,9dba0770-8b30-4787-8543-e819b893043f,-3867.12,debit,cash-withdrawal,AU00000,2023-09-06T06:30:13Z
transaction,98ed60f5-632c-4128-99a8-4599f85532d7,posted,Pharmacy Purchase,-1439.08,1207d0f7-c096-48c4-b101-18508cb31587,-5306.2,debit,payment,AU00000,2024-01-17T14:51:45Z
transaction,d1e4f2cf-fb3a-476e-9cf3-9b58025f703e,posted,Coffee Shop Purchase,-2404.69,956a1056-afd7-4834-bd22-2afbf3e72eec,-7710.89,debit,cash-withdrawal,AU00000,2023-12-07T02:26:46Z
transaction,78b40b03-433e-4dfd-befb-1465eec86b1f,posted,Home Improvement Store Purchase,-4991.84,8a831fbb-285a-425f-9448-212ddf5b6d94,-12702.73,debit,payment,AU00000,2023-07-02T07:24:29Z
transaction,77924820-f618-47ab-83de-2b0e861e1d94,posted,TFR Acc14000 TO 12389,-3605.25,bb40f5f6-b61a-413f-8362-58553fa2ba04,-16307.98,debit,payment,AU00000,2023-08-30T16:17:30Z
transaction,132de278-7a6d-47dd-ac0c-3d75e339d815,posted,Restaurant Dinner,-410.26,d26998a9-9e3a-42a1-90f3-1059550054c9,-16718.24,debit,payment,AU00000,2024-01-03T15:27:00Z
transaction,6c42d32a-f3fc-4bd1-b6d2-77da3308d26b,posted,Bookstore Purchase,-1715.34,0cf5edef-19bf-4abc-94a7-843731fbe6cd,-18433.58,debit,cash-withdrawal,AU00000,2023-11-15T15:10:29Z
transaction,ed234b24-bb3f-4939-83c8-5097d3f088ec,posted,Pharmacy Purchase,-1009.98,5ed098ee-072f-4247-bba3-161092f4830a,16353.96,debit,cash-withdrawal,AU00000,2023-09-13T03:28:37Z
transaction,14690000-6307-4be0-8da8-2029a7600d0b,posted,TFR Acc14000 TO 12389,-4808.42,230e5371-a618-497e-a0a1-722d104d84c5,11545.54,debit,cash-withdrawal,AU00000,2023-10-24T12:23:18Z
transaction,188c42b0-9f81-47dd-8d34-106ed159ac8d,posted,Uber Ride,-4239.69,accdab25-9545-467c-8e9f-b1d019179f94,7305.85,debit,payment,AU00000,2023-12-31T12:24:45Z
transaction,bc8be782-ff99-4522-8d8c-61bc681059da,posted,Clothing Store Purchase,-2378.46,9d47fb09-5cbe-4b65-9b12-114bb689cb40,4927.39,debit,cash-withdrawal,AU00000,2023-09-25T12:36:01Z
transaction,deebec54-16f1-4f69-af47-3de10da0953b,posted,TFR Acc14000 TO 12389,-4566.73,5fb4c6cc-0726-43e5-986e-300492971c16,360.66,debit,cash-withdrawal,AU00000,2024-05-05T09:21:44Z
transaction,48607d0b-fc4e-4fef-b782-a54b736d5fc1,posted,Gym Membership Fee,-4437.6,33589581-d7c3-4955-b1bf-02586ac5deeb,-4076.94,debit,bank-fee,AU00000,2023-09-21T01:23:48Z
transaction,36215725-46e5-48b3-b5c4-5c028cf17646,posted,Payroll WFRMS 15439393,11758.85,237190ac-9340-47af-877c-af8aafd6fe04,7681.91,credit,transfer,AU00000,2023-08-31T14:08:28Z
transaction,54bad158-1b48-4c9f-b7c7-3b8cfc171cae,posted,Non Hooli ATM Withdrawal Fee,-1132.29,6c7c140d-e5bb-4617-8984-afa2f4536b1c,6549.62,debit,cash-withdrawal,AU00000,2023-09-30T09:09:32Z
transaction,defc9673-4b55-45d5-9325-0cc31af7e2ce,posted,Coffee Shop Purchase,-4624.37,b07f46f3-20d8-49fd-9225-4fa666782fbb,1925.25,debit,payment,AU00000,2024-01-28T09:25:33Z
transaction,5ad4a814-07fe-49a7-bb44-8bfcc0e6d95a,posted,CTRLINK CARERS Ref: 998R6789201610974V,-18.51,033a1f94-16ba-4f20-a9f5-e60f18623c3f,1906.74,debit,payment,AU00000,2023-05-26T00:21:01Z
transaction,a9c09b08-b1f2-4f6d-a401-4c863337b23f,posted,Transfer Platnm Homeloan 346454,-948.33,94bc6c12-3f7c-43a9-a4d2-b406c11a7b08,15667.52,debit,payment,AU00000,2024-04-05T09:40:19Z
transaction,1414714d-c62d-4076-bde1-a9cd58370bcb,posted,Mobile Phone Bill Payment,-3745.18,10efab4f-1859-4c9d-9dd6-44eb77f65b14,11922.34,debit,bank-fee,AU00000,2023-09-05T01:00:37Z
transaction,67609288-3b65-42e4-aeed-4b104df9e4c9,posted,Transfer Platnm Homeloan 346454,-3788.04,eac18867-caab-4e25-b798-9df017753d3f,8134.3,debit,bank-fee,AU00000,2024-01-05T19:10:25Z
transaction,038d4b82-4918-41ae-b030-29ca12452ddc,posted,Wdl ATM WESTPAC IGA BALGOWLAH BALGOWL AU,-3939.98,580b2b49-0fb1-4393-adeb-6b81ab747bde,4194.32,debit,bank-fee,AU00000,2024-04-16T13:28:27Z
transaction,08d6da69-6189-4bca-b7fc-3304deb41824,posted,Electricity Bill Payment,-521.8,e0a3d161-dbc4-4e22-8887-c23d9218475d,3672.52,debit,payment,AU00000,2024-05-09T18:28:59Z
transaction,c192e199-9f58-4e78-9294-1aeb3f79e0c6,posted,Coffee Shop Purchase,-2502.33,b6573e59-3ac0-4a7b-be10-2ce198d2906d,1170.19,debit,payment,AU00000,2024-05-07T22:21:07Z
transaction,29b22afe-bbb5-41cb-9dc0-b65054317495,posted,Travel Agency Booking,-3340.16,7e6c88ff-eea6-4701-86d5-ac3d9ab9c7cf,-2169.97,debit,bank-fee,AU00000,2023-12-05T18:10:00Z
transaction,d8674dc6-1229-4fb9-85d8-4c3d60ac7531,posted,Coffee Shop Purchase,-1402.19,5d124b5b-73e9-43d5-9139-49b8b2b8e5d4,-3572.16,debit,payment,AU00000,2024-02-10T13:58:33Z
transaction,ee54884d-a790-4876-a777-084b0e3f05c4,posted,Bookstore Purchase,-3919.35,7e8d50c1-55df-4207-893d-64acd5bbf8fd,-7491.51,debit,cash-withdrawal,AU00000,2023-06-28T04:54:11Z
transaction,d13fb331-69a9-409d-b165-e4c0f536f5d6,posted,Home Improvement Store Purchase,-11.04,82958494-71cc-4506-ba3d-a329e40db191,-7502.55,debit,payment,AU00000,2023-07-26T18:53:29Z
transaction,20a32c98-1952-409e-aa92-ae09a3dcfdba,posted,Movie Ticket Purchase,-2981.12,928a1ce6-54fc-4791-a827-a3a949fe3ac4,3932.46,debit,cash-withdrawal,AU00000,2024-04-14T22:30:43Z
transaction,5f956090-02c9-4f6e-a77f-2ba6655352b2,posted,Movie Ticket Purchase,-2635.65,21c73b48-805b-477e-8c97-d7edd7482c95,1296.81,debit,cash-withdrawal,AU00000,2023-08-03T15:32:49Z
transaction,4cb29414-4b0a-4af1-b1b8-1448b9127864,posted,Movie Ticket Purchase,-4280.84,011563f7-df6b-428f-a52e-2f3bba077c8d,-2984.03,debit,bank-fee,AU00000,2024-04-27T13:56:06Z
transaction,03c5d03c-a661-43d3-b44c-8d7fff4ae28c,posted,Gasoline Purchase,-4086.26,2cd37bcb-a3fc-462f-b223-4409ecf298ed,-7070.29,debit,cash-withdrawal,AU00000,2023-09-14T21:27:47Z
transaction,2fc16474-4255-499f-80c4-99aa4997d06d,posted,Hair Salon Appointment,-3666.6,e5bf678b-2657-4c78-9c58-40f4ce5e1a19,-10736.89,debit,bank-fee,AU00000,2024-01-21T06:03:57Z
transaction,32e7e4f5-5ac6-4290-bcd1-801f19c719e7,posted,Bookstore Purchase,-1813.91,d97bde14-b9af-41e7-8974-bc85d1c67ebd,-12550.8,debit,payment,AU00000,2023-08-04T23:58:36Z
transaction,70ca35dd-1f24-45b2-bbad-8d6d1014902a,posted,Music Streaming Subscription,-4723.16,1f46de65-3551-4ef4-8b3f-15b343c752d4,-17273.96,debit,bank-fee,AU00000,2023-07-22T06:07:30Z
transaction,be491f9c-bfa0-4122-a751-a7db894d95c8,posted,Electricity Bill Payment,-1940.6,f6b0f2dd-338f-4bfa-aadd-8f058d4d0b7b,-19214.56,debit,bank-fee,AU00000,2023-12-14T02:56:38Z
transaction,234fb98a-2b3f-4e23-90bf-08fd737aaacc,posted,Music Streaming Subscription,-2107.36,67d3fcb5-bdca-49df-8c42-db8364989e74,-21321.92,debit,cash-withdrawal,AU00000,2023-08-12T23:03:13Z
transaction,6a2032b8-fa1d-4484-8a82-7bf7163da4b5,posted,Pharmacy Purchase,-1958.26,be51b539-eb86-4f78-8155-84b1f63efe4c,-23280.18,debit,bank-fee,AU00000,2023-06-18T08:11:25Z
transaction,cd75d652-854c-4a72-97fb-f3b78f18e49a,posted,Travel Agency Booking,-3335.3,10aa6393-860f-4267-be0c-6564bb6a2d46,1846.83,debit,cash-withdrawal,AU00000,2024-03-20T01:15:15Z
transaction,a0e32a79-c7a2-448f-a90d-63d095fd3848,posted,Payroll WFRMS 15439393,10881.86,81f75ec4-2de3-49d2-8a13-3c1c05ce9823,12728.69,credit,transfer,AU00000,2024-04-11T09:18:11Z
transaction,795047f5-0161-4230-9798-947281fe9848,posted,Pharmacy Purchase,-2005.29,d6b67eae-dac1-431e-8c66-0d92dfb6356c,10723.4,debit,payment,AU00000,2023-11-05T00:06:27Z
transaction,1e0f35e3-6066-4872-b527-973afdc22e14,posted,TRANSFER TO JOANNA SMITH CAMPING,-2163.56,24d51d95-5291-4891-87db-f6f909ca34f5,8559.84,debit,payment,AU00000,2023-05-19T01:04:43Z
transaction,ba1fbda4-27bf-4c07-ba6b-0451ea4b2fb7,posted,TFR Acc14000 TO 12389,-4458.46,7e946005-51a2-457d-85c5-cf97c9ae9aa8,4101.38,debit,payment,AU00000,2023-12-12T16:04:42Z
transaction,fa05292e-5323-4280-8c65-6e358f2832a1,posted,TFR Acc14000 TO 12389,-159.52,48714934-34a5-4ff2-a637-3d035a208feb,3941.86,debit,payment,AU00000,2023-09-11T21:04:02Z
transaction,e642e7b3-562f-4468-ad5b-53aacb503fdc,posted,Pharmacy Purchase,-834.82,ff0e4d28-b988-4ddc-99b3-60c9d532b705,3107.04,debit,cash-withdrawal,AU00000,2023-07-25T03:44:44Z
transaction,44c92215-46c5-4ae0-8050-c1dd2a2e29d4,posted,Home Improvement Store Purchase,-2678.93,b11ed3c6-0ae7-458d-a31a-32339cb9aa70,428.11,debit,payment,AU00000,2023-10-14T10:50:43Z
transaction,a039d576-e226-46f2-aee8-d91f40f88cd8,posted,Travel Agency Booking,-2878.08,38be59dd-cea0-4f7c-8df1-01d6c9f0f642,-2449.97,debit,cash-withdrawal,AU00000,2023-12-08T09:23:16Z
transaction,97444eab-2b25-4e3d-b61a-2c0b8364be0b,posted,Wdl ATM WESTPAC IGA BALGOWLAH BALGOWL AU,-4672.41,15160e21-5f7b-4a4d-90df-f06b747001ca,-7122.38,debit,payment,AU00000,2023-12-04T22:18:40Z
transaction,a4db6878-ff9c-4f98-9add-c9779090abd0,posted,AGL RETAIL ENERGY LTD (GAS),-20.68,1b7e3b17-6e82-4fd7-b1c1-3ca8342a8887,14901.78,debit,bank-fee,AU00000,2024-05-04T08:09:51Z
transaction,7b643796-59b2-4a78-a6ab-81de9af7027d,posted,AGL RETAIL ENERGY LTD (GAS),-4641.76,aabd9f19-5956-40aa-82e2-65d574854ed7,10260.02,debit,bank-fee,AU00000,2023-05-23T06:01:26Z
transaction,136cf1cc-3992-4935-9049-412d7f686b62,posted,Public Transport Fare,-3102.68,bcab7df0-3ada-4813-b139-49b65f61ff6c,7157.34,debit,cash-withdrawal,AU00000,2024-05-07T00:56:28Z
transaction,9725d0d5-d25d-4574-8a93-096f23d6296d,posted,Pharmacy Purchase,-1780.25,618597f3-39d9-4cf9-867c-139df770d626,5377.09,debit,bank-fee,AU00000,2023-10-10T11:39:32Z
transaction,69114f7e-3376-41c0-a525-1a3874c8e7af,posted,Amazon Online Shopping,-4078.11,a2006b1b-feb2-4d61-9af4-5e131ce19b6c,1298.98,debit,bank-fee,AU00000,2023-06-22T20:19:49Z
transaction,f2c34ceb-63a3-4ce3-ad5d-b8aa90242d06,posted,Non Hooli ATM Withdrawal Fee,-4608.71,1c309aa2-ae2e-4a4f-b3f5-320e773b85a9,-3309.73,debit,payment,AU00000,2023-11-18T13:39:45Z
transaction,653fb4c0-1dfc-4edb-b0b5-facffef5d948,posted,Clothing Store Purchase,-241.97,6830e620-9662-43c9-a8df-88fa101abe9a,-3551.7,debit,cash-withdrawal,AU00000,2024-01-29T17:22:17Z
transaction,736c279e-e7bf-4cdb-8e56-0aee373a83d6,posted,Home Improvement Store Purchase,-1104.73,b8700e2d-c837-4f73-9878-ddb7d18f8934,-4656.43,debit,bank-fee,AU00000,2023-12-11T14:58:56Z
transaction,169c2659-b0df-479d-8d58-073a8ba8b559,posted,Clothing Store Purchase,-4044.61,f4a7c5e1-a3a5-47d5-ba47-acb53ce6d23d,-8701.04,debit,payment,AU00000,2023-07-07T04:09:57Z
transaction,79ec8c94-aa8a-456f-a6b4-a82821ef7de7,posted,Netflix Subscription,-490.79,9ca42a47-ed68-49dd-b712-40bde05866cd,-9191.83,debit,bank-fee,AU00000,2024-04-19T07:22:13Z
transaction,928862f4-9f8b-4d6a-805e-ced4c220bf3e,posted,Gasoline Purchase,-3189.63,dd755bca-f496-4003-981b-c421302c073d,13205.59,debit,cash-withdrawal,AU00000,2023-07-08T15:15:59Z
transaction,c7acd7c8-e861-4b4b-9a7b-1003f49c5dde,posted,Gym Membership Fee,-202.46,8e1168e5-5f94-473e-864b-3787aba90e7a,13003.13,debit,payment,AU00000,2023-06-22T08:59:27Z
transaction,092e0df3-10e0-4d2c-ade6-609e1266a219,posted,Home Improvement Store Purchase,-3553.85,c69fc158-d0bf-47dc-bc39-3d5f5dcd9086,9449.28,debit,cash-withdrawal,AU00000,2024-03-02T11:26:16Z
transaction,20c94a1d-7387-4743-b8ea-0576409092d0,posted,Home Improvement Store Purchase,-1799.46,16d03aa3-e272-4873-9974-db5d1e2d8bb7,7649.82,debit,cash-withdrawal,AU00000,2024-04-13T05:42:02Z
transaction,2d24cddf-18cc-4d96-9773-6ebfe937a26e,posted,TFR Acc14000 TO 12389,-2648.03,6e570391-e1fc-4e38-8725-f50eb3df7f28,5001.79,debit,payment,AU00000,2023-10-13T23:03:35Z
transaction,fc12fd30-ee1f-4b7f-8924-aa7b97918e1f,posted,Gasoline Purchase,-1786.43,c1c88ae0-35d3-4d6c-a275-6ef162cd41a9,3215.36,debit,bank-fee,AU00000,2024-01-19T14:08:56Z
transaction,61f427d6-5e68-45d7-8d6e-2d3231e34007,posted,Wdl ATM WESTPAC IGA BALGOWLAH BALGOWL AU,-4871.34,733b2f2c-3fae-4c45-877d-1e55e1e7c89d,-1655.98,debit,payment,AU00000,2023-09-27T07:24:39Z
transaction,f1c7a395-c3d8-4e6e-8fd9-942cbe8c26fb,posted,Bookstore Purchase,-1276.92,e1f5a1f7-c25e-41bc-bf76-daee5cf3e3c0,-2932.9,debit,cash-withdrawal,AU00000,2023-12-30T15:38:02Z
transaction,a085162e-d0cb-4587-a909-cb0f6b34cc47,posted,CTRLINK CARERS Ref: 998R6789201610974V,-4879.27,faba548d-5f5f-4244-9b0f-d5d77f43b4bd,-7812.17,debit,cash-withdrawal,AU00000,2023-08-22T19:56:40Z
transaction,38c1f71a-95d0-40bb-b87a-651c6a8b6e44,posted,Mobile Phone Bill Payment,-4461.93,57f7fc3e-e054-4a5f-a43c-2b41932222ad,-12274.1,debit,payment,AU00000,2024-01-24T18:47:21Z
transaction,5cea300c-adb5-41e1-84c2-8bad00c16495,posted,Movie Ticket Purchase,-390.01,f39ae562-df5d-42e1-8fed-8f34e7cf30c8,10451.63,debit,cash-withdrawal,AU00000,2023-11-06T22:18:33Z
transaction,e268b8cf-deb7-44a3-aeca-c10bcb5711b6,posted,CTRLINK CARERS Ref: 998R6789201610974V,-2585.18,43dda1ea-8d5f-4c7e-a55a-35dbef755aea,7866.45,debit,payment,AU00000,2024-02-13T19:38:51Z
transaction,ca884038-0b25-4ad9-8a0d-0a3db629c7c7,posted,Netflix Subscription,-2801.19,da5a8994-e2a2-4d11-ae19-8c8eecf18aed,5065.26,debit,payment,AU00000,2024-03-24T15:03:12Z
transaction,e6ce9702-5919-4d14-8951-1292949d1dba,posted,Movie Ticket Purchase,-9.92,10e44ed3-0177-416a-bd8f-4371df32903c,5055.34,debit,bank-fee,AU00000,2024-01-26T21:36:50Z
transaction,235a7122-9eac-4ac0-950b-52fcdd57d4e3,posted,TFR Acc14000 TO 12389,-846.93,d51ffbfb-28a4-4444-b63b-59c3580efc69,4208.41,debit,bank-fee,AU00000,2023-12-26T18:16:23Z
transaction,7241887e-1282-41af-9eba-e31cbca4d278,posted,TFR Acc14000 TO 12389,-619.85,d062ac47-686a-4030-8bef-4512ad3437d4,3588.56,debit,bank-fee,AU00000,2023-09-24T10:33:14Z
transaction,e58ebd11-d366-44f7-b11c-8f972c1a8897,posted,TFR Acc14000 TO 12389,-4341.3,322e20ed-6d46-49e6-9ed7-fb290c876ccc,-752.74,debit,bank-fee,AU00000,2024-04-07T00:33:05Z
transaction,c9404cae-c36f-4bee-9f0e-cc7fb0a1d960,posted,Gym Membership Fee,-4190.59,98177dee-bc36-43cd-a571-1b0ddf95d959,-4943.33,debit,cash-withdrawal,AU00000,2023-07-20T09:45:09Z
transaction,e60cb6d1-294f-452c-9e5d-b6990414d545,posted,Movie Ticket Purchase,-1205.69,050d6b97-ae4a-4e46-8d85-15a97a7a403d,-6149.02,debit,bank-fee,AU00000,2024-03-04T22:14:25Z
transaction,834610e3-b2c6-456f-9f6e-5d94de37a107,posted,Electricity Bill Payment,-2398.75,eb6b07c4-1277-43c8-b01c-c108ef74dcb4,-8547.77,debit,payment,AU00000,2024-04-11T18:24:00Z
transaction,fd65a8d7-4987-4716-95c2-e98a9895f8aa,posted,Movie Ticket Purchase,-2098.78,28b9e524-15cd-429e-bdb5-d109e2fb82dc,16275.9,debit,bank-fee,AU00000,2023-05-31T10:30:16Z
transaction,88b3495a-5d18-46d5-8c0f-71730388e204,posted,Movie Ticket Purchase,-1652.28,182c5bc0-ad60-4657-b449-404be66e25c5,14623.62,debit,bank-fee,AU00000,2024-04-16T23:53:52Z
transaction,a53839de-bc5b-4248-892e-fa296c83504a,posted,Transfer Platnm Homeloan 346454,-4579.02,3e87986d-ceab-43d9-925d-4521168997d1,10044.6,debit,payment,AU00000,2023-10-12T17:37:25Z
transaction,cf0834e6-bfdd-4be6-8d41-e2297d2c44b8,posted,Electricity Bill Payment,-2767.78,c90fc2c9-1c50-45cf-97bd-2c9df7c2b3fb,7276.82,debit,bank-fee,AU00000,2024-03-31T11:52:18Z
transaction,9bb30a6b-8fac-49e6-a6ab-3a6efa9994cc,posted,Gasoline Purchase,-159.69,68796539-c225-4662-a421-93fa61f6e68b,7117.13,debit,payment,AU00000,2023-11-04T08:08:33Z
transaction,9487c591-3f66-4858-aa70-6e31f76db122,posted,Mobile Phone Bill Payment,-1677.4,ffb3c90c-26e7-4503-b8f0-eaf70efdc001,5439.73,debit,bank-fee,AU00000,2023-12-22T05:37:35Z
transaction,3b7e6054-41fb-458f-b969-f4b978d6331d,posted,Gasoline Purchase,-4576.46,99ef333b-000e-4043-a0b3-819f977d4d69,863.27,debit,bank-fee,AU00000,2023-10-13T05:00:56Z
transaction,3e58f75d-65ed-43c3-97d9-4672c36b3360,posted,Online Gaming Purchase,-4693.25,1d3b908c-c294-4685-a383-754bfc693abd,-3829.98,debit,cash-withdrawal,AU00000,2023-12-13T00:22:32Z
transaction,76b9814c-4903-43ef-a73a-df8f074ce858,posted,AGL RETAIL ENERGY LTD (GAS),-960.47,0879825f-bbd4-477d-96bb-f4d4af8f3957,-4790.45,debit,bank-fee,AU00000,2023-06-28T00:05:22Z
transaction,e2124c40-469b-4481-a918-a10fdc0f371d,posted,Travel Agency Booking,-671.06,2014d137-acc9-4152-b1f5-449b9fa9e048,-5461.51,debit,bank-fee,AU00000,2023-09-01T04:18:19Z
transaction,914cf36c-d5f8-4e21-9c07-ef198b753960,posted,Uber Ride,-644.31,43a1e8ab-39e4-4b2e-ba0b-89911aebbdf6,11705.19,debit,cash-withdrawal,AU00000,2023-09-28T01:01:21Z
transaction,8b05ac94-ef4a-4a9c-8936-1726adfd2e3f,posted,Pharmacy Purchase,-54.24,4b433332-f7ef-4252-bfae-528939ede930,11650.95,debit,cash-withdrawal,AU00000,2023-09-22T20:55:50Z
transaction,7eb56359-e833-48fe-8ce9-b3f55356af86,posted,Mobile Phone Bill Payment,-4169.4,f0466d7e-168d-4829-b1f5-f0c7fcc4d9f7,7481.55,debit,payment,AU00000,2024-03-31T06:42:32Z
transaction,71b39132-867b-4284-be67-651dab1a8290,posted,Manly Maths Tutor Wages,-3785.42,f90d47be-0604-4e6d-9bf6-4274864c2063,3696.13,debit,bank-fee,AU00000,2024-01-19T10:30:20Z
transaction,eb41386f-bfdd-4d65-8fee-0248881546e6,posted,Clothing Store Purchase,-3721.37,0f1cc754-906a-4fce-8a41-eda1ca72f689,-25.24,debit,bank-fee,AU00000,2023-09-18T20:15:26Z
transaction,91fe7148-77aa-41a0-9f0d-c6fa50c77bc3,posted,Travel Agency Booking,-2317.56,7bdb2bb3-2852-4d27-9530-7de484c0464f,-2342.8,debit,cash-withdrawal,AU00000,2024-02-06T10:28:26Z
transaction,6e388c98-e5cb-41be-8de0-5bc3aef7611b,posted,Home Improvement Store Purchase,-515.93,f52a48a0-04f5-47f0-bdb8-7957051db372,-2858.73,debit,cash-withdrawal,AU00000,2023-11-14T12:38:59Z
transaction,eb71b072-0299-4f94-9043-8d9101e3a075,posted,Electricity Bill Payment,-3516.16,5e9f79d1-14f5-4a7f-acc8-7907165342a8,-6374.89,debit,cash-withdrawal,AU00000,2023-07-19T21:36:33Z
transaction,31dc7ea4-29aa-49b2-b862-27203bba37cb,posted,Online Gaming Purchase,-375.64,f0c0c273-5b42-4e9a-b7bb-f318062f4d49,-6750.53,debit,payment,AU00000,2024-03-02T18:12:54Z
transaction,4d62edac-6f76-4af2-9df9-90488dce0c8d,posted,Gasoline Purchase,-4053.02,d06759b1-649b-4cb0-87b1-603ca275cf65,-10803.55,debit,bank-fee,AU00000,2023-10-05T18:47:24Z
transaction,a4ff611f-0241-4b73-b971-0cc187d0de5c,posted,TFR Acc14000 TO 12389,-1595.17,0c9b7cc9-c33a-44c9-8909-147a592516d2,13251.14,debit,payment,AU00000,2024-01-22T04:10:37Z
transaction,345fab26-e075-4322-9f0d-4f4d20c55fe4,posted,TRANSFER TO JOANNA SMITH CAMPING,-1328.88,5989ae9b-3a09-4cd5-b3d4-98deaa02c887,11922.26,debit,cash-withdrawal,AU00000,2024-02-04T12:32:03Z
transaction,8eef3b1f-d753-4c94-a834-e551a7bf87a4,posted,Movie Ticket Purchase,-3216.89,93d940b6-b65d-4cf4-8faa-1ab8095f0c31,8705.37,debit,cash-withdrawal,AU00000,2023-12-21T03:45:11Z
transaction,02fcfa3e-c650-460e-a0bf-7d26e7d13dbb,posted,Online Gaming Purchase,-4474.65,0b5c6cc2-1e12-4a5e-979f-8f4ebaa3fcad,4230.72,debit,bank-fee,AU00000,2023-08-01T02:07:49Z
transaction,055cc0d5-2a95-4880-8739-694a2dd7b9a8,posted,CTRLINK CARERS Ref: 998R6789201610974V,-2967.16,7319a72c-0eba-4a81-9620-3da8dda8da90,1263.56,debit,payment,AU00000,2023-08-06T18:43:04Z
transaction,796c2444-8632-4b26-a706-a3cdd0d3fe2b,posted,Electricity Bill Payment,-4237.01,36a6e9d6-8ca2-4ea5-bd33-94b4e384b17e,-2973.45,debit,payment,AU00000,2024-04-02T11:11:48Z
transaction,27aed616-f279-4e27-b82b-2fa4c8515bde,posted,Mobile Phone Bill Payment,-913.49,9fd41766-0f71-4260-bdc9-891d841d4abb,-3886.94,debit,bank-fee,AU00000,2024-03-28T19:39:05Z
transaction,8530946b-f7f8-498b-b964-3640deb75a70,posted,Transfer Platnm Homeloan 346454,-2538.59,70aec9a9-6c75-4a00-a045-c9f451dbf347,-6425.53,debit,bank-fee,AU00000,2023-08-29T17:02:30Z
transaction,efe0832b-ce4c-4f24-80bb-692ff41e60c4,posted,Travel Agency Booking,-2434.35,5aa4a111-b70e-4662-b5b6-3e6d2176d8b1,-8859.88,debit,cash-withdrawal,AU00000,2023-07-09T15:49:35Z
transaction,221d92ab-93ef-4413-86d6-a34b547713dd,posted,Car Maintenance Expense,-1762.75,9c47ee7b-97d5-433f-9444-276ff79e38ae,-10622.63,debit,payment,AU00000,2024-01-05T02:40:33Z
transaction,446f80b4-3335-4f8f-84ed-5981689fb874,posted,TRANSFER TO JOANNA SMITH CAMPING,-351.98,af9abf97-3054-4b46-9311-94d8575f955f,10257.61,debit,payment,AU00000,2024-04-21T18:35:36Z
transaction,e99f2163-8e74-4907-8c3e-5403a15d91d1,posted,Uber Ride,-4500.62,e73f3793-a48e-499b-a326-7fd8ae828fb4,5756.99,debit,payment,AU00000,2023-09-03T12:57:23Z
transaction,cc47b94e-5bbd-4cae-af40-13119adb3a89,posted,TRANSFER TO JOANNA SMITH CAMPING,-4453.23,12e6b6b3-6b1e-435e-bc69-82170a6c7092,1303.76,debit,bank-fee,AU00000,2023-05-18T00:34:10Z
transaction,d165ff64-5d0a-4c43-b469-2c3288f34d83,posted,Amazon Online Shopping,-1001.91,b0313fae-a6ed-4df9-9b0f-d7ad80372197,301.85,debit,payment,AU00000,2023-11-15T15:26:34Z
transaction,8ae36ce5-5dc4-4324-b5d7-9015a83f62bd,posted,Manly Maths Tutor Wages,-1168.89,8751490e-b361-40f8-91b1-1a970549b26b,-867.04,debit,cash-withdrawal,AU00000,2023-09-28T08:20:02Z
transaction,7d971c10-9603-42e5-a13b-de3cac76fe4d,posted,Manly Maths Tutor Wages,-741.47,7e8b8e0a-b118-46b5-927f-7b767f223aa2,-1608.51,debit,payment,AU00000,2024-04-30T04:16:21Z
transaction,6f4a2691-5618-4a5c-8e8f-31f8f5c39bf8,posted,Online Gaming Purchase,-1310.28,e70c3220-81ca-4dbb-a1d6-65528ea3d9b6,-2918.79,debit,payment,AU00000,2023-08-28T05:50:03Z
transaction,9689a5ed-4694-476b-ab62-888a908c77ed,posted,Gasoline Purchase,-433.83,87eca6f0-1596-4f69-97e0-18b674a52550,-3352.62,debit,cash-withdrawal,AU00000,2024-02-06T19:33:37Z
transaction,5642ba6e-3a06-421e-89cf-3f91eb6ca499,posted,Coffee Shop Purchase,-3909.52,a1b3e9e0-a9f7-44d4-b7dd-9d14b8e32f71,-7262.14,debit,bank-fee,AU00000,2024-04-11T13:18:31Z
transaction,22545b43-d7fa-4de8-9bf5-3fa77e662399,posted,Travel Agency Booking,-1697.6,1ad5e35f-ce41-4431-8209-071b1a43e463,-8959.74,debit,payment,AU00000,2023-07-18T14:37:42Z
transaction,29e5b870-1e97-4838-8ea0-475ed383ddf6,posted,Restaurant Dinner,-3717.94,2327346e-f3ae-48d0-846f-3d7f32227963,9935.69,debit,payment,AU00000,2024-04-13T13:28:19Z
transaction,426dbbff-e6e8-458d-b14a-9c55353f3777,posted,Hair Salon Appointment,-1986.53,f16e9a9c-8424-4de4-b242-f8e0081c6a8d,7949.16,debit,bank-fee,AU00000,2024-05-10T11:21:39Z
transaction,5448074f-eee8-47fe-86cd-0645e36b21ad,posted,Non Hooli ATM Withdrawal Fee,-1375.49,6b5b8164-5734-4a9b-9fe9-64e984fb957b,6573.67,debit,payment,AU00000,2023-05-12T11:48:08Z
transaction,bbde531b-5608-4c67-8afb-d7d44bcd3332,posted,Transfer Platnm Homeloan 346454,-2622.64,1733f016-b5f0-4a0f-b706-cfbbac85b718,3951.03,debit,bank-fee,AU00000,2023-09-09T21:56:40Z
transaction,77b4c18a-f397-4cf6-98a7-2e8e931b10a9,posted,Car Maintenance Expense,-516.08,f34a424d-9fb7-45b6-b9de-fb6cf195e9ee,3434.95,debit,payment,AU00000,2024-02-01T16:07:37Z
transaction,f49c62a9-a2bd-4e53-ac0c-2a6d17da528d,posted,Clothing Store Purchase,-4809.69,996ca95c-e8c7-40d1-9842-38bab732ab63,-1374.74,debit,cash-withdrawal,AU00000,2024-05-03T15:47:05Z
transaction,5bb45dd5-7758-4583-8705-6641df28e60b,posted,Travel Agency Booking,-920.22,a375d2c3-0eb0-43a1-afce-8a15e85e4aee,-2294.96,debit,payment,AU00000,2023-05-31T17:38:59Z
transaction,89d6b4e7-2296-48c7-9828-c9c1ca202cf2,posted,Hair Salon Appointment,-3274.53,d3df1c98-bcc7-4355-9e96-192935b28269,-5569.49,debit,bank-fee,AU00000,2023-05-31T04:58:34Z
transaction,49af7875-ac9b-4a3c-809b-74c20246df5f,posted,Public Transport Fare,-4750.56,b3c08c5b-c22c-4720-a57d-6619ffd2ded9,-10320.05,debit,payment,AU00000,2023-05-23T01:07:18Z
transaction,ec7a3c81-045e-4053-9205-95f8f9dd27c2,posted,Bookstore Purchase,-6.62,e3ab1cb8-708a-4acb-8de0-cef4b83e7f1c,-10326.67,debit,cash-withdrawal,AU00000,2024-02-05T05:58:34Z
transaction,0206a1bc-bfdd-431b-8f4b-cc74f4ec5c4c,posted,Electricity Bill Payment,-3102.09,72c94270-1466-4347-b87f-4374960411d5,7336.05,debit,bank-fee,AU00000,2023-07-21T02:16:07Z
transaction,1b4ebb55-40ce-48bb-b39b-11b29a7c9624,posted,Music Streaming Subscription,-2574.65,2140aa21-d598-4ce4-a3d7-4167566f2351,4761.4,debit,payment,AU00000,2023-10-02T13:06:53Z
transaction,552e2d4b-d222-4e46-a1d6-780018ca73c7,posted,Travel Agency Booking,-3399.51,18e0514b-fe21-42bd-9653-feda33361c27,1361.89,debit,bank-fee,AU00000,2024-03-04T14:20:56Z
transaction,f6343e3a-5e55-4b04-9f16-6e0e63b60f68,posted,Travel Agency Booking,-3424.6,274fb8fb-fe3d-4dda-8273-3e0620d366c7,-2062.71,debit,cash-withdrawal,AU00000,2024-01-08T22:11:29Z
transaction,0b9d10dc-c9b9-4b06-88b7-1cbc592d20ee,posted,TFR Acc14000 TO 12389,-2511.46,90ddcef5-7dbb-4ce9-b3f0-8f181f83d23d,-4574.17,debit,bank-fee,AU00000,2024-04-05T00:11:42Z
transaction,1776b17f-35b2-4fc0-b8c2-625d88c09379,posted,CTRLINK CARERS Ref: 998R6789201610974V,-4560.38,ef3ad094-5c44-4fb2-9278-19a3696a3ddf,-9134.55,debit,bank-fee,AU00000,2023-07-17T07:24:48Z
transaction,389ce3b9-0a23-4994-abae-eb85e789a3d3,posted,Home Improvement Store Purchase,-1135.96,89117b53-1819-4b50-b8cc-663885a7951c,-10270.51,debit,bank-fee,AU00000,2023-12-24T00:26:23Z
transaction,35dff0cd-79b7-492c-aa1b-0dfa36a66f20,posted,Uber Ride,-3333.49,96b59c1c-c549-4d19-8e00-830f0a8a7a97,-13604.0,debit,cash-withdrawal,AU00000,2023-09-02T02:55:23Z
transaction,c6705583-7071-4973-aa9f-2883aab46be0,posted,Gym Membership Fee,-4215.06,9649adc4-167a-46d9-88e0-7b18840cee6b,-17819.06,debit,cash-withdrawal,AU00000,2023-10-30T02:33:57Z
transaction,9bc3eace-2520-46c0-a5ea-3d1936518b4e,posted,Hair Salon Appointment,-2012.61,3a0d47f3-5170-4158-bce1-7291303f0717,-19831.67,debit,payment,AU00000,2023-09-05T14:11:26Z
transaction,cd1203cd-4873-4276-8183-3d47c69a0a79,posted,Home Improvement Store Purchase,-2381.7,2dbdc313-c84c-4574-9671-be36263b86da,16555.43,debit,payment,AU00000,2023-11-17T08:44:32Z
transaction,bc13ef52-2519-4573-98f7-7d48fd23fad0,posted,Amazon Online Shopping,-3325.34,7ca09c29-aa73-417a-85ae-b9c499f57694,13230.09,debit,payment,AU00000,2023-06-25T16:56:21Z
transaction,acb79847-e6d5-4c65-8ca5-ea5a968d0052,posted,Clothing Store Purchase,-941.81,68692bfb-1fe3-47cf-9572-9726ae531fbf,12288.28,debit,payment,AU00000,2023-09-06T12:47:24Z
transaction,915b58ce-56cb-41d5-a1ba-6942a2c41013,posted,Bookstore Purchase,-1587.84,6a98b6e3-3ba2-469d-a885-4085caaa67ed,10700.44,debit,bank-fee,AU00000,2024-01-20T04:34:28Z
transaction,3d02a875-2014-4aaa-985e-993fb26df317,posted,Home Improvement Store Purchase,-1360.69,33536d53-0cdd-40f1-b9e5-3f8c6b4ea99e,9339.75,debit,payment,AU00000,2023-07-02T05:27:02Z
transaction,5e7df9a4-0215-4d96-8d3f-54fe66f63baf,posted,Clothing Store Purchase,-4973.77,3f41b73a-c464-4b00-9ffe-f71eb532ccfb,4365.98,debit,payment,AU00000,2023-08-19T05:35:10Z
transaction,519e8750-bf9c-4720-99ba-41acc79b711e,posted,Music Streaming Subscription,-2812.32,88e58331-eba5-4ff7-9f9c-27f32eb4d9e9,1553.66,debit,payment,AU00000,2023-07-27T11:17:54Z
transaction,8647727c-f734-4066-bb48-eb80faad36b3,posted,Travel Agency Booking,-732.45,0c6c18d3-1133-49f9-9b6f-024378c1cbbb,821.21,debit,cash-withdrawal,AU00000,2024-04-19T01:29:15Z
transaction,6aa87475-9631-4138-b11c-a1696c202868,posted,Car Maintenance Expense,-1780.46,1343e79d-86ab-4284-880d-087ba3e6f5ee,-959.25,debit,bank-fee,AU00000,2024-03-06T16:45:57Z
transaction,78859dfa-acbc-482c-9e04-e42243437112,posted,Coffee Shop Purchase,-4053.22,51832fea-601c-4188-a673-762f63293bf2,-5012.47,debit,bank-fee,AU00000,2024-05-05T00:42:35Z
transaction,1c2a4184-2a8f-4f64-bb48-134a25a677fc,posted,Gasoline Purchase,-1448.75,ffd7735e-99e3-4247-b388-cf0e58705898,8411.12,debit,cash-withdrawal,AU00000,2023-08-25T21:44:55Z
transaction,4a2b985f-b576-45fe-89f9-e7bc3813e72a,posted,Hair Salon Appointment,-750.85,88797ac9-947a-4d84-9cb7-ecabb4501b2e,7660.27,debit,payment,AU00000,2024-01-05T08:06:01Z
transaction,486438fd-6a17-4ccd-b240-d64a29308f2d,posted,Uber Ride,-4084.65,8de3fcb7-45fe-449c-89bb-de4cb1ad6bb9,3575.62,debit,bank-fee,AU00000,2024-01-19T21:17:03Z
transaction,3475b684-57f2-42a7-851b-0bf99f55a968,posted,Wdl ATM WESTPAC IGA BALGOWLAH BALGOWL AU,-3199.02,23e7d5b9-3518-4b52-bb9e-305e5bd46a85,376.6,debit,bank-fee,AU00000,2023-06-11T13:01:37Z
transaction,59101652-9469-4220-91c1-4fb970e5fa74,posted,Gym Membership Fee,-2878.67,a652e52a-c37c-411f-8bc5-f0ffb16c3919,-2502.07,debit,payment,AU00000,2024-01-15T02:46:41Z
transaction,a2f62834-09b4-4208-a474-b83485fa4be8,posted,Amazon Online Shopping,-1561.68,0eb163b9-390e-4ca6-898b-c18f69c8b81e,-4063.75,debit,cash-withdrawal,AU00000,2024-03-28T13:52:01Z
transaction,ec0939b4-ebf8-4d32-8c64-b54e33db26ca,posted,Travel Agency Booking,-1499.25,336e2796-1c57-42f2-b8b7-6d25081ba34d,-5563.0,debit,payment,AU00000,2023-09-22T19:49:11Z
transaction,f86c9afa-87c0-49a1-bf25-60f0efeae7c2,posted,TFR Acc14000 TO 12389,-1729.0,d85c3c94-02e6-4b1c-8ced-091899522bcf,-7292.0,debit,cash-withdrawal,AU00000,2024-04-22T02:46:27Z
transaction,cd47e65f-f73d-4a97-850e-01aa0cdbaef5,posted,Bookstore Purchase,-1616.66,8c9328fc-2053-4a3e-91c4-38408f7819c1,-8908.66,debit,cash-withdrawal,AU00000,2023-11-27T10:21:30Z
transaction,faa9da5b-2371-4a8d-bc5f-64bcf454f96c,posted,Movie Ticket Purchase,-3880.42,9edbb571-ef3a-40e5-9f70-606aec25b958,-12789.08,debit,cash-withdrawal,AU00000,2023-08-25T18:03:37Z
transaction,e65a2d98-8578-4cac-9d72-7a6db9d71f84,posted,TFR Acc14000 TO 12389,-3528.12,9ff246f4-0c41-4402-9f7a-e31691bdc0e9,16110.12,debit,bank-fee,AU00000,2024-05-09T06:01:13Z
transaction,3ea4e345-6cf6-4d00-8e04-7ed9d1cc17d6,posted,Netflix Subscription,-196.65,aefef72a-e137-4a76-93fd-aab465bdeb85,15913.47,debit,bank-fee,AU00000,2024-04-23T15:12:46Z
transaction,c9f4722f-8ee0-4ec3-a509-ab31d5f60ba5,posted,Clothing Store Purchase,-178.42,0c19a805-7ad6-4c26-8e37-7d9a37e3b77b,15735.05,debit,cash-withdrawal,AU00000,2023-09-05T08:30:45Z
transaction,fc1b6011-ed6c-498f-8662-8bb3c7a83abb,posted,TFR Acc14000 TO 12389,-3078.21,541f6fef-6248-42a6-a9f7-20e9388bf6fc,12656.84,debit,bank-fee,AU00000,2023-06-19T22:53:43Z
transaction,b22bb0de-07bc-4464-b39d-e6ec787e446b,posted,Coffee Shop Purchase,-746.89,88a6a57f-e4c1-494a-8bd3-6b9b1327b8a5,11909.95,debit,payment,AU00000,2023-06-06T00:07:23Z
transaction,a5ae11bb-57c8-402a-b8b8-57317affee49,posted,Amazon Online Shopping,-3572.42,66542513-093c-4913-ac8d-217c884f8ec2,8337.53,debit,bank-fee,AU00000,2023-11-02T08:08:22Z
transaction,37ca85dc-c806-4bd4-b7f8-49ddab936cb3,posted,Wdl ATM WESTPAC IGA BALGOWLAH BALGOWL AU,-4634.57,51e301d9-06a4-41d5-812b-27339b718756,3702.96,debit,payment,AU00000,2024-01-02T00:05:39Z
transaction,0678b9f7-12f6-4cc8-81db-29ff9ce9d176,posted,Bookstore Purchase,-4054.98,749e94c1-755d-472b-9d9f-c9bfbac330de,-352.02,debit,cash-withdrawal,AU00000,2024-02-08T22:11:22Z
transaction,1e2b17ef-f5a2-4438-af2a-8f89c8baef79,posted,Clothing Store Purchase,-226.47,521caa18-1e64-43c3-994a-8e23bcddb52d,-578.49,debit,bank-fee,AU00000,2024-03-19T14:42:28Z
transaction,67876636-5540-4f7f-8260-1e45e8085ba6,posted,Bookstore Purchase,-3470.38,ac9a9237-7e3d-486c-b076-481bdabc3f03,-4048.87,debit,cash-withdrawal,AU00000,2024-05-08T00:03:50Z
transaction,6dccacc6-d8de-4974-bba0-704e2432286c,posted,Public Transport Fare,-1560.42,09b10336-24c4-49a0-a4c6-d96be2854eb4,13113.08,debit,bank-fee,AU00000,2023-11-11T07:43:30Z
transaction,15acbeb9-f1b0-4f19-8fa5-0486c2e53fae,posted,Gasoline Purchase,-4585.95,7fac6ff2-3c13-4aa1-bc88-3d51e92af65b,8527.13,debit,cash-withdrawal,AU00000,2023-08-07T15:39:46Z
transaction,62cde836-826e-420e-9c74-165f237abe45,posted,Manly Maths Tutor Wages,-4295.65,b342a9bc-1cd7-40ba-ba33-5b4823b2803b,4231.48,debit,bank-fee,AU00000,2023-12-09T03:44:12Z
transaction,728725bf-be65-4f75-a897-500728f8f084,posted,Clothing Store Purchase,-4942.3,d7289ccb-0bc9-4a16-858a-6d7333c89781,-710.82,debit,bank-fee,AU00000,2023-09-23T06:47:38Z
transaction,e5722930-f8c5-4590-ab3d-d718d3f0af5e,posted,Amazon Online Shopping,-2917.03,9780e48b-7988-406e-a6a4-2adb123e0d56,-3627.85,debit,cash-withdrawal,AU00000,2023-10-30T22:27:09Z
transaction,2a247223-2270-4273-931f-e6b07b812b7d,posted,Hair Salon Appointment,-659.26,04a08e33-a813-4848-8e1a-1f32889a5e88,-4287.11,debit,payment,AU00000,2024-02-17T07:57:51Z
transaction,c1e96a27-59b3-4c9a-8548-ec0deabe5f45,posted,AGL RETAIL ENERGY LTD (GAS),-2042.93,7ec9682f-4d1d-4fab-8d5f-fbe2717e2d10,-6330.04,debit,bank-fee,AU00000,2023-05-14T23:34:44Z
transaction,16cb487e-90a3-466a-9623-c11c3dfad4a5,posted,Payroll WFRMS 15439393,10571.43,a7d6f62e-9e6c-46db-af12-a15f69fffe3d,4241.39,credit,transfer,AU00000,2024-02-24T03:41:35Z
transaction,dadbb144-5684-4942-977c-e0beee224351,posted,Movie Ticket Purchase,-11.48,0576e372-b400-4633-8fdf-9c05f52d957e,4229.91,debit,payment,AU00000,2023-06-22T18:21:15Z
transaction,d5005555-aa21-4e09-aa8f-60f6a846391d,posted,Coffee Shop Purchase,-2051.7,3599592e-45d9-4df8-a225-ff3230036f47,2178.21,debit,bank-fee,AU00000,2023-07-14T06:50:57Z
transaction,eeb99cff-6b2c-445d-aece-3e8e69d1fcc2,posted,Bookstore Purchase,-2399.51,5a25ff44-5b5b-4f4f-ad7f-3ff0d223d3e8,4079.29,debit,cash-withdrawal,AU00000,2024-01-27T14:13:03Z
transaction,01234b09-ab44-4dc2-a1c3-bc808748feac,posted,Manly Maths Tutor Wages,-4911.58,0ab2cde5-d79c-42bf-941f-5d044c45d253,-832.29,debit,cash-withdrawal,AU00000,2024-03-21T14:15:14Z
transaction,2309f9f7-f76d-4922-b842-882602b17f90,posted,Hair Salon Appointment,-1243.69,5d7cbe65-c703-4c59-8bdc-4a07dd16b61d,-2075.98,debit,bank-fee,AU00000,2024-04-29T15:11:48Z
transaction,f2b00c23-8019-49a2-b975-c7cea944fc46,posted,Gym Membership Fee,-4764.03,35ec81a2-f520-4ab7-b440-09d5174b1970,-6840.01,debit,bank-fee,AU00000,2023-11-29T05:58:36Z
transaction,d582b3f9-3060-42d6-a5a8-74d97f7d5f70,posted,Gasoline Purchase,-1433.15,e177b74d-68e0-4414-9092-f30543174156,-8273.16,debit,cash-withdrawal,AU00000,2023-07-11T14:52:49Z
transaction,16035bc6-8127-4c2d-8a4d-cb66c4e29b35,posted,Gym Membership Fee,-4461.33,6605cdb9-73b7-4fa3-963d-f6044315ee8f,-12734.49,debit,cash-withdrawal,AU00000,2023-06-26T04:14:31Z
transaction,a491e01b-a77b-4d98-b350-217468add432,posted,CTRLINK CARERS Ref: 998R6789201610974V,-2779.04,8a87f880-65ac-4dc7-8745-7cd96adcfd02,-15513.53,debit,bank-fee,AU00000,2023-12-01T15:15:17Z
transaction,62e41800-dc85-4fe4-8a63-586ed5bc0810,posted,Netflix Subscription,-4305.79,dc61a33e-1a3e-4c2b-a3d9-2984a75ceb36,-19819.32,debit,payment,AU00000,2024-02-04T06:12:23Z
transaction,0f5f3fca-f140-4149-b71f-baf76384ceee,posted,Manly Maths Tutor Wages,-4898.96,1dcce5e8-89a4-42ee-81f1-d2b21c09e79d,-24718.28,debit,bank-fee,AU00000,2023-07-08T02:34:25Z
transaction,f06890c8-1d2d-4f32-bec8-4975ee6a14ec,posted,Online Gaming Purchase,-3545.92,5b4e81e5-d761-415c-a122-1dca4b47ba37,-28264.2,debit,payment,AU00000,2024-02-18T04:05:13Z
transaction,12f0ef5c-9a2f-48e0-af01-201910a87690,posted,Car Maintenance Expense,-576.51,6914d0e6-73bf-498e-8908-c742361b0493,11912.41,debit,cash-withdrawal,AU00000,2023-09-01T06:19:44Z
transaction,6782aa1d-3667-44b3-948d-f045acd91996,posted,AGL RETAIL ENERGY LTD (GAS),-2886.68,b7488589-458f-417d-8cdb-73dfae2ce617,9025.73,debit,payment,AU00000,2023-11-10T09:43:24Z
transaction,062e9dc2-bd5c-4335-95a8-dcd1d26e7a5e,posted,AGL RETAIL ENERGY LTD (GAS),-2765.97,39765321-9f24-40b2-b3ee-e9aba06a2382,6259.76,debit,cash-withdrawal,AU00000,2024-02-01T11:37:13Z
transaction,30ce0d4f-5769-4bb5-b22b-d3ede40d3e23,posted,Coffee Shop Purchase,-2084.98,97652965-a6f9-46c9-a754-26a1aeec6749,4174.78,debit,bank-fee,AU00000,2024-04-13T07:13:10Z
transaction,3386a3f7-37a7-4d15-95eb-23f13d17249e,posted,Restaurant Dinner,-1827.02,e54c0b12-09ac-4a2c-8f72-db95aa5b1c42,2347.76,debit,payment,AU00000,2024-03-30T09:57:19Z
transaction,de4a3df5-e4d0-4a8c-972a-63b53a905923,posted,CTRLINK CARERS Ref: 998R6789201610974V,-4174.85,acde9f0d-01f2-401e-b27f-949a143bced8,-1827.09,debit,payment,AU00000,2024-02-22T13:27:20Z
transaction,50d74e99-1cd6-47bf-9811-fc25bbe8cdc1,posted,Coffee Shop Purchase,-2476.28,f9b78373-2e46-4ab2-8564-304b69143163,-4303.37,debit,payment,AU00000,2023-07-31T23:48:35Z
transaction,92bfa8ff-a94c-4b81-b784-2626303ee6b8,posted,Public Transport Fare,-3296.64,2a6de3a4-dbc9-420f-8e71-6291121bb87a,-7600.01,debit,cash-withdrawal,AU00000,2023-11-12T05:18:21Z
transaction,999f2a88-b610-42c3-9b71-c0c1d8963fca,posted,Hair Salon Appointment,-2679.19,bbe2610c-fd38-4875-b28d-0b75fd02ea92,-10279.2,debit,bank-fee,AU00000,2023-05-28T13:33:26Z
transaction,031f3dd2-a13d-4f2c-b1f5-56d78071c66f,posted,Electricity Bill Payment,-3521.79,5381cc27-3081-471a-8123-12428c075526,-13800.99,debit,cash-withdrawal,AU00000,2024-04-08T04:59:14Z
transaction,3d8510e8-bf3a-43fc-bfe3-32d5edfc6f23,posted,TFR Acc14000 TO 12389,-394.17,3231a193-226a-4098-ab25-d1d0f163f9ff,16052.26,debit,payment,AU00000,2023-05-20T20:46:47Z
transaction,9b6b849c-d9cb-4095-bbdf-dc395f64d43d,posted,Mobile Phone Bill Payment,-705.56,3bc415ff-0583-4e44-9a85-8fcc3f436fe6,15346.7,debit,cash-withdrawal,AU00000,2023-06-09T11:05:46Z
transaction,b84a7988-c0d4-4467-8ddc-0563aa350963,posted,Amazon Online Shopping,-3682.73,b0f1a8c5-67e0-4280-9362-47cd4904e8f0,11663.97,debit,cash-withdrawal,AU00000,2024-03-30T17:17:32Z
transaction,92847a0b-3198-4fa0-91b0-b062c9ee986e,posted,Wdl ATM WESTPAC IGA BALGOWLAH BALGOWL AU,-2551.9,0b4292c1-293a-4fc9-adba-c7bf1bddf17f,9112.07,debit,payment,AU00000,2023-11-23T20:36:21Z
transaction,f2f65781-1909-44d4-81d7-b04a607301bf,posted,Gasoline Purchase,-2348.84,490a3616-a27c-4b46-b312-43c766c6fc30,6763.23,debit,bank-fee,AU00000,2023-12-08T04:52:21Z
transaction,c691f43a-57a3-4bdf-88c2-c725d17f17ef,posted,Coffee Shop Purchase,-201.38,b40761d7-5331-421b-a07b-01948ad3741a,6561.85,debit,bank-fee,AU00000,2023-09-15T22:14:43Z
transaction,6a11ce0d-317c-4947-b354-db1dcbc27529,posted,Restaurant Dinner,-3771.13,778ff462-c61a-43de-a225-80729117d60a,2790.72,debit,bank-fee,AU00000,2023-05-12T02:30:18Z
transaction,2a9c5d39-692b-447a-9678-a59aa84fdb54,posted,Bookstore Purchase,-146.66,2a599d18-d591-448c-84d6-079c08254661,2644.06,debit,bank-fee,AU00000,2023-09-18T17:15:13Z
transaction,483944e3-6ff5-4e6c-8e08-c9706555dd9a,posted,Clothing Store Purchase,-1490.33,08a7c482-3458-4681-8f91-0021669fc39b,1153.73,debit,bank-fee,AU00000,2023-05-19T18:04:09Z
transaction,d0a0750d-e9da-4a58-92a5-5aea319a3dda,posted,Wdl ATM WESTPAC IGA BALGOWLAH BALGOWL AU,-313.72,92b58105-f795-4a5a-af9a-9e213518532e,840.01,debit,bank-fee,AU00000,2023-06-30T00:44:55Z
transaction,2cd353ce-7ab9-4d2f-b0c2-be03333f3566,posted,Gasoline Purchase,-4913.75,168c886a-4cdb-4ca1-945b-b6f806bf0be3,11874.61,debit,bank-fee,AU00000,2023-10-02T10:16:54Z
transaction,2b3245ec-bab6-4e33-8b48-ad0858f82896,posted,Coffee Shop Purchase,-2163.58,9a4f8a6e-68b0-4f41-ad95-533381bf5e7f,9711.03,debit,payment,AU00000,2023-11-01T08:52:32Z
transaction,e2a4d893-e1d7-4671-ae19-5723faeb82dc,posted,Coffee Shop Purchase,-4036.54,d4d5f5d5-67c0-41af-b3d6-3d7550f12d0e,5674.49,debit,bank-fee,AU00000,2023-10-13T09:30:45Z
transaction,7ebcc626-0d02-4a17-b3fc-bb13a0d874b9,posted,Gasoline Purchase,-4182.44,120bc851-16f8-463b-bf8c-ba90b1fdfcca,1492.05,debit,payment,AU00000,2023-08-05T19:55:06Z
transaction,10d6df9e-a4fc-479e-b407-f233f932dfff,posted,Manly Maths Tutor Wages,-4098.8,3ddfe1fc-98a5-4149-b329-cab8c96cc6cf,-2606.75,debit,cash-withdrawal,AU00000,2024-01-31T18:51:26Z
transaction,a87c3bc3-be60-46a3-a64b-8be9a7e28608,posted,Online Gaming Purchase,-659.06,b28497fb-a94d-4872-9d4a-65d01b2e3fe8,-3265.81,debit,bank-fee,AU00000,2024-02-14T14:32:09Z
transaction,760c1417-2e0e-461a-bb63-aa333d9ab8f2,posted,Gym Membership Fee,-1665.16,d17a6254-90d8-4e82-9df9-18b21569d4ee,-4930.97,debit,cash-withdrawal,AU00000,2023-08-12T10:40:25Z
transaction,ea500b93-4078-4f4a-aef9-56dfb6758582,posted,TFR Acc14000 TO 12389,-188.85,2b8724f9-7796-4307-8dc1-77cbcca0431b,-5119.82,debit,payment,AU00000,2023-07-08T22:51:12Z
transaction,8a883d19-ae19-46f3-bc68-259787c40592,posted,Netflix Subscription,-1613.81,8da81c96-2587-43f7-835d-722676b127b0,-6733.63,debit,cash-withdrawal,AU00000,2023-10-28T11:11:41Z
transaction,aa9c4632-caee-4697-9b8a-9c760d56cd19,posted,Coffee Shop Purchase,-1574.74,9b566882-258f-47bf-a3d5-898c4fc06535,-8308.37,debit,payment,AU00000,2024-04-29T06:06:34Z
transaction,b49abb5b-06e5-415d-a25c-4a25bd7b4855,posted,Wdl ATM WESTPAC IGA BALGOWLAH BALGOWL AU,-580.13,0301ab71-9a0b-460e-8a7a-684b44f63637,18070.59,debit,cash-withdrawal,AU00000,2023-08-11T15:24:14Z
transaction,a04d47a1-894e-4803-9f85-1523c724b205,posted,Manly Maths Tutor Wages,-1722.07,c5938f53-53a3-4c1d-9e67-e9a1c3f5674b,16348.52,debit,bank-fee,AU00000,2024-01-27T19:23:23Z
transaction,5a2532c6-122f-49fc-bfb1-0c75ebf80b5b,posted,Coffee Shop Purchase,-1355.94,8e7c5008-dd83-4c51-96dd-8f39869f8c9f,14992.58,debit,bank-fee,AU00000,2023-05-26T04:43:07Z
transaction,13a317d9-debd-43a0-a2d8-d60ecd96e33f,posted,Hair Salon Appointment,-3350.15,12138fb3-ffb8-48fa-b548-439078fd7f69,11642.43,debit,payment,AU00000,2023-11-21T17:56:23Z
transaction,fb6299c4-df7b-40bd-9051-c15b0b9e5394,posted,Gasoline Purchase,-3997.07,93c28c50-7c7a-412d-8d70-57fef71c4e25,7645.36,debit,bank-fee,AU00000,2023-05-20T22:39:44Z
transaction,b00412b9-6dfb-4af5-91ff-821688dc1226,posted,TRANSFER TO JOANNA SMITH CAMPING,-291.98,bc67124d-225e-4c61-9f18-886f1c144f25,7353.38,debit,bank-fee,AU00000,2023-06-20T08:45:39Z
transaction,6e2cfc1d-2aee-4920-9f07-b22cc41d7fe7,posted,Wdl ATM WESTPAC IGA BALGOWLAH BALGOWL AU,-834.26,1f016706-3457-4c3d-8975-905d0e7288f6,6519.12,debit,cash-withdrawal,AU00000,2023-08-08T16:27:19Z
transaction,d49823d5-8c7c-4b05-abb9-ffb3c82299e4,posted,Amazon Online Shopping,-1131.25,1e8d7dfc-2eb2-4a36-a9f0-60a7279797ac,5387.87,debit,cash-withdrawal,AU00000,2023-06-19T23:01:18Z
transaction,1ed323cb-659a-4cdf-8119-6ee364f5f2b8,posted,Transfer Platnm Homeloan 346454,-928.35,d137d71a-28c3-4cc7-9df9-abb6710bdf4d,4459.52,debit,bank-fee,AU00000,2024-02-08T12:14:51Z
transaction,4931f695-8a62-40c3-9b21-b676fea090e9,posted,Transfer Platnm Homeloan 346454,-1873.47,696344f4-8724-4353-9740-b67d4745de17,2586.05,debit,cash-withdrawal,AU00000,2024-04-19T10:06:18Z
transaction,3db4a2d6-c0e7-449a-88f5-0761a8327571,posted,Payroll WFRMS 15439393,10088.04,b5315b72-8cc0-4422-8d33-8feba00b1758,27230.43,credit,transfer,AU00000,2023-11-14T23:48:27Z
transaction,cd9f7f91-6834-4765-9072-a4acd68ee680,posted,Music Streaming Subscription,-1922.56,bcacaa67-ef51-4a8b-87cc-fca0fd1f8010,25307.87,debit,payment,AU00000,2023-09-15T05:52:28Z
transaction,abfe0218-c16e-4e90-b7e9-604d772514ee,posted,Bookstore Purchase,-3091.22,57f720eb-94f0-4461-aa35-6e9e6228e6e7,22216.65,debit,bank-fee,AU00000,2023-11-14T13:33:10Z
transaction,1b5f8160-ac5c-4a1f-91fd-15813134af2f,posted,Netflix Subscription,-374.56,1ce96866-323d-4e0a-bd53-b074dd04d4dc,21842.09,debit,cash-withdrawal,AU00000,2023-06-18T04:26:27Z
transaction,d044750b-7aa8-4e34-a8c1-46e64f61f251,posted,Movie Ticket Purchase,-4116.99,a9cbe400-45fb-42dd-b89f-5dfad27e6abe,17725.1,debit,bank-fee,AU00000,2024-04-04T06:55:00Z
transaction,31176321-99ea-46a9-8728-111b157e74de,posted,Home Improvement Store Purchase,-1793.56,f8a77a23-fc3e-4adf-a13e-9f022509dacb,15931.54,debit,cash-withdrawal,AU00000,2023-07-03T12:39:43Z
transaction,14711493-5bcf-4a38-8e89-7404771925a1,posted,Amazon Online Shopping,-1716.99,d48e8b10-cb0a-4ca5-ae42-4dafd9f1b622,14214.55,debit,payment,AU00000,2024-03-11T23:25:08Z
transaction,b6ae9eb6-b8d9-423c-9620-ab1b5836888c,posted,TFR Acc14000 TO 12389,-446.3,2e1d701e-1422-411a-bcf5-9d56064dd0af,13768.25,debit,cash-withdrawal,AU00000,2024-04-15T08:18:08Z
transaction,c1e2700f-cee0-40bd-9adc-d570e7fc220a,posted,Gym Membership Fee,-4121.75,99cdc29c-fda6-4b00-8ab6-e9c8730dff7b,9646.5,debit,cash-withdrawal,AU00000,2023-12-13T09:39:43Z
transaction,c0e38440-aca1-4cdf-8e75-6503c94441a0,posted,Clothing Store Purchase,-2051.97,75ba03db-37aa-4bd8-803e-eb40d4ac1502,7594.53,debit,payment,AU00000,2024-05-08T14:57:17Z
transaction,ac77b30a-59af-4fc7-8cbc-bb4762966ce8,posted,Public Transport Fare,-1777.6,48436a91-57c7-4882-9772-e7d34e134bde,3908.64,debit,bank-fee,AU00000,2023-06-16T20:39:35Z
transaction,2f56ec8f-b619-4e69-b57d-630a6098de40,posted,Clothing Store Purchase,-1067.55,a2fa5875-0eb6-4d91-8323-d042780a4257,2841.09,debit,cash-withdrawal,AU00000,2024-02-11T17:59:18Z
transaction,40c779c1-438d-4ee8-b9e7-78bc2f670ca5,posted,Wdl ATM WESTPAC IGA BALGOWLAH BALGOWL AU,-4314.29,f89d6d7a-19d8-4569-affb-33ba98a700aa,-1473.2,debit,payment,AU00000,2023-10-19T12:46:31Z
transaction,f896792f-7963-401d-832a-083ec15d2a88,posted,Music Streaming Subscription,-1765.43,2c414bbd-ec79-47f0-b0c6-157a37f85c28,-3238.63,debit,cash-withdrawal,AU00000,2023-11-16T19:46:52Z
transaction,bfc75844-75b0-4dcc-aad5-01d3d7c23476,posted,Pharmacy Purchase,-1983.03,2560d606-aec3-48a6-a883-d3fbd3c637f5,-5221.66,debit,payment,AU00000,2023-12-05T12:34:44Z
transaction,bfbb5246-fe63-4567-9c14-ed3ddea95df0,posted,Amazon Online Shopping,-2478.38,467bd263-e5fc-4e5e-8751-364e9adbdd1d,-7700.04,debit,bank-fee,AU00000,2023-06-24T12:15:49Z
transaction,7cf34395-ffbf-42d4-9a64-ff4c7bfb960e,posted,Uber Ride,-2351.42,554c68b8-5a50-4898-a5ce-dca13c168d72,-10051.46,debit,cash-withdrawal,AU00000,2023-09-17T05:36:51Z
transaction,fea14596-9955-44f7-bbef-24d99984323d,posted,Non Hooli ATM Withdrawal Fee,-3187.35,81b04ec1-dc3b-4015-9a49-c74997e30ebe,-13238.81,debit,cash-withdrawal,AU00000,2024-03-21T05:00:42Z
transaction,6b5461b6-fd77-4f25-9fcf-2f8d85689d62,posted,TRANSFER TO JOANNA SMITH CAMPING,-4008.74,7d4190d6-b0db-4b1e-abc8-9338caf8f6fd,-17247.55,debit,bank-fee,AU00000,2023-12-20T12:08:02Z
transaction,aa2613c7-a442-4f9e-9c73-b3ae9c097b66,posted,Public Transport Fare,-3693.19,5cd8249b-3f83-4108-9aa0-79c7944e1dee,-20940.74,debit,payment,AU00000,2023-10-22T01:36:51Z
transaction,76787552-1bf6-483f-9ace-dc184fc74dc1,posted,Online Gaming Purchase,-1578.48,4621ba32-a65a-4619-8d86-a6313419c865,9295.13,debit,payment,AU00000,2023-10-14T05:13:11Z
transaction,ad1a709e-be30-41aa-b706-4ffc3b864e64,posted,Non Hooli ATM Withdrawal Fee,-949.18,76607b9c-97dd-498b-b0e8-596b1b0e1e22,8345.95,debit,payment,AU00000,2023-11-01T05:46:01Z
transaction,90370cf6-caf7-45c8-86e3-1609a3372c2c,posted,CTRLINK CARERS Ref: 998R6789201610974V,-4474.56,aa8c3853-bd36-46fa-b43d-a12083a1d400,3871.39,debit,payment,AU00000,2024-03-08T05:37:06Z
transaction,d9840faa-d00b-4bb3-92d2-c15b01a68fb3,posted,Clothing Store Purchase,-415.99,65eb839f-715f-4d1c-95b9-06f40f8a1a7e,3455.4,debit,payment,AU00000,2023-10-03T08:24:28Z
transaction,601d0192-2e82-4e41-b49d-29d4c2a7f499,posted,Mobile Phone Bill Payment,-470.75,56bbd608-afa1-47f9-a4c7-e28bcc2c20ab,2984.65,debit,payment,AU00000,2023-06-24T15:01:57Z
transaction,40384fbc-a08d-45cb-8522-bee57d9acc18,posted,TRANSFER TO JOANNA SMITH CAMPING,-1460.75,7d1d8826-d128-4e0a-bac6-0b16682f63f7,1523.9,debit,payment,AU00000,2024-05-10T03:16:47Z
transaction,2bc5dd0b-cd11-4552-a1ad-fa681f281a73,posted,Travel Agency Booking,-1017.55,8a8ad843-2f40-4d27-a424-84c9858153d0,506.35,debit,payment,AU00000,2023-05-24T17:24:27Z
transaction,b8423863-c4da-4016-8d33-c04ba79f5876,posted,Amazon Online Shopping,-407.23,f39edf4e-d00e-491c-9460-55a65e5253f4,99.12,debit,cash-withdrawal,AU00000,2024-04-15T00:07:57Z
transaction,7ca7450f-fcc2-4acd-ae70-6573fe0f557f,posted,Gym Membership Fee,-187.1,87a2ec65-f6aa-4e21-92e6-50a89c72d95c,-87.98,debit,bank-fee,AU00000,2023-10-29T17:30:44Z
transaction,343c93ef-f148-41ec-b06f-e8a3363d529b,posted,Wdl ATM WESTPAC IGA BALGOWLAH BALGOWL AU,-2966.92,b1e8a443-8456-41df-a9bd-a6474c844a13,-3054.9,debit,bank-fee,AU00000,2023-09-20T23:58:40Z
transaction,6757b5e2-f077-424a-bc25-c37e09014869,posted,Amazon Online Shopping,-214.62,1d9763c8-1b8c-4328-92ff-173d71acf604,5308.5,debit,bank-fee,AU00000,2023-10-08T07:24:46Z
transaction,e9965866-62c5-4d5c-9c19-c43339846eab,posted,Music Streaming Subscription,-3041.82,be260154-18a8-4e4a-954f-bccd8230f511,2266.68,debit,bank-fee,AU00000,2024-01-29T11:09:28Z
transaction,7ddb7506-9e82-4caa-a3e6-96a44f533c0a,posted,Netflix Subscription,-352.93,da61abd0-d62e-48db-8911-8b1359f5f0b1,1913.75,debit,payment,AU00000,2024-03-10T12:52:32Z
transaction,af7e8d92-43ca-4c6f-b74e-4155a8eb3a8f,posted,Movie Ticket Purchase,-641.09,4b7ba38b-4cbe-465e-8b3a-cd524da7b8a0,1272.66,debit,cash-withdrawal,AU00000,2024-04-13T15:42:24Z
transaction,f3d116a1-5e5e-43e6-8d51-3e4095e66c99,posted,Mobile Phone Bill Payment,-585.84,50caf6a6-39ef-4b62-b7d7-07bb96b57217,686.82,debit,bank-fee,AU00000,2023-09-10T21:51:55Z
transaction,f16a71f9-5298-4fdf-8014-26482f49fd5c,posted,Car Maintenance Expense,-2201.4,33f00d64-f36e-48d9-9484-493b1f112486,-1514.58,debit,cash-withdrawal,AU00000,2023-09-05T09:48:02Z
transaction,524f9355-eea2-4fc2-94c6-4d1228bf9964,posted,Clothing Store Purchase,-659.69,8b062e09-199a-45d1-8396-7d9623ee337e,-2174.27,debit,payment,AU00000,2024-02-15T01:33:15Z
transaction,a39f860f-ac36-47e7-bdec-377950bfabb0,posted,Travel Agency Booking,-574.47,db0462ec-a9e3-4519-89e1-06430b8ec66d,-2748.74,debit,payment,AU00000,2024-02-11T11:56:31Z
transaction,d90d7ea7-565a-4774-9140-f7bad5f3bfbb,posted,Bookstore Purchase,-914.75,42d3f951-bcd9-4d96-87ca-0c097cecea06,-3663.49,debit,cash-withdrawal,AU00000,2024-01-12T06:16:00Z
transaction,66b6e584-de81-4169-bad4-2526ab14e003,posted,Mobile Phone Bill Payment,-3849.66,1bc5676e-8641-493f-9d4d-fdc363684a57,-7513.15,debit,cash-withdrawal,AU00000,2023-12-24T10:25:49Z
transaction,ba36811f-0340-419d-bed6-61617fb66c2f,posted,Manly Maths Tutor Wages,-1964.04,45eecc0b-9b20-458e-a733-ad7c9897bb76,6538.81,debit,payment,AU00000,2023-08-02T15:44:34Z
transaction,c4153f54-47a8-436e-aad8-bd1159dd6056,posted,AGL RETAIL ENERGY LTD (GAS),-1691.13,b2c361e4-5cf0-4540-ab17-eb5aede68a9c,4847.68,debit,payment,AU00000,2024-01-05T22:59:27Z
transaction,a77ae58d-e7cc-4be2-9641-9ece557503dc,posted,Mobile Phone Bill Payment,-874.95,068e9d4f-2621-4ad7-94a2-9d35e7e0926c,3972.73,debit,cash-withdrawal,AU00000,2023-10-31T14:53:55Z
transaction,d1eed5d7-851e-4258-baac-2ae013f8d212,posted,Hair Salon Appointment,-3025.78,07fe18d4-c368-444d-b06b-ccae25fd17a4,946.95,debit,bank-fee,AU00000,2023-08-07T04:49:33Z
transaction,6a8049cf-584d-4d1b-9223-18e36edbe2d1,posted,Home Improvement Store Purchase,-3798.45,296b9673-1547-4d98-8e48-4655ee650964,-2851.5,debit,cash-withdrawal,AU00000,2024-04-14T23:43:59Z
transaction,4307631d-8dd2-4709-a1a5-5f697a6dcb1b,posted,TFR Acc14000 TO 12389,-919.77,1c2e4bd5-8c5f-4869-b10b-8b77ecb42a76,-3771.27,debit,bank-fee,AU00000,2023-06-30T09:52:52Z
transaction,d5f2fd5e-6983-40b0-8e48-b471ba19891c,posted,Transfer Platnm Homeloan 346454,-2565.39,b89bc268-7d0e-4d2f-9898-153f18b63531,-6336.66,debit,payment,AU00000,2024-04-24T08:38:41Z
transaction,6d0b638f-7b3d-4250-9e74-2d2ab3dfd5fe,posted,Clothing Store Purchase,-2373.7,a7be3779-1cec-4b10-afe8-0a06ce3623cd,-8710.36,debit,cash-withdrawal,AU00000,2024-05-09T23:51:13Z
transaction,a82ff66e-a81b-4e23-91ae-555803ed94d1,posted,Pharmacy Purchase,-1133.79,8da4044b-c551-4579-9c24-d1bf4a2df2db,-9844.15,debit,bank-fee,AU00000,2023-10-30T00:54:44Z
transaction,1cc6390a-7cc2-4b2a-b801-6de891c5a988,posted,CTRLINK CARERS Ref: 998R6789201610974V,-4905.02,3acff857-3d26-4da3-b603-679941fdc24c,-14749.17,debit,cash-withdrawal,AU00000,2023-11-01T18:48:24Z
transaction,64883141-f233-4483-b73f-595660c3e8df,posted,Payroll WFRMS 15439393,10767.74,3e8b99df-c24e-48f2-8722-622abbc8f394,30000.12,credit,transfer,AU00000,2023-10-24T17:49:33Z
transaction,ba06145e-9141-4388-8e0e-2c0606818c61,posted,Travel Agency Booking,-1528.85,b05126ef-9d94-44d7-8b12-448dd34e786a,28471.27,debit,bank-fee,AU00000,2023-12-12T11:34:23Z
transaction,2c8c4b44-f701-4bd5-a96a-22a55d3fa5fd,posted,Non Hooli ATM Withdrawal Fee,-1341.62,d1393d7b-60b2-4dc7-87fa-1e434632e94c,27129.65,debit,bank-fee,AU00000,2023-10-02T09:38:19Z
transaction,dfe6c999-69f0-4645-80c5-5072aaae9615,posted,Music Streaming Subscription,-2085.72,c3da69e1-31f3-4ee8-ba27-4c9f7adcaae6,25043.93,debit,payment,AU00000,2024-05-08T10:49:03Z
transaction,8460dea4-cedf-4e5e-bf53-db416528b252,posted,Pharmacy Purchase,-2854.49,b5f47b27-1762-413e-b5f6-327ea96e26c9,22189.44,debit,bank-fee,AU00000,2024-01-29T17:28:33Z
transaction,fa0e5f38-a19c-499f-9bb7-b2b3388f7b70,posted,Uber Ride,-3925.31,5d1adb49-a29a-4c99-9f62-4e508a338d55,18264.13,debit,cash-withdrawal,AU00000,2023-05-24T07:17:50Z
transaction,b9cfcede-a023-491e-9ea6-3be138aa85fd,posted,Online Gaming Purchase,-215.04,19cd1581-80be-4181-b204-eb9e86bd9a2c,18049.09,debit,payment,AU00000,2023-05-14T08:58:03Z
transaction,a115e623-06cc-4699-ad79-08967fcabe1c,posted,Manly Maths Tutor Wages,-816.56,f83230ef-ac52-4a2c-84cc-4ce97d74e74a,17232.53,debit,bank-fee,AU00000,2024-03-08T23:04:36Z
transaction,5b348a3c-de6e-48b5-a927-2565beabe5c6,posted,Payroll WFRMS 15439393,11609.87,7150e35f-7ef1-49fe-a513-808c099f6c54,28842.4,credit,transfer,AU00000,2024-02-29T09:33:42Z
transaction,e25a8d39-2a55-4fae-906b-3342f42235c7,posted,Gasoline Purchase,-887.01,cd143807-3f2d-4dc5-bd3b-11814608df74,27955.39,debit,cash-withdrawal,AU00000,2024-02-20T22:54:55Z
transaction,c255f7ec-c8a5-4698-89c8-293c58dc5e44,posted,Wdl ATM WESTPAC IGA BALGOWLAH BALGOWL AU,-4502.41,5666c08f-2604-4d04-b037-2f5888f152fd,7547.12,debit,bank-fee,AU00000,2023-09-25T06:21:12Z
transaction,4fcd0338-4bc0-4a30-b785-0031b159e944,posted,Non Hooli ATM Withdrawal Fee,-4962.12,410c97d3-f986-47bb-a5d0-773f4d9554b8,2585.0,debit,bank-fee,AU00000,2023-12-26T06:09:21Z
transaction,13ddf843-aeac-4b81-8354-5c5feac11a7b,posted,Public Transport Fare,-1417.22,1895cbff-ef06-4e7c-aa8e-4d64143535df,1167.78,debit,cash-withdrawal,AU00000,2024-01-15T07:00:00Z
transaction,2a134fcc-4a9f-4e21-8643-f9992c919118,posted,Gym Membership Fee,-4724.87,9187dde9-daa3-417b-9157-6d0e50f3db0e,-3557.09,debit,cash-withdrawal,AU00000,2023-11-29T17:29:02Z
transaction,42054510-b349-4f77-8293-89dc69a5164d,posted,Payroll WFRMS 15439393,10214.22,86615ea8-f2ae-40ce-8600-bc81320beb99,6657.13,credit,transfer,AU00000,2023-06-25T09:30:58Z
transaction,0cd05d6c-cc78-4d7e-bd32-d864bca9f34f,posted,Hair Salon Appointment,-3296.96,f798281b-5b86-4a55-b3c3-a18cbb1cd42c,3360.17,debit,bank-fee,AU00000,2023-07-03T01:12:03Z
transaction,154dcd8b-989d-49ad-8258-7c64af27b918,posted,CTRLINK CARERS Ref: 998R6789201610974V,-3998.55,ccc727b6-6444-4e51-91d4-576ddfc8d85d,-638.38,debit,cash-withdrawal,AU00000,2023-07-13T03:16:57Z
transaction,67400daa-181a-45c3-a803-d19d1dff52f4,posted,Payroll WFRMS 15439393,11168.34,269999bc-599a-4f1e-9fca-d1ae8d4f457f,10529.96,credit,transfer,AU00000,2024-01-12T00:04:39Z
transaction,7f5ae124-5cd1-4e72-93eb-c542dff69e1d,posted,Uber Ride,-4070.9,bdb75fc6-8a5b-4169-ab74-8a775ae8c537,6459.06,debit,bank-fee,AU00000,2024-03-23T10:32:10Z
transaction,bf1cfde5-31f7-4608-9ead-ee918a937c2a,posted,Payroll WFRMS 15439393,11186.27,8721ab29-451a-49a8-8bc3-4fc115370e64,17645.33,credit,transfer,AU00000,2023-06-14T14:15:53Z
transaction,70dbf9d2-366e-40f4-b09f-f949e72335df,posted,Hair Salon Appointment,-1565.76,345a7abc-e284-4104-8ce4-e9a5c907e994,16215.35,debit,payment,AU00000,2023-09-02T12:47:12Z
transaction,42a6029f-bf36-4759-9ea2-3907aeaa8233,posted,Online Gaming Purchase,-2152.82,e871addf-dad5-4dad-ab6d-5a3e0c8461bb,14062.53,debit,bank-fee,AU00000,2024-02-15T09:28:28Z
transaction,f9ed705d-1bad-4925-8a72-cd3604c35152,posted,Gasoline Purchase,-3342.77,8c0f141a-b197-4281-94a7-0023b2ce8a75,10719.76,debit,bank-fee,AU00000,2023-07-15T03:27:17Z
transaction,fd594913-bd6c-4709-8bb3-f42331959ed9,posted,Non Hooli ATM Withdrawal Fee,-4753.76,67e736d7-97d3-48b9-bf4b-83c3705280f0,5966.0,debit,bank-fee,AU00000,2023-09-17T23:18:11Z
transaction,3b01947e-5e4e-4345-b579-d1c078609722,posted,Netflix Subscription,-630.86,4090820b-3bb1-4287-9d85-7696c4a2a8b6,5335.14,debit,bank-fee,AU00000,2024-03-25T02:00:50Z
transaction,731f23da-b459-4a91-9988-0d1955d8514b,posted,Payroll WFRMS 15439393,10759.93,c70cbd0a-0d72-4409-ab39-5580b5e50843,16095.07,credit,transfer,AU00000,2023-10-01T05:56:09Z
transaction,2a410535-063d-4e22-8d0f-ac31d2224d98,posted,Travel Agency Booking,-1577.85,ce04e6ac-52ee-4322-bb76-06a9f4278fb3,14517.22,debit,bank-fee,AU00000,2023-11-21T09:13:49Z
transaction,c5464b5d-8ba7-446e-932d-570f44f90fa1,posted,Restaurant Dinner,-1972.17,d82cbdee-9cd9-4c42-9926-60b4be868603,12545.05,debit,payment,AU00000,2024-02-07T00:26:04Z
transaction,79a2e23b-f0f0-4118-ac1b-ad99b5a868f8,posted,Manly Maths Tutor Wages,-3516.9,6930fc1f-45ab-4dab-9057-ebf22bc9475f,9028.15,debit,payment,AU00000,2024-03-18T13:08:25Z
transaction,dd45160f-c627-4922-90ef-31d4b9886e86,posted,Home Improvement Store Purchase,-4449.56,cda78a92-cba2-436b-a941-2789513204f8,4578.59,debit,cash-withdrawal,AU00000,2023-11-17T06:36:50Z
transaction,ef86f553-8caa-4777-b5a3-3891017034a3,posted,Electricity Bill Payment,-1488.28,59121f13-ef60-44d2-a772-8f7224a7df4c,5309.09,debit,payment,AU00000,2023-08-19T15:10:38Z
transaction,1f71acaf-1220-4deb-9396-6357809e3611,posted,Netflix Subscription,-2215.59,5e793108-1441-45e5-b89a-a9abbd6e1922,3093.5,debit,cash-withdrawal,AU00000,2023-06-08T01:11:44Z
transaction,1cb0ab1d-3356-418f-8c3f-45c655967a4d,posted,Non Hooli ATM Withdrawal Fee,-2303.99,dfb9d2db-8802-4adb-8ecf-e1561744c652,789.51,debit,payment,AU00000,2023-05-12T11:14:00Z
transaction,dc79ec90-190e-4ddb-aa7d-06d3a02ae422,posted,Manly Maths Tutor Wages,-201.14,6beef97d-3b84-4096-99e1-0d26d68def9d,588.37,debit,cash-withdrawal,AU00000,2023-08-21T07:47:49Z
transaction,bb19fb51-3a6b-454b-838e-7e00a0e0bb72,posted,Bookstore Purchase,-2570.12,e0f510c6-dae1-45a3-bc4f-19b59f59363f,-1981.75,debit,cash-withdrawal,AU00000,2023-08-30T02:53:47Z
transaction,076dae44-a9aa-4289-81a8-6c7dd2b0e737,posted,Music Streaming Subscription,-505.4,16fcc6d3-371e-4daa-a9bc-7dd266e7d535,-2487.15,debit,bank-fee,AU00000,2024-05-09T18:19:48Z
transaction,1dd5553c-ff18-4242-9796-da52773efc19,posted,Manly Maths Tutor Wages,-2098.28,29324747-070c-408d-aa7e-e221bec077e7,-4585.43,debit,payment,AU00000,2023-05-13T20:03:24Z
transaction,771c66c4-61eb-418e-938f-9707e3c602ea,posted,Clothing Store Purchase,-660.14,d6dc28a4-04c7-4c71-bfe4-c32f3c7939e7,-5245.57,debit,cash-withdrawal,AU00000,2023-12-23T23:52:54Z
transaction,279abb0c-bea6-4cad-97c3-9f34fd9088e8,posted,Non Hooli ATM Withdrawal Fee,-2971.18,c278a229-e918-421f-99dd-d96781c151e8,-8216.75,debit,bank-fee,AU00000,2023-12-17T03:34:50Z
transaction,b6b30ded-19c5-4936-818d-ff33647e6a0d,posted,Uber Ride,-1736.24,0ca3e99d-709c-4749-a9f9-1ed3414c46e8,-9952.99,debit,cash-withdrawal,AU00000,2023-06-23T01:29:56Z
transaction,c5200cdb-b4c4-48aa-8627-8f9baeeb1070,posted,Music Streaming Subscription,-4372.07,1b3fbb03-32a3-4486-b03d-5599d4e77c62,6177.81,debit,bank-fee,AU00000,2023-08-22T04:14:39Z
transaction,974ad5cc-53b3-4f00-a93d-87f01874e3f8,posted,Music Streaming Subscription,-4070.54,840f37f6-2aa6-4d02-8efa-b134ce27585f,2107.27,debit,payment,AU00000,2023-05-27T16:36:38Z
transaction,5d74bf26-4311-49cb-9f40-223705221104,posted,Hair Salon Appointment,-4739.93,2bc118a1-eafc-404b-87af-3281fe60c5ef,-2632.66,debit,bank-fee,AU00000,2023-06-30T16:38:49Z
transaction,df5045e6-cc1a-47b5-8cdf-ac19a4055e5c,posted,TRANSFER TO JOANNA SMITH CAMPING,-282.92,6c93829d-ddec-412d-ba17-b1acf4e98c49,-2915.58,debit,payment,AU00000,2023-08-17T20:19:55Z
transaction,e1b70b07-888b-4e40-b4fc-8ac10dac7007,posted,Public Transport Fare,-922.86,8af41a21-9f40-4009-ae71-2058ff35fe97,-3838.44,debit,cash-withdrawal,AU00000,2023-09-11T16:29:50Z
transaction,df5a74b9-2fc6-47eb-be85-ee264ad198fd,posted,TRANSFER TO JOANNA SMITH CAMPING,-4334.94,e6014570-91d9-4302-a3d4-5e7e99a2962b,-8173.38,debit,bank-fee,AU00000,2024-01-03T13:07:03Z
transaction,a0b3b674-f203-404a-8ebf-2dfaad555d92,posted,Payroll WFRMS 15439393,11753.46,5a1121e5-6ce4-4998-be5a-a4e3bec205ec,3580.08,credit,transfer,AU00000,2024-02-01T11:28:05Z
transaction,af8d218a-bc1a-48a5-8e41-385453f36cad,posted,AGL RETAIL ENERGY LTD (GAS),-1024.06,3b48a70a-c88b-4c23-8d4d-b5445fe2c4c5,2556.02,debit,bank-fee,AU00000,2023-06-04T10:45:18Z
transaction,bf00340f-2100-4d43-89ba-87ec87f3d040,posted,Public Transport Fare,-1906.54,6cb800e0-13df-4086-9ca8-60346ac8dd67,649.48,debit,bank-fee,AU00000,2023-07-29T00:33:47Z
transaction,259dd303-2707-4d46-92e0-1430cbf3d582,posted,Wdl ATM WESTPAC IGA BALGOWLAH BALGOWL AU,-313.2,4081fb8a-7b95-4f2b-a0fa-6dfc05fa37c6,336.28,debit,payment,AU00000,2023-10-30T11:47:50Z
transaction,5ee4a3c5-7cef-49de-bf68-9a9bc1b06a09,posted,Travel Agency Booking,-2816.36,192ceee2-df74-422f-9ebf-d72149e29842,7550.31,debit,cash-withdrawal,AU00000,2023-12-20T15:20:10Z
transaction,daad6fd3-3bbc-4586-bd18-e49f11e14cd3,posted,TRANSFER TO JOANNA SMITH CAMPING,-3516.54,5b4c8f0c-98de-41e3-acdb-6a0c4b1792a4,4033.77,debit,payment,AU00000,2024-01-08T14:09:32Z
transaction,fbe7588f-6924-4cc1-be7e-5e3565618739,posted,Music Streaming Subscription,-3866.39,9788913c-ece4-4a05-9e36-fb39366f7877,167.38,debit,bank-fee,AU00000,2023-06-16T13:40:10Z
transaction,5beac346-7a93-4c73-b479-4c1337780b02,posted,Home Improvement Store Purchase,-3056.0,140c8a01-ce84-45f4-8446-e68a1550b19b,-2888.62,debit,payment,AU00000,2023-09-24T05:26:19Z
transaction,5978c0a5-6133-4e1e-a3be-b9f321074168,posted,Wdl ATM WESTPAC IGA BALGOWLAH BALGOWL AU,-1988.89,ba6b8b60-9f1d-4655-9272-3c50d4dd7270,-4877.51,debit,cash-withdrawal,AU00000,2024-03-05T10:50:04Z
transaction,d142c6d5-347e-4226-9f75-6e86fa208492,posted,Restaurant Dinner,-4151.71,ac2383ae-abdd-4e7a-9bda-4d1b8c2a4c02,-9029.22,debit,cash-withdrawal,AU00000,2024-04-20T21:25:27Z
transaction,ba91538b-a1b1-41a8-96d9-a1bd0d889598,posted,Home Improvement Store Purchase,-2149.89,271f1581-aa4d-47e1-8cc4-c9386ac23359,-11179.11,debit,cash-withdrawal,AU00000,2024-04-27T12:20:41Z
transaction,79c85b8a-07f6-402b-b5bd-2e2272a1bac4,posted,Restaurant Dinner,-1794.73,377235e8-604f-4101-b7bb-58b70a8fe932,-12973.84,debit,cash-withdrawal,AU00000,2023-12-06T06:53:23Z
transaction,b3d05e39-b958-4b27-b521-be041d5a4b4c,posted,TRANSFER TO JOANNA SMITH CAMPING,-1859.18,162f6f81-e187-4dff-8e2a-52bf6b16b64b,-14833.02,debit,cash-withdrawal,AU00000,2024-02-11T01:28:33Z
transaction,f27ade08-12c2-4d46-b36f-78be7abb76ca,posted,Coffee Shop Purchase,-2470.41,f0936c98-d542-4310-b99e-351e1a226f35,-17303.43,debit,payment,AU00000,2023-10-27T20:48:20Z
transaction,58872048-5ec9-4722-8020-61098c0d226b,posted,Payroll WFRMS 15439393,11196.45,09bd68f8-9a0b-4fd9-bea7-b1205c268ac3,24540.39,credit,transfer,AU00000,2023-12-14T00:10:05Z
transaction,fa8fb531-af4b-4d23-a026-7ace26ca1859,posted,Hair Salon Appointment,-4243.94,d233c88b-8251-4db9-94b7-f68f33fa8769,20296.45,debit,cash-withdrawal,AU00000,2023-07-07T18:19:29Z
transaction,1e426731-89b0-4b6f-b874-e9a08953936c,posted,Bookstore Purchase,-1575.41,441fe298-67d3-4956-b40c-005ad360993d,18721.04,debit,payment,AU00000,2024-04-01T03:42:09Z
transaction,b5261c2f-7ac3-4893-afa5-fe5df139fd82,posted,Car Maintenance Expense,-3943.29,a1c40011-8e13-4817-a849-3af556047985,14777.75,debit,cash-withdrawal,AU00000,2023-06-17T12:16:51Z
transaction,295430ed-7d77-4443-a493-28d003b47cdb,posted,Mobile Phone Bill Payment,-2200.16,5e7f1ecf-dbc0-4664-b29c-00053a5b38e5,12577.59,debit,payment,AU00000,2023-12-26T12:08:32Z
transaction,ed90d944-3488-4112-9d86-4553a563fbae,posted,Home Improvement Store Purchase,-3845.44,fb23ef9c-98a1-4e87-826b-66be9ab038e8,8732.15,debit,cash-withdrawal,AU00000,2023-06-12T07:13:39Z
transaction,30c9de84-35ca-4a5a-b742-89587f28ca35,posted,TRANSFER TO JOANNA SMITH CAMPING,-92.48,fabbddf1-a874-4f51-b21b-fe74a6c3f23d,8639.67,debit,bank-fee,AU00000,2023-12-01T23:06:07Z
transaction,b1f320b9-d36c-435d-b405-2d55048af638,posted,Travel Agency Booking,-3937.16,3514ff74-922e-4183-9cae-dfcc39b39c97,4702.51,debit,bank-fee,AU00000,2024-03-24T13:18:09Z
transaction,7665019a-aae5-42bb-8b83-d7cf28975b36,posted,Restaurant Dinner,-96.38,af1692f7-008a-42bb-a7c9-bb686dff4a5a,4606.13,debit,payment,AU00000,2023-09-21T23:38:47Z
transaction,792ffbb4-0a5b-4698-b921-03b6d09825f7,posted,TFR Acc14000 TO 12389,-281.88,2330ce12-205e-47c0-9612-6089776c2529,4324.25,debit,cash-withdrawal,AU00000,2024-03-04T08:11:39Z
transaction,55ba6308-89db-4f08-863f-742244b93541,posted,Hair Salon Appointment,-1107.59,76619e1b-1217-43aa-a209-17d561b5f8c0,18279.21,debit,cash-withdrawal,AU00000,2024-04-11T04:38:03Z
transaction,5722d9ef-8ad1-4a31-8969-158f404968a0,posted,Gym Membership Fee,-2179.89,62dec119-bf87-4a1f-be5a-6047f06e6732,16099.32,debit,cash-withdrawal,AU00000,2023-10-21T21:40:11Z
transaction,115af1dd-884a-4982-9755-e31e9d464204,posted,Netflix Subscription,-1790.83,c22595e9-72f2-453a-a3dd-b57f28e1844f,14308.49,debit,bank-fee,AU00000,2024-01-14T05:53:03Z
transaction,fa99e944-e807-4c21-b15b-7ade441bce1d,posted,Payroll WFRMS 15439393,11609.57,2a3db51a-8bae-480d-8e31-e1fb8e5010e7,25918.06,credit,transfer,AU00000,2023-07-08T12:24:39Z
transaction,44e97845-4983-401b-a1ad-c4e984064727,posted,Electricity Bill Payment,-4065.02,3e39aae9-86d2-47f6-9335-86918499e48f,21853.04,debit,bank-fee,AU00000,2023-11-16T14:51:35Z
transaction,038ec061-65fe-411f-8d18-c058f16e7c09,posted,Car Maintenance Expense,-275.09,e03e0792-89c1-4b30-9ebc-ba40d7591af9,21577.95,debit,bank-fee,AU00000,2023-07-15T13:03:00Z
transaction,d733d7e7-f047-4848-8043-b2d09d95b8a1,posted,Online Gaming Purchase,-1763.43,f23c56fb-3b77-4307-93a7-f42ed3cc9453,19814.52,debit,cash-withdrawal,AU00000,2023-09-18T11:59:22Z
transaction,b26fa956-fd67-448b-bfd4-523cd18aac56,posted,Restaurant Dinner,-2051.01,3265aae5-68d7-43da-a889-2b511a0164d4,17763.51,debit,bank-fee,AU00000,2024-04-02T04:26:39Z
transaction,3d770351-e4c6-43bc-a7c6-62d1b573dcb7,posted,Electricity Bill Payment,-4709.03,9acead08-5952-4aa3-b01f-2c369ecdf60e,13054.48,debit,payment,AU00000,2024-03-22T10:14:14Z
transaction,b3bd5266-ef99-4b39-a7ff-dc76b847150c,posted,AGL RETAIL ENERGY LTD (GAS),-4881.7,a420d56c-d6a0-44e0-9432-e45466bbcee3,8172.78,debit,bank-fee,AU00000,2023-06-04T23:56:47Z
transaction,1465f424-8893-4105-8003-1848346f6ca2,posted,Payroll WFRMS 15439393,10849.23,03e6779e-c179-4e64-b87e-5d8b4904621e,22842.93,credit,transfer,AU00000,2023-07-22T03:36:07Z
transaction,c5d744d9-d828-4986-948a-57ffa430276c,posted,Movie Ticket Purchase,-3522.42,6fa4056e-3fde-4eb1-9424-02e9a1dd8625,19320.51,debit,payment,AU00000,2023-09-14T02:33:37Z
transaction,fb854c99-55e6-46ff-a7b5-4bd7b1dad2f5,posted,Car Maintenance Expense,-4717.31,9c4a193b-7af3-4319-b46d-57530b282c9b,14603.2,debit,bank-fee,AU00000,2024-04-21T23:44:36Z
transaction,b35c4c18-82fa-4d8a-be09-936c6615ec6e,posted,TRANSFER TO JOANNA SMITH CAMPING,-2793.45,c024649e-42b6-4a30-97a3-db96d46107bf,11809.75,debit,bank-fee,AU00000,2023-07-28T22:12:40Z
transaction,3ed83d14-3690-4a81-9376-1e74737f28d4,posted,Wdl ATM WESTPAC IGA BALGOWLAH BALGOWL AU,-1964.41,1345cd8d-eabd-4c86-a02f-e4f4f835d363,9845.34,debit,cash-withdrawal,AU00000,2024-03-05T14:08:39Z
transaction,33505a84-4620-4524-80a7-00d2d8038076,posted,Restaurant Dinner,-1223.95,d306abc0-22d3-4702-9d70-3da54cd69bb4,8621.39,debit,bank-fee,AU00000,2024-01-14T12:41:12Z
transaction,10070e18-f1be-417d-a540-37783d9384ad,posted,Hair Salon Appointment,-1824.85,ffd17378-930d-4858-9b84-04a8dc52999d,6796.54,debit,cash-withdrawal,AU00000,2023-07-25T19:47:38Z
transaction,c3dee90d-cbf5-40ec-824b-de366e308420,posted,Clothing Store Purchase,-2739.06,02e76ea1-49b5-42dd-ab07-0237020311f4,4057.48,debit,bank-fee,AU00000,2023-09-21T05:17:28Z
transaction,aeef2f94-d0cf-4418-8468-6edb35ad70ef,posted,Amazon Online Shopping,-1260.79,6dffefe0-ad79-403a-83b5-83a3d370d73a,2796.69,debit,cash-withdrawal,AU00000,2024-02-18T07:25:03Z
transaction,c6c88bd0-a6b7-4bfe-9adf-0775eb3ba03d,posted,Mobile Phone Bill Payment,-4106.44,56d9dc9e-350d-427b-8c20-d9ae3e18c57f,-1309.75,debit,bank-fee,AU00000,2023-08-03T01:04:10Z
transaction,0df096e3-5ad9-42d6-80f3-31fc91d8ad72,posted,Non Hooli ATM Withdrawal Fee,-1087.28,bc39aadd-49f3-45c0-8a0c-ba2e552883d2,13401.66,debit,payment,AU00000,2024-03-25T18:35:14Z
transaction,265ca697-a892-494b-9ddd-747548099e56,posted,Car Maintenance Expense,-1213.5,b006b8d9-3fd9-41bd-9788-d955c465057a,12188.16,debit,bank-fee,AU00000,2023-07-31T19:41:09Z
transaction,157fc115-7ab5-4fdc-88a0-59b5b72021a4,posted,Uber Ride,-3017.96,cced4327-7d49-48d7-8eee-6f8efdb9f4ec,9170.2,debit,cash-withdrawal,AU00000,2023-07-08T16:06:42Z
transaction,0fe16144-7ab5-4514-8884-361683864873,posted,Music Streaming Subscription,-3643.84,a0c7bd88-8508-4ecb-8cfa-51374fc30927,5526.36,debit,payment,AU00000,2023-08-10T07:17:53Z
transaction,5ccb78cd-eb91-4369-964a-b92b4f8ba040,posted,Movie Ticket Purchase,-2008.1,1676d751-aba8-4d8e-ad25-5178cc46b1cf,3518.26,debit,bank-fee,AU00000,2024-03-16T19:00:16Z
transaction,5e7a0c77-4fc5-4941-abef-f1cf3ec45e9f,posted,Non Hooli ATM Withdrawal Fee,-3416.03,8bda174e-ce1d-4b6e-aca4-ccd0e56d9d1d,102.23,debit,bank-fee,AU00000,2024-05-03T18:51:54Z
transaction,32c5c97f-2971-4b95-bdd9-5f7384730bae,posted,Clothing Store Purchase,-679.82,7df84248-a73f-4fba-bb5e-a1d5c6a715f2,-577.59,debit,cash-withdrawal,AU00000,2023-08-25T05:48:15Z
transaction,bfcedea0-8c49-482e-a9b4-10f353561d12,posted,Uber Ride,-1333.13,7a9f35d5-a612-414a-abbb-3ee5323ca467,-1910.72,debit,cash-withdrawal,AU00000,2023-08-24T05:24:58Z
transaction,a06f2c43-1d05-43e5-8b85-f40204b6fd73,posted,Bookstore Purchase,-3489.41,8d63bda5-1202-4ad0-9dd6-fcd8e7939f1d,-5400.13,debit,bank-fee,AU00000,2023-06-11T14:23:25Z
transaction,bad0e9f6-53cb-44c7-82e1-5aa9489ebc8d,posted,Electricity Bill Payment,-73.17,400cde20-4d97-42f0-95ab-b90a3cadc5fe,-5473.3,debit,cash-withdrawal,AU00000,2023-08-21T13:59:51Z
transaction,669b0bf0-df31-45ee-b003-32cd89ced316,posted,Manly Maths Tutor Wages,-2130.7,2bfcdac6-937d-453f-8378-e2b95ceba2b9,6671.65,debit,payment,AU00000,2023-11-17T17:55:47Z
transaction,27512b9e-ccb4-4f42-93d3-fe737113bf6c,posted,TFR Acc14000 TO 12389,-3823.65,fa1a24ef-63d1-44cf-a3ae-8fc024dcc33d,2848.0,debit,cash-withdrawal,AU00000,2024-03-01T10:33:35Z
transaction,c56549a9-2d4c-42f1-bad5-be3296398e29,posted,TFR Acc14000 TO 12389,-1946.41,22bb89b8-07b8-4b70-bf8b-882aca151a04,901.59,debit,payment,AU00000,2023-06-30T11:05:11Z
transaction,2ee1fc02-eae5-4d74-adeb-54f6d77097f7,posted,Electricity Bill Payment,-1036.64,0b1c478c-b742-4e7d-985b-007cebbd02bf,-135.05,debit,payment,AU00000,2024-05-09T11:05:38Z
transaction,4eae7fca-283d-4204-94f0-b219773566d2,posted,AGL RETAIL ENERGY LTD (GAS),-725.99,1c348aae-9a11-44a9-8a15-f4266ac8c1b6,-861.04,debit,payment,AU00000,2024-02-01T11:06:52Z
transaction,c03aee04-fc30-48e1-84b7-b4ce3adfe081,posted,Payroll WFRMS 15439393,10759.35,5c909b4c-be75-45b5-ae32-ba116b16daa3,9898.31,credit,transfer,AU00000,2023-11-08T16:15:07Z
transaction,b65addad-3ab8-494e-ac78-3aab52f4abd9,posted,Clothing Store Purchase,-816.63,9d62a289-4c73-46b1-a09e-ce3d76709d5e,9081.68,debit,payment,AU00000,2023-12-17T20:13:40Z
transaction,55b21e08-1338-4ac5-b6c7-c10e26a12c21,posted,Electricity Bill Payment,-628.86,1e2f1b9e-d123-46e9-a787-0fb6089dad52,8452.82,debit,cash-withdrawal,AU00000,2023-07-09T03:01:03Z
transaction,5a11f868-205c-4b34-b82b-acdf4297c7ed,posted,Coffee Shop Purchase,-2697.4,4db6c12e-ef05-4216-be43-10e6477b757e,5755.42,debit,payment,AU00000,2023-09-14T17:46:17Z
transaction,53856925-8499-4182-92d8-d7753b7f955d,posted,Electricity Bill Payment,-3566.54,cc7d3d89-946b-4410-be2e-933c0a704676,2188.88,debit,payment,AU00000,2023-11-14T10:08:07Z
transaction,6b37968a-5060-4441-b317-8219343661f1,posted,TRANSFER TO JOANNA SMITH CAMPING,-118.14,6bbc15d9-24d8-4c9f-af71-fcab20b46903,5903.17,debit,payment,AU00000,2023-06-02T12:51:15Z
transaction,c50d1a06-d405-4323-83a9-1e59e1b87968,posted,Transfer Platnm Homeloan 346454,-515.02,e05986cc-5771-4eeb-9ea8-395114049295,5388.15,debit,bank-fee,AU00000,2023-06-18T17:37:08Z
transaction,b09f43ce-3932-4b26-9128-b74ebdf6d71a,posted,Music Streaming Subscription,-807.9,c1a3f80e-9bc5-435f-82e7-26481b39f489,4580.25,debit,cash-withdrawal,AU00000,2024-04-17T01:39:10Z
transaction,2540821a-d18f-4a0d-b420-204591b96bbe,posted,Mobile Phone Bill Payment,-3291.36,b7fa8d2e-f44a-486f-844f-5650a0eef180,1288.89,debit,payment,AU00000,2023-12-11T05:11:00Z
transaction,e5fe3f5c-37d7-45f6-ae1c-018843617ac7,posted,CTRLINK CARERS Ref: 998R6789201610974V,-559.93,2d189173-7b52-4dc6-a517-075a7d5d80ae,728.96,debit,bank-fee,AU00000,2023-10-05T17:32:57Z
transaction,b0f3ad91-8154-4dd9-b2ab-e06ed2086131,posted,CTRLINK CARERS Ref: 998R6789201610974V,-3297.55,44f3016f-50be-4f13-be3d-0f61297dffd1,-2568.59,debit,payment,AU00000,2023-09-10T16:22:55Z
transaction,cb0bcdb5-879b-4358-b51f-5a28a68715b4,posted,Bookstore Purchase,-1841.3,7763c68b-313b-46ac-92d0-4e3dca66d027,-4409.89,debit,bank-fee,AU00000,2023-05-25T02:52:06Z
transaction,92f7db78-7ef8-4ad3-9bde-bb88b2e3a0dd,posted,Wdl ATM WESTPAC IGA BALGOWLAH BALGOWL AU,-4031.58,ce7c0994-bdbe-457f-85c1-ad3b15290285,-8441.47,debit,payment,AU00000,2023-06-14T00:40:06Z
transaction,07cd639e-a997-487c-80cb-ca1cb3b574d9,posted,Clothing Store Purchase,-213.03,b15024b0-9085-4dd1-a3fa-0b13e1351577,-8654.5,debit,cash-withdrawal,AU00000,2023-11-08T10:18:08Z
transaction,180f5a20-79ad-4a8d-80e2-1fbd8faa674e,posted,Wdl ATM WESTPAC IGA BALGOWLAH BALGOWL AU,-4655.67,ff9ed660-a81c-4292-84dc-815ab6f24e23,-13310.17,debit,bank-fee,AU00000,2023-09-17T20:59:01Z
transaction,c4a5f452-af26-4745-9b24-32e94d5a50c9,posted,Hair Salon Appointment,-1927.26,6a8567ab-f8db-4cc6-86c1-39312f737ba3,18008.51,debit,payment,AU00000,2023-10-09T23:58:37Z
transaction,2381f6f1-6ffe-4ccc-bb95-3609b40ed722,posted,Manly Maths Tutor Wages,-3594.59,6d9e6b9d-37ca-46c4-9544-8cf9d5de4d47,14413.92,debit,bank-fee,AU00000,2023-10-12T23:23:00Z
transaction,164a798d-71d1-42b6-b1f8-20d579e8dcf6,posted,Electricity Bill Payment,-234.82,431e0b9f-6710-4415-8459-b3a1a0c484e5,14179.1,debit,cash-withdrawal,AU00000,2023-10-04T11:21:41Z
transaction,0239a554-f0e1-475c-83ec-e1dc9e2c0344,posted,Hair Salon Appointment,-4990.54,5c77bde7-d863-41bc-aae5-a95e846f6884,9188.56,debit,cash-withdrawal,AU00000,2023-07-16T05:41:47Z
transaction,d007e049-04a2-447d-bb2e-26e9c1ba2dea,posted,TRANSFER TO JOANNA SMITH CAMPING,-346.79,a3d6fc14-cbea-4e0f-b686-50970f326c70,8841.77,debit,payment,AU00000,2024-03-08T02:22:21Z
transaction,1135689b-b474-432e-8cb5-2c926d3ec68c,posted,Music Streaming Subscription,-4356.87,397a9c6a-1f05-49b1-bb90-11a459794736,4484.9,debit,payment,AU00000,2023-08-02T20:34:29Z
transaction,baa80f57-a2ae-4763-9318-0b6bd279bc39,posted,AGL RETAIL ENERGY LTD (GAS),-4389.18,95b6d3c6-8688-4dc1-8e76-d8a6da5775ad,95.72,debit,cash-withdrawal,AU00000,2023-05-17T19:38:15Z
transaction,68cc73a0-8772-411a-9719-7499f21fc19c,posted,Transfer Platnm Homeloan 346454,-4180.8,45ce1c5d-542e-468e-acc4-37e911a73728,-4085.08,debit,cash-withdrawal,AU00000,2024-02-05T22:52:18Z
transaction,ddc978f6-c047-425a-b97a-7784bc723c0d,posted,Public Transport Fare,-4573.4,89b17834-611c-4a44-bff9-36fc25447af9,-8658.48,debit,bank-fee,AU00000,2023-07-31T17:34:39Z
transaction,5419c75d-9cb4-4d0b-a386-865db9835ace,posted,TRANSFER TO JOANNA SMITH CAMPING,-3514.96,47eab7a9-25d1-48e2-9c38-d04b8f47516f,-12173.44,debit,bank-fee,AU00000,2024-04-16T00:07:22Z
transaction,4b3a5aec-b555-41f1-a3e3-e0402529cd6b,posted,Bookstore Purchase,-1426.61,8fc41227-df66-4b02-b1f0-e91ed1154714,9650.84,debit,payment,AU00000,2023-05-23T19:32:20Z
transaction,ade7e335-d8cf-42db-a47c-08fd24b41cbf,posted,Gasoline Purchase,-3941.36,69ccdd3e-665a-40e8-b912-7c7f16b813ad,5709.48,debit,cash-withdrawal,AU00000,2023-08-19T12:31:12Z
transaction,b281d168-ae0b-4720-8d21-a136a8409d55,posted,Electricity Bill Payment,-2837.24,83816387-b97c-4d68-a1c6-efec9035be6e,2872.24,debit,payment,AU00000,2023-09-05T07:34:50Z
transaction,f6a9994f-b0f2-4a43-bc03-8e023d299314,posted,Public Transport Fare,-12.88,e3ddeadb-59cf-4cae-b82a-0a7f96aa3737,2859.36,debit,bank-fee,AU00000,2023-07-16T01:33:41Z
transaction,06a2144a-06e8-40c9-ac21-8a1be182e942,posted,Mobile Phone Bill Payment,-922.86,de5501c7-9066-4a36-9261-c4cec28836cd,1936.5,debit,bank-fee,AU00000,2024-03-28T06:50:00Z
transaction,bf0537d4-e8aa-4368-b3fb-dd33a02d79e4,posted,Mobile Phone Bill Payment,-1978.03,bef9f29c-4548-4038-b870-b4bd421d073c,-41.53,debit,bank-fee,AU00000,2023-11-05T04:13:28Z
transaction,06e8470e-e549-4770-a01e-1f23edaf2844,posted,Music Streaming Subscription,-3779.46,f18e4cd5-0d07-4c42-a545-47edc73ca26d,-3820.99,debit,payment,AU00000,2023-08-20T06:20:19Z
transaction,bc1d098b-56a1-4da7-b47f-43e40e8dbe54,posted,Public Transport Fare,-4294.8,2d92a7f7-3ada-4538-86e5-05dbe1e89b24,-8115.79,debit,bank-fee,AU00000,2023-06-19T05:26:29Z
transaction,da8f5f51-d7d5-4384-a06f-7c0f1bc2e37e,posted,Bookstore Purchase,-305.29,ff413bc1-630c-4fdb-886b-e7364bb5159b,-8421.08,debit,payment,AU00000,2024-02-13T23:40:58Z
transaction,688d3dd6-5e4e-43f9-ad35-4460dcf59b21,posted,Gym Membership Fee,-3970.05,cf4c916c-501f-4f40-8f60-b7e5110f276f,-12391.13,debit,payment,AU00000,2023-08-15T21:58:08Z
transaction,e90cb323-6acc-41da-a1e9-89f781c8abd1,posted,Hair Salon Appointment,-2261.44,a7393e37-4e70-4cef-9585-042665eccd36,13773.95,debit,bank-fee,AU00000,2024-03-18T00:40:33Z
transaction,348aa91f-8cc6-4841-90a7-6cc493a76e33,posted,Electricity Bill Payment,-1273.8,27c6b837-063f-491f-987d-e1a912eb6827,12500.15,debit,bank-fee,AU00000,2024-02-01T20:21:53Z
transaction,00b0b645-86f7-49eb-bb11-d5c6c03c2672,posted,CTRLINK CARERS Ref: 998R6789201610974V,-614.17,45203f1a-6d77-4445-9d2d-d1ef9721a47c,11885.98,debit,payment,AU00000,2023-10-13T07:23:10Z
transaction,52857025-e9c4-4466-8877-164e3f42f748,posted,Car Maintenance Expense,-3789.41,20654c94-2da3-4bd2-9f4f-3bcb1d1daf0c,8096.57,debit,cash-withdrawal,AU00000,2023-06-23T06:38:29Z
transaction,dd589943-c29d-40c3-a910-b767f7fd24e7,posted,Electricity Bill Payment,-2839.81,a9822352-082f-4bc1-a887-eadf78e543e8,5256.76,debit,bank-fee,AU00000,2023-10-05T14:27:39Z
transaction,a12ac180-6fc1-4488-8dba-fb75d39d9158,posted,CTRLINK CARERS Ref: 998R6789201610974V,-1178.92,63fd4536-a56b-4641-973e-b3e155cead6e,4077.84,debit,cash-withdrawal,AU00000,2023-06-30T03:40:08Z
transaction,5d8e3dc6-d827-41c2-b94a-fc5a2d4010c0,posted,Online Gaming Purchase,-570.66,5ef7e1ea-7ac3-4951-958b-5e7d7c75851a,3507.18,debit,payment,AU00000,2024-02-29T05:08:51Z
transaction,64382d4c-2aaf-4765-81e1-21e1d511a86e,posted,AGL RETAIL ENERGY LTD (GAS),-1196.87,fa9f4dda-3b68-4f4a-9024-8c3fe01bddca,2310.31,debit,payment,AU00000,2023-06-26T14:09:45Z
transaction,6cea2efa-0c0a-4302-adda-25c14390581a,posted,Bookstore Purchase,-1768.68,6fcf6505-d853-448a-bbfe-f7c0101bacd7,541.63,debit,bank-fee,AU00000,2023-07-08T16:38:51Z
transaction,bf3205bb-5117-4cac-b913-70f5eba224eb,posted,Travel Agency Booking,-3305.91,9053d867-7b27-4d04-9b9d-85f35884bef9,-2764.28,debit,cash-withdrawal,AU00000,2024-02-21T00:04:08Z
transaction,83a0d314-2d14-40a9-8951-0014027b31f4,posted,Hair Salon Appointment,-1976.8,2530f7c0-6471-408e-8550-631e64384816,13409.88,debit,payment,AU00000,2024-03-08T06:43:32Z
transaction,879b764f-1b2b-4ea8-9f73-68635b4e9c94,posted,Pharmacy Purchase,-2928.87,7cdd8350-d067-4350-b486-6c7dd99740d0,10481.01,debit,bank-fee,AU00000,2024-04-30T12:15:53Z
transaction,5f413914-3cb5-4184-b595-142a0a3d81e0,posted,Car Maintenance Expense,-337.58,b6a8e6c1-ab90-4f71-bdd9-0e6c8e33c737,10143.43,debit,bank-fee,AU00000,2023-09-14T03:08:58Z
transaction,3867e037-7586-449c-b665-2767ffb4d004,posted,AGL RETAIL ENERGY LTD (GAS),-4284.01,192398b6-936d-4919-8a76-4227d03a8bd7,5859.42,debit,payment,AU00000,2024-02-21T12:22:23Z
transaction,9b07b80c-1315-4254-ac2e-4cab0836f0e2,posted,Car Maintenance Expense,-2618.82,35402785-90f4-484e-bc13-ac7557a42e2b,3240.6,debit,cash-withdrawal,AU00000,2024-03-28T23:03:39Z
transaction,266a90a2-c059-4b33-a1f2-f601ec69fa22,posted,Manly Maths Tutor Wages,-2005.62,1f95389a-ae08-40ad-bd7d-b9436480f4ba,1234.98,debit,bank-fee,AU00000,2023-09-19T22:52:08Z
transaction,1ccb9fc9-db5e-4ebb-b495-79165fd8cfd3,posted,Public Transport Fare,-1210.23,8d577bd3-0510-45aa-80e7-70fefca0df8c,24.75,debit,cash-withdrawal,AU00000,2023-07-25T07:12:43Z
transaction,f2a25de3-62b8-4d70-92cf-c927f8adf00c,posted,Travel Agency Booking,-287.76,438dceaa-5d45-4e11-bf15-adc1cec24708,-263.01,debit,payment,AU00000,2023-07-12T01:56:41Z
transaction,a433a4da-c4a7-424f-a015-5446ed2958df,posted,Coffee Shop Purchase,-2893.06,088468cd-300d-4b7b-a515-ab489ebd62ad,-3156.07,debit,bank-fee,AU00000,2023-09-23T20:24:30Z
transaction,5a90c4c2-f9a7-4b82-8d88-88c6da41f70d,posted,Bookstore Purchase,-170.53,e05a13f6-65df-482d-bf6b-6944f4e55af0,-3326.6,debit,cash-withdrawal,AU00000,2023-05-20T14:19:49Z
transaction,676da3f4-bbe3-477d-a9d5-ef0bd89ef0cc,posted,Non Hooli ATM Withdrawal Fee,-3072.06,2422ebc6-5b1d-42d8-99a2-c934a25566ae,2672.02,debit,cash-withdrawal,AU00000,2023-10-04T01:09:29Z
transaction,3b1cacb8-7dba-4a43-a0f5-551008eaa976,posted,Wdl ATM WESTPAC IGA BALGOWLAH BALGOWL AU,-4688.43,b5b85138-f08a-47c9-a0ae-72928a95d140,-2016.41,debit,payment,AU00000,2024-03-05T18:33:43Z
transaction,58195530-dbd8-498b-af68-3c1a6d0f779e,posted,Mobile Phone Bill Payment,-4661.18,d0bdd6d3-3930-476b-b1da-446fc513fe89,-6677.59,debit,cash-withdrawal,AU00000,2024-01-09T10:07:27Z
transaction,3ed39164-6675-485c-92f8-1783e2b11033,posted,TFR Acc14000 TO 12389,-444.46,911b88cb-6ab3-4520-8811-2610839f3bd2,-7122.05,debit,payment,AU00000,2024-01-03T19:46:07Z
transaction,16311d1f-a775-4d2a-86b1-ae337d9ffb74,posted,Amazon Online Shopping,-390.42,16c2f76e-c78c-40ee-a757-b246de4d19a4,-7512.47,debit,cash-withdrawal,AU00000,2023-08-12T19:14:16Z
transaction,d7c802e5-d398-4728-afc1-1bcf47d286af,posted,Pharmacy Purchase,-4096.77,a11025a5-22ab-41de-8c06-1a1db730f19b,-11609.24,debit,bank-fee,AU00000,2023-11-04T22:40:38Z
transaction,b2f10cb2-36cd-461a-bb3e-a4a92fc14c67,posted,Gasoline Purchase,-195.12,2f1923ef-0b8f-45a9-97ec-387a8d4a5a7a,-11804.36,debit,bank-fee,AU00000,2023-08-11T08:57:48Z
transaction,5692fdd3-3f88-4d13-9881-a620f136aee9,posted,Car Maintenance Expense,-14.3,a3d1cbaa-1c56-4889-b860-3452a0a8c5ba,-11818.66,debit,cash-withdrawal,AU00000,2023-05-19T22:29:24Z
transaction,69434e14-8a45-4060-9186-ce81f61a7eaf,posted,Music Streaming Subscription,-3719.84,f97f3c01-d825-404e-807f-9d547dd77d54,-15538.5,debit,payment,AU00000,2024-04-07T03:01:33Z
transaction,f7faf4a8-edd7-4ee8-8c11-5d7cb2bed00a,posted,Uber Ride,-1499.35,112dfae7-bea0-4790-b888-d52729ffa6fb,-17037.85,debit,cash-withdrawal,AU00000,2024-04-15T00:46:23Z
transaction,cd157521-7fcb-4f17-b616-27cdc659fd78,posted,Transfer Platnm Homeloan 346454,-1424.68,394bf037-825c-460f-a188-fdd3c47e1682,8703.91,debit,payment,AU00000,2024-02-13T09:30:34Z
transaction,67adb2fb-4314-4444-a101-640a6e91c8ec,posted,Travel Agency Booking,-2858.71,44ee8d47-ef5b-4080-95da-f736ce9d5370,5845.2,debit,cash-withdrawal,AU00000,2023-06-06T17:49:00Z
transaction,afeb2ab1-d5f9-4106-b1a4-0c1b40149aa5,posted,TFR Acc14000 TO 12389,-4734.3,6e436922-4233-4896-8883-f12c64cfbc84,1110.9,debit,cash-withdrawal,AU00000,2023-11-28T14:46:32Z
transaction,b29ced7a-80c6-4f6f-aed9-9fac288fafe5,posted,Public Transport Fare,-160.87,93a71471-ba00-4ba5-b0fa-61e82fe91ebd,950.03,debit,bank-fee,AU00000,2023-10-04T04:41:53Z
transaction,84c63603-d2be-4c7a-87ff-5c087bc31fc2,posted,Hair Salon Appointment,-2411.11,c4f865fe-3c51-4ef8-b280-e5d9bc0683ab,-1461.08,debit,payment,AU00000,2024-04-11T17:34:10Z
transaction,dd83e50d-232c-4a7a-9f67-e32065428797,posted,Mobile Phone Bill Payment,-2151.05,7a1b2338-f1eb-4d87-9e26-1955152b7763,-3612.13,debit,bank-fee,AU00000,2023-12-01T00:47:19Z
transaction,803366b8-768b-4afd-b6c5-0ed7976cc533,posted,Gasoline Purchase,-917.74,ae432c3e-8cc7-4c4f-a063-ccea199e3fb5,-4529.87,debit,bank-fee,AU00000,2023-09-23T23:41:28Z
transaction,0a5df06b-7f7f-415a-a31f-26509cc9aac1,posted,Manly Maths Tutor Wages,-4865.72,c732feac-9144-40f8-bd17-d760a1ccad19,-9395.59,debit,payment,AU00000,2024-02-01T19:46:37Z
transaction,8bcf4f60-afd5-4df0-938b-7e53503e1fb8,posted,Hair Salon Appointment,-3123.2,2c570d1b-db21-476b-9509-0565d74a4f7b,-12518.79,debit,bank-fee,AU00000,2023-10-14T12:10:17Z
transaction,9f85f8c6-089d-4dee-a963-98d94b04132b,posted,Gym Membership Fee,-689.59,3a5be688-ce51-4f0a-80cb-dcb464e9bbca,-13208.38,debit,bank-fee,AU00000,2024-01-01T11:06:22Z
transaction,841bb918-7798-4dce-a026-9ff3da156fa7,posted,Car Maintenance Expense,-4731.29,b1ce1002-dd06-4303-8d6e-8aee0001be81,10045.73,debit,cash-withdrawal,AU00000,2024-03-17T23:20:53Z
transaction,72f7f6ae-d7b9-4ee0-adb4-edfa2b401620,posted,Uber Ride,-2702.48,f57fa57d-2bf4-4b2f-b6bb-e0460f204427,7343.25,debit,payment,AU00000,2023-11-09T14:29:03Z
transaction,ef01827c-93af-4048-924f-5feede7e29f6,posted,AGL RETAIL ENERGY LTD (GAS),-2430.36,01149024-cf26-4907-9867-45f30c7a5dc3,4912.89,debit,bank-fee,AU00000,2023-11-10T09:43:29Z
transaction,2d4bcd24-b555-4d5f-836f-05e26674a7aa,posted,Mobile Phone Bill Payment,-3691.51,c003505c-8bd6-40af-b59c-eab05c20e24b,1221.38,debit,payment,AU00000,2023-12-04T20:17:42Z
transaction,b3f2e7c5-68e3-4389-929b-c891ad588f04,posted,CTRLINK CARERS Ref: 998R6789201610974V,-2847.48,40351988-689b-4af8-aec3-72a5e7a41b66,-1626.1,debit,bank-fee,AU00000,2023-05-17T03:43:44Z
transaction,070326f8-5984-4d1d-bc0b-72bfde96e1b3,posted,Coffee Shop Purchase,-3308.31,51f7330b-b3ad-4926-8426-b7366817c4c6,-4934.41,debit,payment,AU00000,2023-06-17T12:05:50Z
transaction,7398a989-112d-48a0-8148-9d30c09b0a28,posted,Restaurant Dinner,-3251.73,382628fd-d744-4db7-b232-ca334ea99a19,-8186.14,debit,cash-withdrawal,AU00000,2023-10-27T01:24:09Z
transaction,825ef75c-e7ff-4df0-a0fc-9c1319e2326a,posted,Online Gaming Purchase,-2648.59,a0b35284-dfd7-447c-b83f-865422ea8172,-10834.73,debit,payment,AU00000,2023-05-19T13:04:50Z
transaction,3949c4c4-023d-448c-adfd-ab5f99a4ae52,posted,Gym Membership Fee,-4326.45,cd0ddc3a-45f0-47ee-9327-870a70feba6c,-15161.18,debit,payment,AU00000,2023-08-31T21:47:38Z
transaction,f1e9362d-7e52-4d12-8a4c-299c11d65abb,posted,Wdl ATM WESTPAC IGA BALGOWLAH BALGOWL AU,-1449.95,a947856f-2fe2-4807-ae9c-23dcf1a4276f,-16611.13,debit,payment,AU00000,2023-05-29T11:36:44Z
transaction,f8317524-29a5-4bce-b142-fa2cee2c16ff,posted,Mobile Phone Bill Payment,-589.5,9f279e94-8d44-4d70-9183-ae1b24bdeeeb,4525.99,debit,payment,AU00000,2023-09-26T09:16:59Z
transaction,22cfb896-11cc-455c-9478-49c807793108,posted,Netflix Subscription,-169.62,609f9561-4450-42f5-a2a2-4c23808b566c,4356.37,debit,cash-withdrawal,AU00000,2023-11-28T05:38:36Z
transaction,774c287c-4f8d-4a64-8ca8-00d252abb895,posted,Home Improvement Store Purchase,-2104.39,d2fe0cf8-4b89-4c7e-adf6-140df54dcc02,2251.98,debit,payment,AU00000,2024-03-10T20:50:57Z
transaction,96ac9370-4780-4f7d-9296-845b09d75538,posted,Netflix Subscription,-1340.79,22ed8393-1c96-4cf2-bf48-dbbf91fd83a7,911.19,debit,cash-withdrawal,AU00000,2023-10-11T06:29:06Z
transaction,2e4dcb2d-22b5-43bb-a3df-e6a857967860,posted,Manly Maths Tutor Wages,-1492.18,b63e2c17-8146-4c7d-925e-86150a289797,-580.99,debit,payment,AU00000,2024-02-28T20:59:09Z
transaction,e000f9b8-20ce-4fff-8e28-cfbc84eadcd0,posted,Amazon Online Shopping,-1204.54,d3d8ab53-7943-4f96-bc9d-4ce1b2ed3b24,-1785.53,debit,cash-withdrawal,AU00000,2023-10-03T09:31:02Z
transaction,3837d055-6882-4c8c-8bc7-17899392befd,posted,Music Streaming Subscription,-3653.02,f3381a2d-dae5-4b1c-826c-3970c74f1b2e,-5438.55,debit,bank-fee,AU00000,2023-06-16T23:49:03Z
transaction,56acf0ea-b5e5-4300-88e9-9279975823d5,posted,Online Gaming Purchase,-3106.3,2e0df762-3796-4c25-b656-a09bef27edc8,-8544.85,debit,bank-fee,AU00000,2023-08-18T09:39:04Z
transaction,ad017ce3-d573-4c4d-8fbb-0fe75e23f733,posted,Transfer Platnm Homeloan 346454,-2350.51,3816f819-3886-46e6-81a5-fcc8ed223b20,-10895.36,debit,bank-fee,AU00000,2023-09-04T06:01:36Z
transaction,61d1d559-c035-4112-b3c4-3d63a93f22d9,posted,Coffee Shop Purchase,-4523.71,be27c719-cc83-4a88-9816-01f2123e79ef,-15419.07,debit,bank-fee,AU00000,2023-12-09T07:40:24Z
transaction,7f242e4a-c7ba-4c02-a635-13ab8a00e3e5,posted,Manly Maths Tutor Wages,-424.71,2f43b871-cda2-438f-bea7-2f98af5fd152,19305.07,debit,payment,AU00000,2023-12-15T17:32:52Z
transaction,e2cb1ac7-6486-4f91-b565-ee9616c6ad52,posted,Coffee Shop Purchase,-364.36,5f6749ca-ac72-4552-8b99-718720a8361a,18940.71,debit,cash-withdrawal,AU00000,2023-09-25T02:14:47Z
transaction,df6d244f-f7bf-4a21-97c1-ae85640f5a76,posted,Gym Membership Fee,-2286.4,3235e12f-88f5-494f-8d39-c7405744aaf9,16654.31,debit,cash-withdrawal,AU00000,2024-03-12T13:52:27Z
transaction,ec251bbb-2406-4ee5-bd9e-35fc5f69f703,posted,Non Hooli ATM Withdrawal Fee,-1672.95,f40cf9a7-a598-4f77-bf18-a3c18aad0a56,14981.36,debit,payment,AU00000,2023-07-11T05:43:44Z
transaction,2d1832dc-3f3f-4da5-aad5-04996e07bf27,posted,Bookstore Purchase,-3347.88,682b4d20-4662-4377-afe9-f5a2117dc25c,11633.48,debit,bank-fee,AU00000,2023-11-24T18:09:16Z
transaction,91022fe3-2431-40f8-96af-365567322d92,posted,AGL RETAIL ENERGY LTD (GAS),-4270.55,ca1e2695-a77e-4c28-90c1-7e2bc4f51cba,7362.93,debit,bank-fee,AU00000,2023-11-29T14:35:02Z
transaction,a316cbd1-2bfa-4603-bc0b-9c88ffc7dfab,posted,Gym Membership Fee,-4949.85,53f2df1f-6470-4116-989b-929b2039c85b,2413.08,debit,bank-fee,AU00000,2024-04-21T15:33:39Z
transaction,557cfa93-bbe5-42c1-8e85-ce19f8de7b8e,posted,Clothing Store Purchase,-1107.23,f5566bd7-a9f0-43e9-9fb3-1c483ec7eaa3,1305.85,debit,bank-fee,AU00000,2023-09-22T18:22:01Z
transaction,51b43797-057a-4ead-9360-a78610cfe80a,posted,Amazon Online Shopping,-4352.2,55047a42-fba9-4391-b882-dbb9f7241d85,-3046.35,debit,bank-fee,AU00000,2023-12-12T20:55:57Z
transaction,2a4f6702-d816-4a22-a01a-86cf75aa8949,posted,Coffee Shop Purchase,-1538.56,e7b30b8c-85c3-40a5-83af-f58057dfc104,-4584.91,debit,cash-withdrawal,AU00000,2023-06-23T18:50:45Z
transaction,57969111-3b97-4ac7-b0c1-fa40ba4ac808,posted,Manly Maths Tutor Wages,-3893.92,05f6a302-ae79-4422-8dbb-81a8e8f22f77,10870.13,debit,cash-withdrawal,AU00000,2024-01-28T15:49:54Z
transaction,2ec59611-4e94-4df1-bc44-d4d0cb4a849b,posted,Pharmacy Purchase,-2944.44,788bf5c3-8fae-43da-9270-e28125e33fad,7925.69,debit,cash-withdrawal,AU00000,2023-06-26T13:11:26Z
transaction,60a3ef57-c904-4945-be86-426035df6f69,posted,Transfer Platnm Homeloan 346454,-3921.27,cbdf2b49-4a1e-4881-bb29-eb8cae26a678,4004.42,debit,bank-fee,AU00000,2024-04-19T06:07:06Z
transaction,78943e68-a907-4c2b-93fc-0e0feb6e856b,posted,Uber Ride,-2658.88,cdca2e1a-56fc-4ffa-9651-c5953acb476e,1345.54,debit,cash-withdrawal,AU00000,2024-01-01T15:53:37Z
transaction,b3f0e358-f936-4f2f-9c6b-5630ee554824,posted,Online Gaming Purchase,-1056.74,8d67ea87-7f2f-4f23-bd28-340d2513c371,288.8,debit,payment,AU00000,2023-11-28T00:53:09Z
transaction,bc80249d-8ddf-4cc4-b2a6-98bdaef51d14,posted,Gasoline Purchase,-1667.56,cfef00bc-399e-4163-b248-d8b6fe67598f,-1378.76,debit,cash-withdrawal,AU00000,2024-03-12T18:00:50Z
transaction,78ab12bb-8d48-4fdc-8857-66140280b0ab,posted,Clothing Store Purchase,-223.47,1deae19a-861b-4d04-8a75-fa9e1bc332af,-1602.23,debit,cash-withdrawal,AU00000,2023-08-19T07:11:27Z
transaction,8d9e4ec3-240d-4932-9415-690b31b05bad,posted,Hair Salon Appointment,-3342.45,cf0b88eb-23ba-444e-aa9a-d8f4c566b64f,-4944.68,debit,bank-fee,AU00000,2023-12-27T10:17:07Z
transaction,741d280a-9cd0-49bd-a0dd-7cdd1588938b,posted,CTRLINK CARERS Ref: 998R6789201610974V,-2630.43,3668c050-3086-470a-92f3-05669d0aa6f2,-7575.11,debit,payment,AU00000,2023-10-26T07:39:03Z
transaction,7ae1e117-514e-4a1c-9e19-6aed307b53ac,posted,Movie Ticket Purchase,-4629.46,723d1179-950e-4421-ba40-9ffe68c3ba74,-12204.57,debit,bank-fee,AU00000,2023-10-03T12:22:53Z
transaction,e852bad0-3c32-43a1-a6b3-bf8aaad88159,posted,Restaurant Dinner,-1123.47,c73c369b-7c58-4a5f-aba1-c6f02b9fbf00,15837.52,debit,cash-withdrawal,AU00000,2023-11-04T08:13:00Z
transaction,f93ad22f-9155-4ff7-8f12-b5f21ae626d0,posted,Payroll WFRMS 15439393,11918.98,88d3303e-4914-4d2c-9bf0-649ec17f742e,27756.5,credit,transfer,AU00000,2023-12-29T16:47:57Z
transaction,70b12f36-6203-4297-80f3-a1c81908bb48,posted,Mobile Phone Bill Payment,-3897.27,0ef2484d-9594-4364-ac53-f5ac3bf96dd0,23859.23,debit,cash-withdrawal,AU00000,2024-05-03T09:06:54Z
transaction,c3709f16-0fb6-478c-9591-6fa3b4c72060,posted,Pharmacy Purchase,-3988.9,1431b207-392f-463f-b7ca-d40494fe4996,19870.33,debit,payment,AU00000,2024-05-10T08:33:58Z
transaction,a8c4d56f-a609-4992-9a47-141342228190,posted,Travel Agency Booking,-1089.64,89ba4e2d-6cab-4b47-a122-7b0dafa96932,18780.69,debit,payment,AU00000,2023-12-10T22:53:36Z
transaction,a8b1214e-b0ea-41ea-b43a-44be52d513b4,posted,CTRLINK CARERS Ref: 998R6789201610974V,-2516.16,6c3ef42e-0d26-4f19-b462-b01325ad0bf7,16264.53,debit,cash-withdrawal,AU00000,2024-01-20T04:50:17Z
transaction,1ec748e5-0d3a-4e65-9531-ea55df58607d,posted,Payroll WFRMS 15439393,10715.41,99290099-6765-4fa0-9782-c490a04c435a,26979.94,credit,transfer,AU00000,2023-06-28T00:01:40Z
transaction,a1159922-7f8a-4fc4-a9ed-1b8366925cdb,posted,TFR Acc14000 TO 12389,-323.4,8eefb2b9-b79e-439d-8bcc-8402da06c0b4,26656.54,debit,payment,AU00000,2023-06-30T08:00:01Z
transaction,c9f8c799-88de-4106-86d2-73b48ae09783,posted,Travel Agency Booking,-2675.59,989f2827-6c6e-49e6-a632-3c9e4d2d9d98,23980.95,debit,payment,AU00000,2023-06-18T15:15:46Z
transaction,6677977e-fcd6-4deb-aea1-438114e02fd6,posted,Electricity Bill Payment,-318.15,d333ba6a-ddcf-4ea3-a764-25f0add33e54,23662.8,debit,payment,AU00000,2023-06-18T03:36:16Z
transaction,6081946c-f171-4169-b495-008cdb7d68ae,posted,Mobile Phone Bill Payment,-3906.58,0e430b5e-cabc-4ce4-a110-104834f6ac90,3961.96,debit,bank-fee,AU00000,2023-06-10T22:26:34Z
transaction,4ecea2bc-96dc-4862-ae77-dac9eb78b37f,posted,Restaurant Dinner,-3175.7,9a8309c7-8764-4534-bc86-a995c76c47fd,786.26,debit,bank-fee,AU00000,2024-03-26T19:37:40Z
transaction,77615d9b-ee34-4936-ba8a-2e8eb7f3cb0c,posted,Online Gaming Purchase,-3098.61,69b6535c-0dba-41af-ab6e-e75fdf04c3b2,-2312.35,debit,payment,AU00000,2023-11-18T06:59:05Z
transaction,276a434e-aad9-43e1-9893-e4e6b6070a87,posted,Uber Ride,-3219.76,be606369-8da2-4d77-8fc8-f29c3436c46c,-5532.11,debit,bank-fee,AU00000,2024-01-20T19:58:00Z
transaction,e9b5d3c8-09dc-42a9-8390-7070569c1fe0,posted,Amazon Online Shopping,-2571.64,0e8b6d06-c3aa-4b11-a389-7d22deeccf2f,-8103.75,debit,cash-withdrawal,AU00000,2023-09-07T08:43:24Z
transaction,2d5b9e4c-dc3d-48d1-9eb0-a2aacc1647ef,posted,Transfer Platnm Homeloan 346454,-360.04,a0b6e0f9-c9af-44c5-9470-1833f8acf232,-8463.79,debit,payment,AU00000,2023-11-26T19:05:17Z
transaction,e603765b-2f5b-4567-9bdc-bab88321380c,posted,Wdl ATM WESTPAC IGA BALGOWLAH BALGOWL AU,-529.39,028f253b-d4f9-4db6-bd1b-0ca4d7fd9a3e,-8993.18,debit,payment,AU00000,2023-07-15T03:01:12Z
transaction,f92602ee-6154-4ae4-9f48-ef7e8bae5370,posted,Pharmacy Purchase,-2857.47,84e57a5c-853e-4351-954b-580257bc5936,-11850.65,debit,cash-withdrawal,AU00000,2023-08-01T06:51:32Z
transaction,cbbfb6b0-8b94-48e1-9814-21452eea7f53,posted,Transfer Platnm Homeloan 346454,-4964.5,fac84083-39d9-43dc-8954-0b24aaeeb0aa,-16815.15,debit,bank-fee,AU00000,2023-12-03T10:07:32Z
transaction,ca2d49aa-ebac-4eb5-acc2-e0adcaf8f9ce,posted,AGL RETAIL ENERGY LTD (GAS),-4306.12,9145a38c-423a-4cee-9e81-1ec16315bf6c,-21121.27,debit,cash-withdrawal,AU00000,2024-05-05T07:14:34Z
transaction,9f631fb4-dd05-4557-a323-f5571ec003ed,posted,Gasoline Purchase,-1237.39,6b579b61-dd2e-4e42-aaff-876eb658c9d3,14753.52,debit,payment,AU00000,2024-02-27T01:02:30Z
transaction,2136ca35-9144-43f7-a2db-78da7adc4b47,posted,Wdl ATM WESTPAC IGA BALGOWLAH BALGOWL AU,-2324.77,da09abc9-360e-4e82-843d-022f29db7536,12428.75,debit,bank-fee,AU00000,2023-09-26T12:22:20Z
transaction,d79adaf5-6a38-4fdb-bfc2-49326acb6faa,posted,Restaurant Dinner,-4838.17,fe4546e8-2636-48d2-9e25-3d23c6884f68,7590.58,debit,bank-fee,AU00000,2024-02-06T15:19:42Z
transaction,2025b4ec-3e45-42d3-bd0e-6a810751db22,posted,Travel Agency Booking,-3767.05,98dd7520-ec12-45de-ba78-5ea27169a75a,3823.53,debit,payment,AU00000,2023-08-03T23:18:10Z
transaction,a44dd312-46f6-46c5-9363-be6bd913ac69,posted,CTRLINK CARERS Ref: 998R6789201610974V,-3275.64,f8d2905e-60f2-4287-8c89-d6ae4fac4f87,547.89,debit,payment,AU00000,2023-07-07T19:35:03Z
transaction,aca6ef44-96e1-4d37-8c6e-fb7b8122ca20,posted,Netflix Subscription,-3563.67,c3365606-382d-44a5-97bd-b24da4953d44,-3015.78,debit,cash-withdrawal,AU00000,2023-06-14T00:34:07Z
transaction,d8ee0fce-1a84-4e45-b168-8c2e8e9f4e11,posted,Gym Membership Fee,-1217.03,78724c4c-858c-4afa-8414-e1b727da8e3c,-4232.81,debit,cash-withdrawal,AU00000,2023-06-26T20:09:10Z
transaction,0bca99a3-212c-494b-b1f6-dc527a17e35e,posted,Transfer Platnm Homeloan 346454,-4577.94,72b218b4-5de1-45a9-b19e-9d8f3f36ab8a,-8810.75,debit,payment,AU00000,2023-10-31T19:42:14Z
transaction,219708ad-0fc0-4858-ab66-4b8a77469b77,posted,Online Gaming Purchase,-1140.71,2e3cbd9b-aede-4ead-a3fd-aa4648e19979,-9951.46,debit,payment,AU00000,2024-05-05T07:32:45Z
transaction,15a718de-eb1b-46e7-b5c0-85d55959a71c,posted,Gasoline Purchase,-313.97,d203cf75-01f0-4a28-9fa4-5e15f1ed8348,-10265.43,debit,payment,AU00000,2023-12-19T10:17:21Z
transaction,fedada9a-8ea9-4f94-b6c2-ffd3a6edca04,posted,Car Maintenance Expense,-2797.85,d7c0acf6-00c8-47b3-a2fd-38e2940e35d1,9071.71,debit,payment,AU00000,2023-08-23T19:28:42Z
transaction,62ccb55d-1aad-4d6b-a0ec-27c8a941b6e0,posted,Manly Maths Tutor Wages,-4532.06,61dcb00c-5061-4805-96ac-d45403636efd,4539.65,debit,cash-withdrawal,AU00000,2024-02-29T17:50:37Z
transaction,c8a1e851-a3e2-427c-bf94-644b152ce4dc,posted,Hair Salon Appointment,-1056.06,827999e3-df56-4b67-8646-8ae70b3e46b2,3483.59,debit,bank-fee,AU00000,2023-09-05T08:24:32Z
transaction,f323c000-a0d8-4227-ba33-7047d459f8ae,posted,Wdl ATM WESTPAC IGA BALGOWLAH BALGOWL AU,-450.13,fce9df41-ef8a-424f-816f-22f98263f377,3033.46,debit,bank-fee,AU00000,2024-03-31T08:03:54Z
transaction,df1951b6-3bb7-4721-894d-191d2c31ca95,posted,Home Improvement Store Purchase,-2907.56,e42b321d-c95b-424f-bcb5-1ab358571f03,125.9,debit,bank-fee,AU00000,2023-08-21T02:36:32Z
transaction,50cd5933-ebe4-49b3-b18b-eb0278338750,posted,Music Streaming Subscription,-2476.91,8886e34c-415b-42e8-9877-b711b2450c74,-2351.01,debit,cash-withdrawal,AU00000,2023-06-25T03:35:45Z
transaction,d42756fb-42cc-4f43-b3d6-35e642647c49,posted,Music Streaming Subscription,-990.21,4be815bb-cdfd-42b4-a175-52a90f296067,-3341.22,debit,cash-withdrawal,AU00000,2024-04-20T04:16:36Z
transaction,5bda0aee-f1ea-4b72-843c-8ecfa0cf5994,posted,Gym Membership Fee,-438.19,dc2c5aa5-e6e1-4cb2-a9e4-bea2d0132e2b,-3779.41,debit,payment,AU00000,2023-11-21T18:55:48Z
transaction,e19454f7-1526-4f2b-bf0b-d51ba29f47b9,posted,TFR Acc14000 TO 12389,-4505.8,52d9f1f3-8eaa-4345-8cac-5bff83fcbcde,-8285.21,debit,payment,AU00000,2023-10-26T20:00:04Z
transaction,8d1217b0-b4e7-4423-b279-559232a1d10f,posted,Wdl ATM WESTPAC IGA BALGOWLAH BALGOWL AU,-500.17,41cffa27-c483-45e0-898e-00a982391ebe,-8785.38,debit,cash-withdrawal,AU00000,2024-03-07T10:37:03Z
transaction,28009291-97fe-4016-bdbe-f66aa431b1bc,posted,Payroll WFRMS 15439393,11701.47,68852549-9aee-4bf1-a51f-296f8687bce8,28550.84,credit,transfer,AU00000,2023-05-20T08:45:42Z
transaction,f9e309ba-cff0-4e61-8f2e-89cf01c0f817,posted,Manly Maths Tutor Wages,-121.01,f9d2085f-fbfb-4f40-84b8-0c65aa64142b,28429.83,debit,bank-fee,AU00000,2023-10-23T03:04:46Z
transaction,a92fd549-155a-41f3-99c0-cf7e3001a45a,posted,Gym Membership Fee,-1105.7,ada44b97-97d0-457b-a971-2be97539c34f,27324.13,debit,cash-withdrawal,AU00000,2023-07-26T04:54:50Z
transaction,ebb13d3f-5b5e-44df-adb6-80fd838cdc7b,posted,AGL RETAIL ENERGY LTD (GAS),-1429.06,fbb88c3f-c447-45eb-a079-b7104b471dbc,25895.07,debit,payment,AU00000,2024-01-24T14:24:17Z
transaction,b12ebce0-17ff-41c2-b351-48ab1d02a799,posted,Bookstore Purchase,-524.71,b92fd589-fdd3-4165-b618-6d6743510cd1,25370.36,debit,payment,AU00000,2023-07-21T22:09:29Z
transaction,0841c3b2-4ce4-419c-b874-6729cdf523ad,posted,Electricity Bill Payment,-3165.89,b40a6b81-9dc5-47e7-bcf8-b3d2155f7e66,22204.47,debit,bank-fee,AU00000,2024-04-27T19:52:10Z
transaction,4c6e1356-6511-401d-a93b-3f0732824e93,posted,Gym Membership Fee,-683.89,d81944b7-b8c2-4bf9-9ba1-f70511845105,21520.58,debit,cash-withdrawal,AU00000,2024-03-26T01:31:35Z
transaction,2a1d273b-5bd9-42d8-b691-2a43b72b4422,posted,Online Gaming Purchase,-3255.47,f1e11e0c-af4b-4b7e-b917-aa66dd4c535a,18265.11,debit,bank-fee,AU00000,2023-09-15T04:47:52Z
transaction,3aa2f9b9-e3e3-4a34-92a0-5b189809e1cb,posted,Music Streaming Subscription,-3887.98,bcbc9de7-5f21-4059-9ce5-db779407dc3a,14377.13,debit,payment,AU00000,2024-03-30T23:25:00Z
transaction,c161332a-bede-4f2b-93ce-ee298ebff384,posted,Music Streaming Subscription,-2808.25,0bfdfb90-f9d6-4f57-95ae-511c97dfde51,11568.88,debit,cash-withdrawal,AU00000,2023-11-26T03:16:57Z
transaction,57bdd5b8-4d31-445b-838f-b9cab9d1638d,posted,Car Maintenance Expense,-868.74,46c55142-e551-42ac-9ee7-bae01f4dd59c,12467.74,debit,bank-fee,AU00000,2023-08-01T23:19:31Z
transaction,4d253b9c-74f4-4bae-95e4-2b0625fb3824,posted,Travel Agency Booking,-1236.5,75b2af35-6b30-403b-8582-7d8e31f2470c,11231.24,debit,cash-withdrawal,AU00000,2023-11-06T09:45:48Z
transaction,449f19e4-887d-4cbf-b64e-0bc575f85e0b,posted,Electricity Bill Payment,-3284.48,195e0d48-f0e3-488a-b7ac-4b8e54fe709f,7946.76,debit,cash-withdrawal,AU00000,2024-04-25T15:03:48Z
transaction,e5946a3e-fd08-4444-806c-3206ab2cb2a0,posted,Music Streaming Subscription,-305.57,91e25647-efac-42e7-8f68-5b99dc90c0ac,7641.19,debit,bank-fee,AU00000,2023-06-02T15:36:50Z
transaction,ff3390a6-3508-4ce3-bdf1-379c64e38453,posted,AGL RETAIL ENERGY LTD (GAS),-2730.72,cce150bf-01c3-4462-bc8a-8ff1da43a347,4910.47,debit,cash-withdrawal,AU00000,2023-07-13T16:36:40Z
transaction,6c5bd8f7-fdde-4055-a2a0-63e73246adcd,posted,Uber Ride,-664.26,03d26ae1-9b88-470b-86bd-7d8e7f6671b3,4246.21,debit,payment,AU00000,2024-01-05T21:19:53Z
transaction,f8278d52-f537-4404-978e-f42cd64415e5,posted,Home Improvement Store Purchase,-1451.8,e39b7e26-803d-474f-8003-0579dce531b2,2794.41,debit,bank-fee,AU00000,2023-09-19T17:12:28Z
transaction,5b1ba1ff-6785-4d6d-8585-7e7bfd380b13,posted,Car Maintenance Expense,-2909.09,d442d2dd-7ae0-4796-a236-05e3ecfb76cd,-114.68,debit,payment,AU00000,2024-03-05T04:25:54Z
transaction,dd5af6a7-8bfe-4a8e-ba83-13e3f5645596,posted,Restaurant Dinner,-3841.63,2738e835-1697-4f35-b4d1-8bfd4df618ac,-3956.31,debit,cash-withdrawal,AU00000,2023-08-08T11:55:16Z
transaction,e4caeae6-9ca6-4898-9068-30574382d952,posted,Netflix Subscription,-4290.99,4a9f7b65-d659-4607-9130-7ee459b1ece9,-8247.3,debit,cash-withdrawal,AU00000,2023-07-21T21:59:19Z
transaction,5e06d53c-d781-41b8-8bd5-0b23db41678b,posted,Manly Maths Tutor Wages,-1891.6,752ada6f-7eed-4f10-beb5-d2f3fa9288ab,15856.44,debit,bank-fee,AU00000,2024-04-06T23:53:03Z
transaction,3fe58ae5-6d7c-4185-849b-65f09d3bb0a4,posted,Restaurant Dinner,-1548.66,ecd4d58a-0e2c-486b-af0d-28d1ced82fbf,14307.78,debit,cash-withdrawal,AU00000,2023-08-07T20:01:01Z
transaction,5f923cd4-12c7-4609-8fc5-65c0276f051a,posted,Payroll WFRMS 15439393,11526.42,3ec462df-783f-4971-b14c-bdc85bde34cd,25834.2,credit,transfer,AU00000,2023-08-27T09:17:43Z
transaction,0831c72f-a4e2-40c4-aa51-227d8a849bc4,posted,Coffee Shop Purchase,-4950.3,9e9d3262-ee47-4139-af24-fd72feffac48,20883.9,debit,bank-fee,AU00000,2023-10-16T18:32:32Z
transaction,383dc426-5030-4e89-8cb8-ea811ea1b296,posted,Bookstore Purchase,-3694.87,27c8ad44-6568-4f5d-b4e0-1a592fed0147,17189.03,debit,cash-withdrawal,AU00000,2024-05-04T01:27:15Z
transaction,d8fdb6a4-5cb3-47e2-bb3a-f5e421eec4db,posted,Netflix Subscription,-37.81,4d03e0ad-d2ff-4582-bf4a-7c35a4ddd51e,17151.22,debit,payment,AU00000,2023-08-17T17:49:46Z
transaction,11f34b29-3e9e-4947-b34e-ab4516328c3f,posted,Non Hooli ATM Withdrawal Fee,-2680.5,ae74d34e-19dc-4138-81a0-75c8f7b65022,14470.72,debit,bank-fee,AU00000,2023-10-17T01:00:18Z
transaction,6fcbc918-c4c3-41e5-a0cb-1ae6eda9c420,posted,Home Improvement Store Purchase,-755.74,22b9be17-f204-4224-a2f1-caf011919697,13714.98,debit,bank-fee,AU00000,2024-02-21T09:38:49Z
transaction,85ee51db-6fe9-4460-811d-05d22befe551,posted,CTRLINK CARERS Ref: 998R6789201610974V,-3629.69,561c7d47-8165-4bd1-8f18-309eb620d97b,10085.29,debit,bank-fee,AU00000,2023-10-17T13:40:15Z
transaction,6785bac3-1367-4b7f-9691-2b2340c7ce56,posted,Hair Salon Appointment,-4981.76,b5f6b86e-528a-42b3-b05f-3d6208e9ff7a,5103.53,debit,payment,AU00000,2024-04-06T00:53:07Z
transaction,e521d2d6-7552-48d7-8851-2749cae308be,posted,CTRLINK CARERS Ref: 998R6789201610974V,-1328.48,2584d7a9-29db-43e3-8ccd-a844a667e148,13227.92,debit,bank-fee,AU00000,2023-06-09T06:47:38Z
transaction,644145c8-7da2-4b00-b748-e49fb41ab275,posted,Bookstore Purchase,-924.91,ad02582e-e6fa-4244-9ca4-33406d5fceb0,12303.01,debit,payment,AU00000,2024-01-17T13:25:24Z
transaction,632feedf-5a7f-4f9b-9263-e8e91d76741e,posted,Online Gaming Purchase,-3928.35,ca586725-d4c8-498f-baaf-31810c179d3c,8374.66,debit,cash-withdrawal,AU00000,2024-01-25T13:25:42Z
transaction,52bf1e41-c6a5-4f4b-969e-1aef43272ca1,posted,Netflix Subscription,-295.06,0420eb74-e0d3-4cb8-9d09-bd694d691602,8079.6,debit,cash-withdrawal,AU00000,2023-08-10T13:19:14Z
transaction,b49d1e44-bf95-41a5-84f1-fd4f97f5b79d,posted,Restaurant Dinner,-1269.97,00ebd6dc-be61-4c5d-af17-a103bd6c2b49,6809.63,debit,cash-withdrawal,AU00000,2023-08-21T07:47:15Z
transaction,bf93f3df-2e6e-4c5a-9f04-1142b9766d67,posted,Travel Agency Booking,-1318.84,07259ec0-3525-4cd7-bee4-840e7de3de70,5490.79,debit,bank-fee,AU00000,2024-03-09T13:38:13Z
transaction,6ee5c1d7-22b1-48ef-af59-a56b14ded386,posted,Home Improvement Store Purchase,-811.39,fafd1da0-cfa5-4813-b040-4702e9497b6a,4679.4,debit,bank-fee,AU00000,2023-09-27T07:37:21Z
transaction,4135e78b-2ec2-4144-a0fb-de958624573f,posted,Transfer Platnm Homeloan 346454,-4835.28,7cb5c616-6cec-407f-aa53-493681435ab2,-155.88,debit,cash-withdrawal,AU00000,2023-09-22T04:05:25Z
transaction,cf6dbfdf-96a4-4a6e-95ef-6dde7b3f0838,posted,TRANSFER TO JOANNA SMITH CAMPING,-1440.06,84b48bee-7ced-4d25-829c-47f2957f9e4a,-1595.94,debit,cash-withdrawal,AU00000,2023-10-05T15:37:29Z
transaction,7139d329-f885-4550-9cc8-3da4a47bbe9b,posted,Non Hooli ATM Withdrawal Fee,-4465.44,7347b951-5522-43c0-9ca3-dbe2adbd2ac3,-6061.38,debit,bank-fee,AU00000,2024-01-26T16:27:20Z
transaction,c7fdbf11-e6b3-4fb6-92c8-b18b0d36a83c,posted,Wdl ATM WESTPAC IGA BALGOWLAH BALGOWL AU,-2715.11,09eb5d33-0c26-4ed8-a1dd-dccf7fd30f16,5370.38,debit,bank-fee,AU00000,2023-11-08T19:49:26Z
transaction,7eccc760-2b5b-4e5e-b06a-7de7addb8eca,posted,Payroll WFRMS 15439393,11137.01,c93de9d8-0534-43ce-b00b-94fc68f7dfdc,16507.39,credit,transfer,AU00000,2023-07-23T02:00:29Z
transaction,d992499c-697f-4d31-b7a1-2dc5e686eb55,posted,Payroll WFRMS 15439393,10793.93,a0a78a03-f882-4ce3-8a05-9f214a40f781,27301.32,credit,transfer,AU00000,2024-02-13T03:25:37Z
transaction,cc404555-a5a1-4e09-937b-84e5309f7567,posted,Restaurant Dinner,-1713.81,eaf37df5-263d-42ea-b471-3fcf10f26f27,25587.51,debit,bank-fee,AU00000,2024-02-22T06:08:07Z
transaction,75af4382-5399-464e-ad26-76411d4cee9d,posted,Online Gaming Purchase,-4183.19,1dca3c39-9613-4b67-ac23-d58cd2c0795d,21404.32,debit,bank-fee,AU00000,2023-11-16T10:44:45Z
transaction,f8770176-e89e-4632-a960-1a5ffaa1eb2b,posted,AGL RETAIL ENERGY LTD (GAS),-3604.92,5665ff4e-b8cc-454e-8a28-688c0c785998,17799.4,debit,cash-withdrawal,AU00000,2023-11-30T17:13:36Z
transaction,e8d77672-9177-4af3-bdd8-56e62fac82d8,posted,Coffee Shop Purchase,-2431.83,09271cd2-7305-4351-a15e-5f7c26b43c3c,15367.57,debit,bank-fee,AU00000,2023-06-10T20:07:18Z
transaction,7432e163-a121-4bec-8c83-89ee5a8c0f19,posted,TRANSFER TO JOANNA SMITH CAMPING,-1177.69,01c1b55c-f3b6-4f94-9d2a-2db0951ede44,14189.88,debit,cash-withdrawal,AU00000,2024-04-17T17:38:27Z
transaction,42a2446f-90f8-42af-bd4c-bdff5e3f47db,posted,Restaurant Dinner,-2412.14,c25e9937-cc12-4e27-949c-237255afec51,11777.74,debit,bank-fee,AU00000,2024-02-11T11:29:44Z
transaction,59c7a24c-b50f-42c9-9ab3-4c8c95f1da30,posted,Mobile Phone Bill Payment,-2048.86,987a1ac0-3025-4249-8998-c59324dd07be,9728.88,debit,payment,AU00000,2024-03-17T08:48:05Z
transaction,5c29307e-8fea-4a8f-b6b6-fd452e703104,posted,Hair Salon Appointment,-3887.9,3d1e035e-07af-4d21-91a9-dd2e8ff8451d,15957.59,debit,bank-fee,AU00000,2023-06-16T21:51:02Z
transaction,438d0def-3cac-4504-ad96-5a1be442b4d9,posted,Amazon Online Shopping,-2488.21,33d29ad4-15cd-45ad-a5bd-d6634ed6e952,13469.38,debit,payment,AU00000,2023-07-27T18:13:21Z
transaction,010451c8-3ff1-41b7-b20b-d0131b0f42b7,posted,Restaurant Dinner,-4024.74,b614a538-9065-4cfb-8bba-80db67fa678a,9444.64,debit,payment,AU00000,2023-11-12T03:48:04Z
transaction,23e25430-17df-4b67-96c5-648a2a1cd0e7,posted,Coffee Shop Purchase,-406.61,942e343e-2877-4424-bd36-e3eae2453c85,9038.03,debit,payment,AU00000,2023-10-24T11:01:23Z
transaction,f5f321a0-9021-46ce-9f92-b5e60a0ae1b4,posted,Bookstore Purchase,-2319.13,c3c92cf7-2634-4585-8843-98fbf6d9ac83,6718.9,debit,bank-fee,AU00000,2023-06-24T09:04:10Z
transaction,ad08f1c1-6c24-449f-8485-df9adf6291c8,posted,Movie Ticket Purchase,-2682.93,e2ab7379-dd10-4c19-94fe-125d3bed7678,4035.97,debit,payment,AU00000,2023-06-04T05:37:41Z
transaction,de4434d2-a0db-41cf-a672-3c5c8d27e4fe,posted,Coffee Shop Purchase,-97.33,ad4d4a1e-4d67-4a63-9e14-a29955756473,3938.64,debit,bank-fee,AU00000,2023-05-21T01:13:29Z
transaction,da1ef772-c958-43b5-a725-d2c29b426519,posted,Travel Agency Booking,-4722.47,28cc5ff7-3df1-4816-9f1f-b33520c0fbed,-783.83,debit,cash-withdrawal,AU00000,2024-04-12T04:18:11Z
transaction,086b1da2-8ede-4da8-92de-55c6181accde,posted,Online Gaming Purchase,-1222.94,9c587c27-87e7-4073-9c9a-65f5b91a59be,-2006.77,debit,bank-fee,AU00000,2023-07-27T11:07:14Z
transaction,ce9f01b3-8ab6-4349-b7c2-3627c9dfb003,posted,Pharmacy Purchase,-3111.62,18b9014d-eeed-4360-87a5-c47ba170aa81,-5118.39,debit,payment,AU00000,2024-03-18T03:57:15Z
transaction,48b27286-317f-479c-9c96-81c8aaa64207,posted,Amazon Online Shopping,-3315.87,54d4926b-80fe-4691-83ec-1a97a3571c84,15977.41,debit,payment,AU00000,2023-09-12T11:15:42Z
transaction,8e631e67-864f-422e-9274-a20c7c9247e9,posted,Clothing Store Purchase,-2940.44,e9810c7b-96d3-44be-a6a2-344998aed0a2,13036.97,debit,payment,AU00000,2023-10-24T14:08:22Z
transaction,085f811e-dff0-4491-88a1-c6cd4a0c3deb,posted,Clothing Store Purchase,-278.39,777cbcb1-9e06-47d5-bc91-0fa625ad174a,12758.58,debit,cash-withdrawal,AU00000,2024-03-01T19:29:58Z
transaction,180fcfb6-988b-47b9-9c12-7117b11dbf17,posted,Mobile Phone Bill Payment,-2138.54,6b8e18fb-e020-48a8-b32c-f5154edb245d,10620.04,debit,cash-withdrawal,AU00000,2023-07-15T02:06:53Z
transaction,9c3ef260-b34d-41c9-8dee-1e943e7253b9,posted,Electricity Bill Payment,-4543.1,4c4fe609-a47a-4ef7-a476-73ca213919a0,6076.94,debit,cash-withdrawal,AU00000,2023-06-18T06:17:56Z
transaction,8ec8c953-c6c4-411f-ba13-ca472238111d,posted,Gym Membership Fee,-4003.53,df03ac57-98c9-4896-b728-5c66d567d61a,2073.41,debit,cash-withdrawal,AU00000,2023-07-14T18:22:37Z
transaction,d1f93f39-39b3-44f9-95bf-8eb3ef6e5e68,posted,Travel Agency Booking,-4334.01,70b40e65-3f9a-4df2-8042-e8818fc84a0e,-2260.6,debit,cash-withdrawal,AU00000,2024-02-01T01:30:13Z
transaction,965cb377-3a2e-4cd2-815a-ebd42cf45767,posted,Restaurant Dinner,-1148.44,09c94339-b0c6-42c5-8eac-e9c0dd94610d,-3409.04,debit,payment,AU00000,2023-10-22T01:21:39Z
transaction,4326b1c7-0173-4ffa-a100-d1d7479a0333,posted,Gym Membership Fee,-1606.48,e2893a64-b6e1-4592-acb2-9ed9df23ad51,-5015.52,debit,payment,AU00000,2023-07-17T12:58:21Z
transaction,1f8df11c-0801-4c6e-b03e-975ab8b95515,posted,Coffee Shop Purchase,-922.85,a5f9b889-3707-4faf-a6f1-5e44ae200bfc,-5938.37,debit,cash-withdrawal,AU00000,2023-11-10T10:21:11Z
transaction,c48d0d3f-75b3-4b0e-ad38-e36bbc633759,posted,Online Gaming Purchase,-3064.14,127df66d-1c24-48c6-aa6f-a18635fbbcec,14865.17,debit,bank-fee,AU00000,2023-10-17T07:37:04Z
transaction,606b235a-8f2c-44ec-a864-dd38d4e3d2f8,posted,Pharmacy Purchase,-3764.68,849e72b9-8569-41b1-923a-5464e2fd479c,11100.49,debit,bank-fee,AU00000,2024-01-28T05:41:07Z
transaction,d69abeb4-37ff-4fa9-aab0-3ee94fefa5c3,posted,Payroll WFRMS 15439393,10699.73,90d21274-04c6-417a-a9d8-8570bc64fadc,21800.22,credit,transfer,AU00000,2023-11-14T01:54:20Z
transaction,de531b4b-b9db-49f7-bba3-121b4cf52541,posted,Music Streaming Subscription,-1193.15,3c51db40-c743-4ec0-ba5e-6df5b9b7300f,20607.07,debit,bank-fee,AU00000,2023-09-19T14:06:19Z
transaction,2474e82e-5947-4582-8ebb-64ec42c6633a,posted,Bookstore Purchase,-2108.5,59c552cd-25bb-4c49-89d8-bb82833afc56,18498.57,debit,bank-fee,AU00000,2023-11-15T15:22:36Z
transaction,f7c336a9-bc59-4e83-8c50-0b771f433639,posted,Online Gaming Purchase,-2429.48,bd906a04-607a-4924-9865-72b72033bc9a,16069.09,debit,payment,AU00000,2023-10-22T12:43:09Z
transaction,cb51425a-dcd5-48f8-8b32-23fabc0cef7a,posted,Restaurant Dinner,-2199.16,c84c77c0-9a18-4abb-bc95-b86031a619fd,13869.93,debit,bank-fee,AU00000,2023-08-24T09:30:52Z
transaction,50c5f6fe-481f-4a90-8e5d-947737fd0bc7,posted,AGL RETAIL ENERGY LTD (GAS),-2588.46,6cd1154b-0afb-40fe-bf9b-76eae187ff68,11281.47,debit,cash-withdrawal,AU00000,2023-08-20T15:23:07Z
transaction,e0e681b0-37ac-458b-b853-e876612687cd,posted,Car Maintenance Expense,-2254.46,245fd161-ce34-4ab2-91e5-d9a8f3323266,9027.01,debit,payment,AU00000,2023-08-28T02:47:45Z
transaction,cf1edf64-ea7c-4c10-91de-782e10a79186,posted,Bookstore Purchase,-4019.54,a683a474-a3df-401a-92bf-248f5803c33f,5007.47,debit,bank-fee,AU00000,2024-02-11T01:44:44Z
transaction,14fdea4b-3088-4bd6-8e10-39725a4ef365,posted,Non Hooli ATM Withdrawal Fee,-4397.96,dbfe816e-b78a-42b0-b0dc-381a616b74e1,1138.05,debit,bank-fee,AU00000,2023-12-20T17:10:24Z
transaction,f46a4e68-6709-406b-bf81-cc2587829274,posted,Movie Ticket Purchase,-4394.52,9a442a4f-1b27-4894-9401-019b188f0ea7,-3256.47,debit,cash-withdrawal,AU00000,2023-11-22T01:49:11Z
transaction,90deba40-7068-4004-bfc8-adb25f5ced6f,posted,Home Improvement Store Purchase,-4781.68,5cdfd3e6-83da-4bad-b118-da181306037d,-8038.15,debit,bank-fee,AU00000,2023-09-13T10:15:04Z
transaction,4f82b424-d92e-4c45-9c35-da703c6eba57,posted,Music Streaming Subscription,-283.97,25bc063b-925a-4169-aa03-5b421ea580db,-8322.12,debit,cash-withdrawal,AU00000,2023-08-29T16:00:44Z
transaction,49c84cc8-e6e0-4179-8437-82486634f367,posted,Travel Agency Booking,-126.05,0844d543-5628-46fd-a900-741a9d0c5d1e,-8448.17,debit,payment,AU00000,2023-08-18T23:15:55Z
transaction,f5ab34c6-e5bf-480b-b682-de3cc7c82d44,posted,Transfer Platnm Homeloan 346454,-823.52,54461b9f-1e9e-4f06-b7f3-a839b411b2a2,-9271.69,debit,bank-fee,AU00000,2024-02-04T02:22:04Z
transaction,33a50d58-3109-4573-9594-2362b9892f8e,posted,Non Hooli ATM Withdrawal Fee,-2194.51,2247df23-2277-4310-892e-1bc6d369045d,-11466.2,debit,payment,AU00000,2024-01-14T18:38:58Z
transaction,eaac9d14-84f1-49f8-9d17-14c899ffc3c5,posted,Gasoline Purchase,-3099.93,565f126d-1601-4222-a0fe-0a04fe598a31,-14566.13,debit,bank-fee,AU00000,2023-09-13T01:44:48Z
transaction,d632699b-0441-4f17-958a-a390a0d238b2,posted,Transfer Platnm Homeloan 346454,-2382.08,4b3aa3f7-3a89-4074-a17c-e6d952d34541,-16948.21,debit,payment,AU00000,2023-09-01T02:32:46Z
transaction,94f8e514-d0c7-495a-8889-085f86dd4d3c,posted,Amazon Online Shopping,-2779.32,259b3eef-7cad-4ad8-9d84-e4dfe14468ce,-19727.53,debit,cash-withdrawal,AU00000,2023-10-15T21:16:50Z
transaction,0dcc92c8-d2ce-473c-b3fc-922add4c0a4a,posted,Payroll WFRMS 15439393,10474.43,2b8ec401-e700-4413-aa3f-4671dc28253e,21497.26,credit,transfer,AU00000,2023-12-25T08:53:27Z
transaction,45b9d766-ec2d-4807-be55-cd5d702691d7,posted,Transfer Platnm Homeloan 346454,-2335.15,4be2fd7a-7b3e-4ac1-9fef-ffadb1b93608,19162.11,debit,cash-withdrawal,AU00000,2023-07-12T20:59:39Z
transaction,06ac7872-482c-4174-a1e0-1aeb7556a0c5,posted,Online Gaming Purchase,-3728.45,4d826de9-f8fa-4b3b-9595-4ea8353db583,15433.66,debit,cash-withdrawal,AU00000,2024-04-24T21:10:42Z
transaction,ac156381-aabc-4579-8d81-b77b015a495a,posted,Manly Maths Tutor Wages,-2779.63,9f9fa520-4f31-4f5a-b4b5-261d0ff6322c,12654.03,debit,cash-withdrawal,AU00000,2023-10-20T05:01:07Z
transaction,8a8d47e8-13f7-4e40-9d2f-5dd89e4d587c,posted,Mobile Phone Bill Payment,-2585.32,2e024724-a4f2-4bba-b609-9c7d2545169e,10068.71,debit,bank-fee,AU00000,2023-11-14T12:51:49Z
transaction,04d49664-36c1-4d9b-9278-2b355da2d049,posted,Car Maintenance Expense,-3599.49,f3658e5c-35b1-4b39-8cea-0abf367314a4,6469.22,debit,cash-withdrawal,AU00000,2024-05-05T11:05:03Z
transaction,8da2f1d8-42bd-4bca-97c1-0ff201961082,posted,Coffee Shop Purchase,-4558.69,6e6201d8-d7fe-4611-88d2-bd30280f4748,1910.53,debit,payment,AU00000,2023-06-08T18:04:02Z
transaction,afe8b3fe-6a76-4777-8565-053dca9f00ec,posted,Travel Agency Booking,-3766.69,1f0e6b09-8ac2-4cba-8014-3c7d30b8c349,-1856.16,debit,bank-fee,AU00000,2023-08-25T16:42:06Z
transaction,00ca9a92-1829-4201-b213-3c0b03287604,posted,Pharmacy Purchase,-2380.45,84500916-c635-4a4b-8334-3f88cc76e1ab,-4236.61,debit,cash-withdrawal,AU00000,2024-02-06T02:09:52Z
transaction,6e2bd90e-de6f-4031-a058-278d393df8d6,posted,Online Gaming Purchase,-999.65,a5d57063-b16e-4b8e-8a1c-942c27135f21,-5236.26,debit,cash-withdrawal,AU00000,2023-12-03T01:28:13Z
transaction,f85b2871-2546-4df1-bbc9-09b3c18dd13d,posted,Uber Ride,-962.0,4bac43a7-4374-4c2a-aebc-44c15058237c,7786.44,debit,bank-fee,AU00000,2023-10-18T15:42:16Z
transaction,1515ced6-5ed0-4c80-a04a-1af81e53d75e,posted,Restaurant Dinner,-3845.83,0c7ac4a1-f74d-4a45-b1fb-1d670a5d2054,3940.61,debit,payment,AU00000,2024-02-01T16:59:04Z
transaction,c22a3db8-e386-4bc1-846c-d77c3f1fa02f,posted,Electricity Bill Payment,-4437.84,38efd9f7-151f-4bee-b9ef-1440075193ed,-497.23,debit,bank-fee,AU00000,2024-03-04T09:33:12Z
transaction,23ea48c1-8784-40a4-81cb-6b89ab765160,posted,AGL RETAIL ENERGY LTD (GAS),-2707.4,166278e7-15d9-47b3-846f-6e7238269f3e,-3204.63,debit,cash-withdrawal,AU00000,2024-01-20T00:23:16Z
transaction,3174de74-c62d-4df6-b98e-c6d62e54c49e,posted,AGL RETAIL ENERGY LTD (GAS),-2453.25,0f8dfa85-a40d-41d6-9e68-4a59395d8563,-5657.88,debit,payment,AU00000,2024-02-01T08:42:14Z
transaction,ebc4b036-7f1f-4a64-aef9-2b05659d678d,posted,Non Hooli ATM Withdrawal Fee,-3352.9,8508a61d-44e7-4613-90a2-b80eed3c6b95,-9010.78,debit,payment,AU00000,2023-06-16T13:50:20Z
transaction,2619c378-8fc2-4516-9c7e-db363df169d6,posted,Clothing Store Purchase,-2409.64,503e345b-a0cc-4ae1-9c97-0dbe9196df39,-11420.42,debit,cash-withdrawal,AU00000,2023-05-30T06:23:54Z
transaction,e8d6e1f0-8414-4871-86c8-dbc1b0e2040c,posted,Amazon Online Shopping,-3598.84,78d42d48-b928-4cd5-893d-0f4e97581c88,-15019.26,debit,payment,AU00000,2023-05-25T13:54:14Z
transaction,89609cb1-2af8-428b-b638-ae25d7ac0175,posted,Non Hooli ATM Withdrawal Fee,-4967.56,3933d2cd-9abc-41d6-901a-4d4b113db654,-19986.82,debit,payment,AU00000,2023-05-18T19:44:24Z
transaction,9de5bfd0-736d-4b1d-9830-17488ea9ce2f,posted,Electricity Bill Payment,-3980.56,4f05761c-35ec-40a0-bae8-11f6a74fdc55,-23967.38,debit,cash-withdrawal,AU00000,2023-11-03T20:56:25Z
transaction,919b01f8-97a8-4695-87d9-2132c9015620,posted,Bookstore Purchase,-4691.15,c473b6fa-40c3-4d99-bfcb-3cc272685ab6,7160.84,debit,cash-withdrawal,AU00000,2023-10-06T02:50:16Z
transaction,5aa45c6e-27fa-417b-9e73-c03dc0dcb208,posted,Wdl ATM WESTPAC IGA BALGOWLAH BALGOWL AU,-4284.45,25c07e70-e1c5-4b67-8e37-bd17d20fa7da,2876.39,debit,payment,AU00000,2023-08-22T10:29:44Z
transaction,aded9668-a30a-4a4e-9882-b2f7669e0e42,posted,Gasoline Purchase,-3755.98,68cd3d47-abf4-430a-b5fb-5d0589ff04f2,-879.59,debit,payment,AU00000,2023-05-14T16:33:48Z
transaction,f1ce89d0-96fe-4ab3-b030-0a407d895762,posted,Coffee Shop Purchase,-2545.97,c67f8baf-09b8-4e6c-84c8-46967c1e7f4b,-3425.56,debit,payment,AU00000,2024-02-17T09:47:48Z
transaction,6bf9cc86-ba01-4f77-9945-e6fefec43188,posted,Clothing Store Purchase,-4719.64,7638e7e6-49f1-43e6-9814-7a0cf2b83cf2,-8145.2,debit,payment,AU00000,2023-09-08T04:48:31Z
transaction,a9898545-0295-4615-b00c-1fc48e1d4b77,posted,Hair Salon Appointment,-409.34,52159876-9a90-4328-bf4f-8ed667b331fe,-8554.54,debit,bank-fee,AU00000,2023-07-02T12:19:16Z
transaction,0627d393-58cc-4e2c-82ca-f49156e4aec6,posted,Manly Maths Tutor Wages,-4798.5,272847c8-3174-411f-ba96-628d85742783,-13353.04,debit,bank-fee,AU00000,2023-08-24T18:00:12Z
transaction,de69b78b-e4dc-47d6-b27e-68e5f0965f26,posted,Transfer Platnm Homeloan 346454,-1459.02,45656282-d5ef-4da6-a09f-7cbc2453109a,-14812.06,debit,cash-withdrawal,AU00000,2023-08-28T17:13:20Z
transaction,bf65985b-28a5-4f99-a24f-16163b8d962c,posted,Mobile Phone Bill Payment,-1886.94,13396eb1-c683-4031-adb5-81d523203f62,-16699.0,debit,bank-fee,AU00000,2024-04-26T03:09:18Z
transaction,48f3a5f7-6274-4305-85ee-58b06233dbd7,posted,Pharmacy Purchase,-2335.68,0a309567-d168-47f0-9eff-56b347eb2662,-19034.68,debit,payment,AU00000,2024-03-01T15:33:58Z
transaction,31b754ec-274a-4c86-a283-2173ccfe8603,posted,Non Hooli ATM Withdrawal Fee,-957.98,c0d5613c-08e1-4038-aaa4-e9d1b4a4673e,18676.16,debit,cash-withdrawal,AU00000,2024-02-07T13:32:05Z
transaction,401cd3d2-84d6-4f59-9546-247eb56f6a4d,posted,Public Transport Fare,-2374.34,79797d33-b9ba-41cf-8c3d-6e564928ea2f,16301.82,debit,cash-withdrawal,AU00000,2023-06-01T06:31:23Z
transaction,bad49e50-7d94-412e-a9eb-ce4598e9e52a,posted,Online Gaming Purchase,-1331.62,f7e571b9-2b36-4e87-9dd4-eff24dab8945,14970.2,debit,payment,AU00000,2023-06-10T15:25:53Z
transaction,053498dc-12ac-4e1c-a80c-1523050a6330,posted,Gym Membership Fee,-730.09,fccb486c-39ed-4547-adb5-855db2ed7cec,14240.11,debit,bank-fee,AU00000,2023-06-21T13:16:55Z
transaction,79259d72-8b59-4bd6-a16d-c63130ddd046,posted,Travel Agency Booking,-3635.12,e4eaf4ce-d28c-433d-91e1-73359aa003c2,10604.99,debit,payment,AU00000,2024-03-28T15:02:55Z
transaction,3d587347-cb79-4362-b7a8-d9c8b449cd25,posted,Electricity Bill Payment,-1402.21,b6eb1a8f-3517-4a2a-904f-93b6c495ff46,9202.78,debit,bank-fee,AU00000,2023-11-10T16:31:30Z
transaction,3057dd30-486d-402f-9c56-9d9d1fcbe98b,posted,CTRLINK CARERS Ref: 998R6789201610974V,-4555.12,c53d8822-22be-4f1a-98d1-8fe60df77005,4647.66,debit,bank-fee,AU00000,2024-04-25T10:34:12Z
transaction,3d5a28bd-0c79-4751-b93c-a321f40d4344,posted,Pharmacy Purchase,-2018.85,93b3fdd3-4d19-4677-a398-6c79c3bcdc62,2628.81,debit,cash-withdrawal,AU00000,2024-03-02T17:43:51Z
transaction,7b647a31-2ece-4538-ae6c-c7adcbb21a87,posted,Manly Maths Tutor Wages,-3212.45,5561020a-e1e0-46bd-9be2-2739f12c5fa8,-583.64,debit,bank-fee,AU00000,2023-07-14T02:50:39Z
transaction,3cbda742-4b3a-46f3-bc89-77f3e0954e3b,posted,Wdl ATM WESTPAC IGA BALGOWLAH BALGOWL AU,-4312.57,aa853e6e-d1af-4be0-a714-abb6582e4ca2,-4896.21,debit,bank-fee,AU00000,2023-07-01T12:14:09Z
transaction,1f467bf4-18fa-4384-b94f-8163c2e8de3a,posted,Bookstore Purchase,-183.39,c22d1228-084a-4a40-b2cb-19e2f4737393,8669.38,debit,bank-fee,AU00000,2023-07-21T00:37:21Z
transaction,14a03a40-53c4-4de1-9c0f-8b22ab971cff,posted,Clothing Store Purchase,-393.71,5182b926-68b7-473c-b1af-2ca7602e4964,8275.67,debit,cash-withdrawal,AU00000,2023-07-03T14:23:36Z
transaction,141b06ae-6b7b-408a-be84-4db71c5b43ba,posted,Bookstore Purchase,-4541.53,d970591d-e886-45da-b32c-18449ee450dc,3734.14,debit,bank-fee,AU00000,2024-03-16T19:39:15Z
transaction,9ef35d8c-b6af-4fd4-a6a7-61177404082a,posted,Netflix Subscription,-4919.14,dc034599-d7de-4187-9895-ab9280eaeebf,-1185.0,debit,bank-fee,AU00000,2023-10-02T12:38:09Z
transaction,6e49a8d8-21b0-4c31-aa53-c4e4cd8b6e3f,posted,Car Maintenance Expense,-457.5,4f76e555-74ea-42fc-8564-4f4dcf9ae2a3,-1642.5,debit,payment,AU00000,2024-04-22T01:35:17Z
transaction,b6b72a57-7ca3-416d-b12a-edcbda6a8fd7,posted,Transfer Platnm Homeloan 346454,-2302.64,7c544a37-0f0d-4b32-9421-89302f59bac4,-3945.14,debit,cash-withdrawal,AU00000,2023-06-16T07:22:27Z
transaction,9d5ccd09-1405-4e0e-94dd-d8ccf64df14e,posted,Movie Ticket Purchase,-1666.19,ba736a32-2a3e-4b04-9a72-34cc1c5e55d5,-5611.33,debit,bank-fee,AU00000,2023-05-14T12:24:49Z
transaction,c7b8e495-55aa-463f-9b9a-897d18b36d00,posted,Mobile Phone Bill Payment,-2781.01,72ed195a-ba89-405a-8998-1fb6017efa68,-8392.34,debit,payment,AU00000,2024-05-06T23:39:35Z
transaction,df118c7d-0b6e-4ae0-b05d-3d7cac2fa3d5,posted,Hair Salon Appointment,-2661.06,aa51cfc9-9fca-40a4-adac-229562958769,-11053.4,debit,bank-fee,AU00000,2024-01-19T11:57:35Z
transaction,80c1c06d-51aa-4709-9c2c-f0eb326a2594,posted,TRANSFER TO JOANNA SMITH CAMPING,-2134.71,15847d7a-4bae-4263-bbe9-7633badb1eb9,-13188.11,debit,cash-withdrawal,AU00000,2024-03-20T00:00:01Z
transaction,7b1a60be-6a3e-4a93-85fe-0bb6a2a1bb24,posted,Bookstore Purchase,-2334.28,f0580a5d-5f78-4127-b2fa-397762cf6537,4389.02,debit,bank-fee,AU00000,2023-11-09T13:01:22Z
transaction,e8542d39-5e69-4447-be18-8861022a3776,posted,Pharmacy Purchase,-3325.23,8fa8d7f5-67d8-4c3f-9c9a-4b19979dba48,1063.79,debit,bank-fee,AU00000,2024-03-15T19:49:26Z
transaction,4d227df5-d855-4fe8-804b-f1467c9ae8f2,posted,Non Hooli ATM Withdrawal Fee,-4222.18,1b7da57a-73d5-415f-bb50-80e9c3e7ebc4,-3158.39,debit,cash-withdrawal,AU00000,2023-08-19T13:07:41Z
transaction,5c421798-7c47-4e65-ad1c-0412539d78be,posted,Movie Ticket Purchase,-4354.6,5c4b86b3-df19-4e3f-ad5d-4f29c20c8098,-7512.99,debit,bank-fee,AU00000,2023-06-21T19:33:35Z
transaction,86a54204-1285-479e-9706-fd8ac0deb852,posted,Gasoline Purchase,-2791.42,a6b3dc52-705b-48a8-9bf0-3344138b636a,-10304.41,debit,payment,AU00000,2024-01-08T09:35:53Z
transaction,0fa36dcb-7de0-4c51-a0d0-1297503f5806,posted,Gasoline Purchase,-2566.1,46db9bd1-ab0f-4ff3-9e01-3199cdf7a89f,-12870.51,debit,bank-fee,AU00000,2024-01-01T14:21:34Z
transaction,7c40dd6c-24b1-4558-9b20-50b4e1ba790a,posted,Car Maintenance Expense,-2366.18,39adba6d-cabb-45b9-9cde-834b945ec7e7,-15236.69,debit,payment,AU00000,2024-02-13T06:15:02Z
transaction,81c02dd9-c9e2-4ad7-bda3-c77610b2fc0a,posted,Online Gaming Purchase,-1800.79,20985361-b5c7-422b-a6ee-769336e065b0,-17037.48,debit,bank-fee,AU00000,2023-09-09T01:05:26Z
transaction,62ddd176-f430-41f3-bae1-e697d257c8d8,posted,Uber Ride,-33.27,2e695701-04af-4d6b-b6ca-e0c7e5c43556,-17070.75,debit,bank-fee,AU00000,2023-10-07T15:41:59Z
transaction,e2be5356-43ec-46af-8f32-4360ef9fc000,posted,TRANSFER TO JOANNA SMITH CAMPING,-576.24,15f10a77-fae2-42ce-abb1-da2e71da37f4,-17646.99,debit,cash-withdrawal,AU00000,2023-06-12T23:35:08Z
transaction,a021bc2b-4bdc-41c8-bb8e-d8e62347cad0,posted,Pharmacy Purchase,-4093.53,13d776fe-a39c-4740-b60d-d011aa8d1847,11974.69,debit,payment,AU00000,2023-09-24T07:48:16Z
transaction,308e5316-7f1d-4a3d-90a6-85a5475ab9a0,posted,Clothing Store Purchase,-4566.81,ac14c810-8e1d-4d88-9e1a-68587acfd720,7407.88,debit,payment,AU00000,2024-05-02T21:32:06Z
transaction,9ccf33ab-91f2-4925-9948-7dd1db164e6e,posted,Electricity Bill Payment,-3047.9,75d3ef2f-2059-49a8-ac32-dde590b33816,4359.98,debit,payment,AU00000,2023-08-02T18:27:48Z
transaction,2c9b0fae-3962-4ca7-b910-a61a2c7d6306,posted,Wdl ATM WESTPAC IGA BALGOWLAH BALGOWL AU,-2600.41,03fb2c03-07e0-4aac-99b0-885dd20fa5c2,1759.57,debit,bank-fee,AU00000,2023-12-21T22:01:25Z
transaction,1dfdcea9-3835-4a32-81f0-83500a757e1f,posted,Public Transport Fare,-2.57,31ac29b8-7fcc-4382-90e7-f39c00e764b6,1757.0,debit,cash-withdrawal,AU00000,2024-03-08T22:18:03Z
transaction,92a2d01e-dc4e-4467-8013-21bdbaff5d62,posted,Pharmacy Purchase,-4026.53,c20a7a4e-f0c7-41fb-beb1-d78914e8a7d1,-2269.53,debit,payment,AU00000,2024-03-18T14:32:46Z
transaction,59742518-c7cb-4671-b933-0fb8218d29ee,posted,Pharmacy Purchase,-1763.04,0a4cab5f-d7c5-4803-8504-3c72f365993b,-4032.57,debit,bank-fee,AU00000,2023-11-11T11:10:01Z
transaction,421df326-bd0f-40a0-9c34-1c2d377cac4e,posted,Mobile Phone Bill Payment,-4271.87,54f343d8-c190-4719-9a3b-9d30af141856,-8304.44,debit,payment,AU00000,2024-04-11T08:17:46Z
transaction,38205f74-801d-4d97-96af-354ee8dd1b51,posted,Mobile Phone Bill Payment,-3970.92,c567d4b4-5935-4c72-88b3-a541eb43db16,-12275.36,debit,bank-fee,AU00000,2023-10-02T10:37:58Z
transaction,ba4cfae4-6920-4e0a-8ce8-c53ebf5e90e1,posted,Restaurant Dinner,-2341.45,5676f611-52db-4784-83f9-6790f4e02639,-14616.81,debit,cash-withdrawal,AU00000,2024-01-19T00:40:12Z
transaction,751fd5e9-f0a0-45d0-a785-0ffc54a8a21e,posted,Music Streaming Subscription,-1815.83,5bd5d70b-538a-4dc7-b721-1a45562880fc,10913.02,debit,payment,AU00000,2023-10-07T16:59:35Z
transaction,450d8359-edae-47a9-b604-5e89fb7fd1ee,posted,Non Hooli ATM Withdrawal Fee,-4575.72,cd7ee71f-4306-46fe-afb0-c669187e0863,6337.3,debit,payment,AU00000,2023-07-09T06:46:40Z
transaction,da614455-2a8f-428c-9c4c-4f99966f5cd2,posted,Gym Membership Fee,-4011.1,7da502b6-45f8-44d6-936d-348b6724e930,2326.2,debit,cash-withdrawal,AU00000,2024-02-20T00:00:46Z
transaction,64854e1a-63b6-4880-9d69-2cd84243db9f,posted,TFR Acc14000 TO 12389,-13.68,3649b7de-e2dd-4299-9f93-b9ddbee9bcbf,2312.52,debit,cash-withdrawal,AU00000,2023-05-22T18:12:07Z
transaction,8f2dad97-bc75-4bc7-a74d-2f7df63fc94d,posted,Non Hooli ATM Withdrawal Fee,-65.69,5d05d7ee-5e60-41f0-a2ae-c039a76eba3e,2246.83,debit,payment,AU00000,2023-08-07T18:06:49Z
transaction,3f73e73d-ca76-49b7-a06a-36e7faaaf013,posted,Transfer Platnm Homeloan 346454,-1051.97,a35a4743-1789-4aea-81b9-f98e3d76af9c,1194.86,debit,bank-fee,AU00000,2023-05-20T09:55:20Z
transaction,0a710f5f-d2ee-404d-9198-222755d2d03c,posted,Home Improvement Store Purchase,-392.78,d210de14-b892-4f5e-911e-d055162f4d11,802.08,debit,cash-withdrawal,AU00000,2023-12-22T14:52:38Z
transaction,513fa7c0-f3c1-4190-887f-3e7719e509a8,posted,Amazon Online Shopping,-1631.59,4aa059d4-fdef-448b-bc78-0279c1059120,-829.51,debit,bank-fee,AU00000,2024-04-07T19:30:21Z
transaction,2f453e4a-981c-4919-a690-f6d6ea359687,posted,Car Maintenance Expense,-421.47,64975abf-2afa-4b75-b356-c208705c60f9,-1250.98,debit,bank-fee,AU00000,2023-09-03T14:25:33Z
transaction,c7d0588f-9061-4b2c-8ffe-0406c524355e,posted,Pharmacy Purchase,-1860.42,07873416-8b05-4407-a1d9-917897a0148c,-3111.4,debit,cash-withdrawal,AU00000,2023-09-09T17:50:31Z
transaction,b9fb9cbb-f289-408a-bf21-5a4ea86d4edb,posted,Pharmacy Purchase,-1627.82,64ee8759-d689-489c-8840-e9f6fe2dd818,12827.47,debit,cash-withdrawal,AU00000,2023-07-30T00:58:27Z
transaction,910519de-876e-4441-975b-db2c76052ce3,posted,TFR Acc14000 TO 12389,-2456.36,b6c3ca47-6ef2-4437-a118-f5c77b7045fd,10371.11,debit,bank-fee,AU00000,2024-01-14T01:18:19Z
transaction,e9cef68d-833b-4815-85fe-f28ed5cc4240,posted,Bookstore Purchase,-2018.22,c15d3426-61ec-4183-bea9-265a44386431,8352.89,debit,payment,AU00000,2023-08-24T18:26:55Z
transaction,0d321bb9-ea89-48c8-a57c-dcb1f1c679de,posted,Music Streaming Subscription,-988.11,0aaf8805-a396-4437-ac75-5b238dcc26e4,7364.78,debit,cash-withdrawal,AU00000,2024-03-04T03:15:29Z
transaction,728fbabe-8f06-4fad-9d91-e526cfa9018f,posted,Bookstore Purchase,-1158.6,728491f5-6826-43f2-9e74-4719d818c078,6206.18,debit,payment,AU00000,2024-04-03T15:56:30Z
transaction,1f534045-a575-4a30-a9c9-3c4243d59813,posted,Restaurant Dinner,-729.32,c12c9487-6eda-4fd1-8cd7-52421fb6b97a,5476.86,debit,payment,AU00000,2023-09-17T07:29:35Z
transaction,090d24eb-764c-4585-8486-b061450bc5c1,posted,TFR Acc14000 TO 12389,-737.86,4500a4d8-6946-4e9c-8ba5-121bfa5c4942,4739.0,debit,cash-withdrawal,AU00000,2024-03-18T22:42:20Z
transaction,9172268f-ad81-4e84-9837-0ee2ed00fc35,posted,TRANSFER TO JOANNA SMITH CAMPING,-3558.21,0d9abb34-fffc-4ab5-8a5e-ebe51181f1bd,1180.79,debit,cash-withdrawal,AU00000,2023-07-03T07:31:01Z
transaction,9344fef1-8baf-47ee-b855-a64d18088416,posted,Mobile Phone Bill Payment,-2449.59,c22add44-c91d-4da0-be5d-6098ab56e51c,-1268.8,debit,cash-withdrawal,AU00000,2023-09-02T19:02:34Z
transaction,95129bd2-a5db-422b-a96c-ddbe9c3c3296,posted,Mobile Phone Bill Payment,-3453.19,74c8b4d5-5927-4c5d-b7a7-cb7fbded2e52,-4721.99,debit,payment,AU00000,2024-03-21T20:02:33Z
transaction,267e9d7c-f049-4ae0-99fc-494be409424b,posted,Car Maintenance Expense,-4116.4,87818d64-0398-4bc2-a9e8-562fd668a4ad,5501.23,debit,payment,AU00000,2023-08-26T19:50:31Z
transaction,99449687-9d34-43f5-b9f0-d796f1dc8262,posted,Online Gaming Purchase,-2909.77,aca4353d-71e3-49f3-8bde-212918e93ca2,2591.46,debit,cash-withdrawal,AU00000,2024-04-09T09:07:02Z
transaction,71f76047-cd49-4b9e-ae3d-fe7767f669de,posted,Gasoline Purchase,-2166.11,a68fcba0-1c06-40f0-ad60-8425601ddcf0,425.35,debit,bank-fee,AU00000,2023-11-12T00:21:29Z
transaction,0e8b9677-b984-46a8-b323-a85a90e63570,posted,Restaurant Dinner,-2781.24,4563173e-797b-46b9-bc7f-05291d044358,-2355.89,debit,payment,AU00000,2023-08-07T01:24:46Z
transaction,89fcd8bf-896d-40e9-9a9c-1903030e5796,posted,Payroll WFRMS 15439393,10144.86,23f26328-046d-42df-b642-54c6fbc6ab47,7788.97,credit,transfer,AU00000,2024-04-08T12:00:03Z
transaction,e6c4280e-c5e2-4e22-9f7a-94d7595eecad,posted,Public Transport Fare,-3735.12,ae889b32-d5dd-4e06-b711-4b5237d18882,4053.85,debit,payment,AU00000,2023-10-27T07:45:47Z
transaction,6579ab10-4ddb-41db-97ab-98a532f0579b,posted,Hair Salon Appointment,-2612.66,142607f1-fc9e-49be-822c-5341a69da08c,1441.19,debit,cash-withdrawal,AU00000,2023-06-05T17:42:12Z
transaction,8a43cf93-c1b8-47fe-be0f-748a5bbfc642,posted,Coffee Shop Purchase,-178.43,ac9b9ab5-56ad-4ead-ace8-a1fe6dd2d566,1262.76,debit,bank-fee,AU00000,2023-06-07T19:00:55Z
transaction,a20119c8-bf8c-4372-bb8b-590203b85829,posted,Netflix Subscription,-2612.37,2dfb1dff-b9c9-40ef-ad13-9feef1e7de73,-1349.61,debit,payment,AU00000,2024-03-11T02:27:28Z
transaction,53578b72-d350-4e8e-a775-f4a9e1794048,posted,Restaurant Dinner,-1507.97,94896b46-8f91-4957-943b-793d336d3363,-2857.58,debit,cash-withdrawal,AU00000,2023-11-27T02:51:23Z
transaction,460c6692-669c-4cb5-9d34-dcf6190c45f7,posted,Payroll WFRMS 15439393,11525.67,62ef1fd1-7501-4ea1-8874-b1236dd9eb51,22765.53,credit,transfer,AU00000,2023-11-11T02:40:12Z
transaction,65c38435-35bc-48e0-b31f-8638a25bf0bb,posted,CTRLINK CARERS Ref: 998R6789201610974V,-4251.29,e99160fd-a35d-4eb8-b192-65ef578c75b6,18514.24,debit,cash-withdrawal,AU00000,2024-02-11T22:09:46Z
transaction,863aefc6-ca44-440f-b76b-dabc9eb97d15,posted,Gasoline Purchase,-3960.78,e43d89ef-402c-4611-9882-e01ea7f9f91c,14553.46,debit,cash-withdrawal,AU00000,2024-04-05T21:27:18Z
transaction,83c6192a-fd32-49a7-b5e7-bc60f89b0a51,posted,Mobile Phone Bill Payment,-4872.64,aa9fe080-78b0-422c-9dff-d6ff2ec5c79e,9680.82,debit,cash-withdrawal,AU00000,2023-10-31T17:35:57Z
transaction,8e7fa557-a540-433e-ba5a-17b35f9c637f,posted,Pharmacy Purchase,-757.58,fa5bc9b0-0c3b-42d4-923f-17824eff3b25,8923.24,debit,payment,AU00000,2024-04-23T01:28:18Z
transaction,a4d91b02-c2b1-4e79-982f-d1230c29b69c,posted,Amazon Online Shopping,-3043.7,97169b2d-80a4-4ef0-b576-639a2f7531eb,5879.54,debit,cash-withdrawal,AU00000,2024-02-07T22:23:13Z
transaction,eef09a33-ede5-4934-abe8-a72215e1fa56,posted,Pharmacy Purchase,-4578.28,37b5f960-ecde-481a-9117-e80fbb9795e9,1301.26,debit,payment,AU00000,2024-01-30T18:15:07Z
transaction,29b3d044-8d51-4b91-9f64-ce32ddab955b,posted,AGL RETAIL ENERGY LTD (GAS),-4030.26,8b42879d-3ae6-4452-918b-f2fdf84de630,-2729.0,debit,cash-withdrawal,AU00000,2023-05-15T10:32:16Z
transaction,d9e4a787-d89c-4b59-be98-d12544342de3,posted,Wdl ATM WESTPAC IGA BALGOWLAH BALGOWL AU,-3953.19,dd8013ac-ec31-4361-962b-03049789df9d,-6682.19,debit,cash-withdrawal,AU00000,2024-02-01T15:53:08Z
transaction,95cf53f1-5832-4fb6-9757-55c97c790d22,posted,Online Gaming Purchase,-2028.93,c194a6ea-15a1-49f8-b949-15a56055d0ec,-8711.12,debit,cash-withdrawal,AU00000,2024-03-18T17:15:26Z
transaction,2a984793-3909-4331-8973-90c226d066eb,posted,Clothing Store Purchase,-3767.4,b60be8ce-95ef-457e-be9d-a8306a318ff2,12483.57,debit,bank-fee,AU00000,2024-01-12T04:25:15Z
transaction,bfa12910-94ad-46d8-89b0-05a6fddf61db,posted,Travel Agency Booking,-2825.82,bf918d26-e878-4bdb-91c1-f32c2074250a,9657.75,debit,payment,AU00000,2024-03-23T00:05:37Z
transaction,df0ad41c-2c32-4e41-9cd7-948f88c4b4a2,posted,Netflix Subscription,-1010.56,d1adbdfc-c522-4de3-b1fc-bcd8e61f597a,8647.19,debit,bank-fee,AU00000,2023-08-10T13:17:43Z
transaction,63c2028a-8b64-40cc-8393-d1b4c7643c35,posted,Electricity Bill Payment,-1520.78,ab0645a5-cf58-4a38-822a-f77672835cfd,7126.41,debit,cash-withdrawal,AU00000,2023-09-30T16:40:44Z
transaction,d2302dcd-71f2-4d4b-9a86-89badde6a198,posted,Uber Ride,-4686.22,2f8b6f75-971a-4f17-b335-a3ecf1e2cc5d,2440.19,debit,cash-withdrawal,AU00000,2023-07-05T21:45:52Z
transaction,9e818030-210e-40b7-983f-d62009aa7dd2,posted,Home Improvement Store Purchase,-2674.3,353da100-562a-464d-8032-39734db871ee,-234.11,debit,payment,AU00000,2023-07-23T07:27:32Z
transaction,2e19a24c-6cb2-4bc4-94c6-927c35d87b11,posted,AGL RETAIL ENERGY LTD (GAS),-3827.46,84fecc4a-0faf-4c9e-aa05-37aea1b5d5bd,-4061.57,debit,bank-fee,AU00000,2024-02-16T04:25:21Z
transaction,93710fa7-abce-4f8b-92bd-de8cf5b09182,posted,Mobile Phone Bill Payment,-3024.16,931fbc38-428d-450a-b6c8-629ac1eb215c,-7085.73,debit,cash-withdrawal,AU00000,2024-03-08T18:55:00Z
transaction,2edb0eb0-0894-4a99-a971-969b73632393,posted,Gym Membership Fee,-4551.91,79c2178f-23db-4cf9-a20e-750ad7efc927,-11637.64,debit,bank-fee,AU00000,2023-11-22T12:47:08Z
transaction,dd06064d-4c18-4254-9f17-9661748bcde6,posted,Uber Ride,-3914.92,958e5e97-48e1-401e-8f96-a4d72e45da88,-15552.56,debit,payment,AU00000,2023-10-12T10:47:18Z
transaction,e6341a98-fef4-46b7-bfbf-69c0a752e25d,posted,Home Improvement Store Purchase,-4763.93,72cc27a1-eeaa-4707-8fea-6b441ed2b4ad,3496.08,debit,bank-fee,AU00000,2023-12-17T17:14:32Z
transaction,acabd305-985a-4f1f-92ba-445773d9df99,posted,Transfer Platnm Homeloan 346454,-3648.96,22ac9360-c237-44df-a34d-6dd4687b3a23,-152.88,debit,payment,AU00000,2024-01-21T00:57:18Z
transaction,7d8beddc-561d-44d9-913c-50dfe8a50d66,posted,Bookstore Purchase,-1324.63,220cd108-374e-484e-bef1-c774a0adbf6c,-1477.51,debit,bank-fee,AU00000,2023-05-24T14:44:08Z
transaction,4f8ca147-4847-4fdc-9e6d-8aed94f2f193,posted,Netflix Subscription,-1346.11,09de8ef1-4c84-4b21-8f81-bec0e8bc381f,-2823.62,debit,bank-fee,AU00000,2023-07-25T21:52:17Z
transaction,2ac85083-c6b7-4fc0-9395-6f7cd400377c,posted,Clothing Store Purchase,-1762.15,0c14f79b-c8c4-4215-b2cc-a6f24fd43e52,-4585.77,debit,payment,AU00000,2024-02-14T23:29:11Z
transaction,02fe1125-fe6c-4eac-ab08-543450f866fb,posted,Restaurant Dinner,-3191.09,38bee8f2-4bb1-4cf0-83c6-876276c30ecd,-7776.86,debit,bank-fee,AU00000,2024-04-08T16:16:28Z
transaction,a984792a-b36f-4feb-b142-b48814ef5526,posted,Public Transport Fare,-106.47,26b6e21b-5d43-4c3e-a29b-c69b37f17b06,-7883.33,debit,cash-withdrawal,AU00000,2024-03-11T05:25:53Z
transaction,766bc350-8639-489b-98cc-2cd5020cf14b,posted,Amazon Online Shopping,-1962.78,83d188d7-d5ac-4f26-a094-45c5886a1620,-9846.11,debit,bank-fee,AU00000,2023-07-24T22:32:09Z
transaction,4ca8250d-f2f2-49b6-8add-51e245d1404c,posted,Movie Ticket Purchase,-51.82,0662b266-e8c6-4942-94bb-62164469c71c,-9897.93,debit,bank-fee,AU00000,2024-04-13T16:25:01Z
transaction,4a19ae54-0541-4094-9648-032a106d8a1d,posted,Gasoline Purchase,-2257.99,580ab7d6-aa10-4fdd-9aae-7d7d2a86f05b,-12155.92,debit,payment,AU00000,2024-01-03T11:06:55Z
transaction,eca0322e-9967-4d8b-a2ca-0fcd21d37bc4,posted,AGL RETAIL ENERGY LTD (GAS),-4829.66,d4d9a799-4eeb-484a-9fed-019bb6801ac0,3552.73,debit,payment,AU00000,2024-02-22T20:17:25Z
transaction,914b0336-fbad-4cda-8d88-ae621559637e,posted,Amazon Online Shopping,-4757.86,1eb1ae66-d168-4ff5-b2e5-86cd31eaffb5,-1205.13,debit,cash-withdrawal,AU00000,2023-09-01T12:40:30Z
transaction,6d391cae-a602-443a-9a92-cf969f2c0622,posted,Travel Agency Booking,-2037.22,2317ae93-348a-4865-a6e5-c6ebe11f8572,-3242.35,debit,payment,AU00000,2024-04-29T04:45:43Z
transaction,16b1a1c2-d792-4f24-9958-47f3bab73934,posted,Mobile Phone Bill Payment,-637.61,869054e1-8068-4473-8de1-1c74e0fe0bed,-3879.96,debit,bank-fee,AU00000,2023-10-07T16:59:58Z
transaction,3f745175-a878-417f-8050-866f8bf684c5,posted,Clothing Store Purchase,-171.88,733c99e6-f1f4-40c7-bbd7-bd36bb769d81,-4051.84,debit,payment,AU00000,2024-04-09T11:22:44Z
transaction,102878c7-049b-4f6a-9212-5858fcffe4f2,posted,Uber Ride,-4649.42,c157ba5e-3041-4a77-bc2d-2764d2ff9b32,-8701.26,debit,payment,AU00000,2023-12-11T11:28:35Z
transaction,c4c0e4bc-0fd7-4e94-81af-5f344c45c0f1,posted,Transfer Platnm Homeloan 346454,-3256.42,8f1f3a9c-7bda-4b27-9243-ce52e40baefb,-11957.68,debit,cash-withdrawal,AU00000,2024-02-28T00:29:20Z
transaction,aee91ebd-a6c9-482a-90d1-23a92e2a54d4,posted,Coffee Shop Purchase,-741.53,eb576b71-b49b-4070-b2e7-1a6fd4e863c3,-12699.21,debit,payment,AU00000,2024-01-20T06:22:59Z
transaction,f2fc0417-dd61-47bc-acbf-85eaf2c9a901,posted,Uber Ride,-4692.68,52a12ab7-0a40-495d-8fa6-7d4ba3a3ed15,-17391.89,debit,payment,AU00000,2023-11-21T05:31:02Z
transaction,ea1c9831-6a20-4196-981e-1d92ea5af2bd,posted,TRANSFER TO JOANNA SMITH CAMPING,-4945.68,6dce64c0-cad2-4ef5-899c-38f28ea32aab,-22337.57,debit,cash-withdrawal,AU00000,2024-04-11T04:51:01Z
transaction,0cc3f894-023d-46b9-ae47-763b4c9d15fb,posted,Transfer Platnm Homeloan 346454,-758.54,e35d06fa-0082-4eb3-8eeb-bbef5563941f,16151.29,debit,bank-fee,AU00000,2024-05-08T09:10:10Z
transaction,052986cc-4dc9-42c4-a2b5-493f7a02efa9,posted,Wdl ATM WESTPAC IGA BALGOWLAH BALGOWL AU,-3540.2,b18d8481-ece2-4fd2-9896-e2c983efbc58,12611.09,debit,bank-fee,AU00000,2023-05-21T07:40:09Z
transaction,32baacaa-adf4-467b-834a-975d10e1f04d,posted,Payroll WFRMS 15439393,10353.36,9d70a3e1-6f4e-46ff-a5b7-7f9e22c9d38d,22964.45,credit,transfer,AU00000,2024-04-05T06:21:05Z
transaction,d5d84baf-dac7-4f6a-8018-d27340de1600,posted,TRANSFER TO JOANNA SMITH CAMPING,-4446.23,912c212a-caa3-4799-b6a4-0abc22ba90c8,18518.22,debit,cash-withdrawal,AU00000,2023-06-17T15:54:25Z
transaction,3fe65c4d-a1a6-4a82-9487-b0dbbcd0f5e2,posted,Restaurant Dinner,-2926.49,11dfb33b-d833-4c4d-91c6-9935278c0d5e,15591.73,debit,cash-withdrawal,AU00000,2024-01-02T04:37:14Z
transaction,da426253-5532-4eb6-882c-df1b92efcc87,posted,Uber Ride,-1313.02,9741e9c0-bedc-4929-a00a-c168c8251751,14278.71,debit,cash-withdrawal,AU00000,2023-09-24T14:45:57Z
transaction,efd6ad67-6191-427b-a799-2dfc498b0d48,posted,Car Maintenance Expense,-196.61,01f5d2a9-7f6e-442d-a169-d22b9ff4be2b,14082.1,debit,bank-fee,AU00000,2023-09-27T19:13:51Z
transaction,70b8a958-c7b2-456d-a0c3-9129fdce6fd1,posted,Wdl ATM WESTPAC IGA BALGOWLAH BALGOWL AU,-2645.38,0a3dbe3d-82c3-436f-915b-0f12dd0293ec,11436.72,debit,cash-withdrawal,AU00000,2024-01-02T04:02:14Z
transaction,ff3a8b4f-0312-4dc4-b306-67ba01174e08,posted,CTRLINK CARERS Ref: 998R6789201610974V,-887.27,8bf2f8f3-590c-4c22-9d31-30aac603eed7,10549.45,debit,payment,AU00000,2023-06-28T12:18:04Z
transaction,60e98a25-a096-4631-989b-85d6d4dbb242,posted,Pharmacy Purchase,-1875.5,27349c63-b5c4-477c-a9f8-8fdd8c2c796f,8673.95,debit,bank-fee,AU00000,2024-03-25T07:02:13Z
transaction,b8686cd5-0b1c-43ec-bebc-b8167c774952,posted,Restaurant Dinner,-4203.91,6ed3d24e-4d21-4bbf-8440-63717ce032d4,10926.29,debit,cash-withdrawal,AU00000,2024-02-06T03:29:43Z
transaction,1be5af11-a8a6-4191-a472-5d378e7101f4,posted,CTRLINK CARERS Ref: 998R6789201610974V,-863.4,6707c700-594a-41e5-b31d-aed340a687c9,10062.89,debit,payment,AU00000,2024-02-01T05:50:34Z
transaction,5e0a9f7d-7c89-4c3b-8290-bbd5c03bb14b,posted,Clothing Store Purchase,-3551.17,d6633fd8-7691-4743-ae32-61c1dd05a4be,6511.72,debit,cash-withdrawal,AU00000,2023-06-11T02:31:35Z
transaction,f6a21636-6227-4190-a55c-480c825dd60f,posted,Mobile Phone Bill Payment,-2288.55,f3493930-b992-4004-8526-6f0d7d8390f8,4223.17,debit,cash-withdrawal,AU00000,2023-07-18T02:35:48Z
transaction,4d109352-6566-4493-ad5b-bc9ccbe8706f,posted,Coffee Shop Purchase,-3508.73,cee95797-4fb8-4655-9640-8bdf3fa0c272,714.44,debit,bank-fee,AU00000,2024-03-15T20:35:52Z
transaction,1dead97e-3817-4433-9eba-fa3176f7347e,posted,Gym Membership Fee,-3528.19,3f596e20-10ad-425f-8704-685ac2b6f39f,-2813.75,debit,bank-fee,AU00000,2023-11-02T00:44:11Z
transaction,6ada62a4-233d-48b8-b53a-1fceaebf57ae,posted,TRANSFER TO JOANNA SMITH CAMPING,-40.65,abc8c903-4159-467e-90ba-6a57952090ba,-2854.4,debit,bank-fee,AU00000,2023-06-08T07:43:09Z
transaction,48dc88a7-c62c-4a6c-b432-809c48da225b,posted,Coffee Shop Purchase,-3042.75,2e01ec11-3131-4079-9e18-eae2a9a4ccbd,-5897.15,debit,cash-withdrawal,AU00000,2023-08-18T21:24:24Z
transaction,f9a7d112-cd00-4dfd-a4c9-4226392b278f,posted,Gym Membership Fee,-1892.53,0fe496ab-f7ea-4d3b-b128-b036f1251dc1,-7789.68,debit,cash-withdrawal,AU00000,2023-11-22T06:47:55Z
transaction,b823f209-f327-485e-bdd2-29d8b9958900,posted,Uber Ride,-1895.18,4b42f404-e7b4-4c27-8189-1111002e7fb0,-9684.86,debit,cash-withdrawal,AU00000,2023-12-23T07:21:08Z
transaction,a1e0de14-91c7-47a8-a741-9ccead3699aa,posted,TFR Acc14000 TO 12389,-3032.78,d4cdbc40-73f6-46d7-a1a1-ce891089c14a,9585.59,debit,bank-fee,AU00000,2023-07-18T01:17:48Z
transaction,8e2d95ba-35fe-4502-a92b-18d0110bfca4,posted,Electricity Bill Payment,-739.23,e1904d06-569e-4326-bd12-5572f5024e9c,8846.36,debit,cash-withdrawal,AU00000,2024-02-15T08:49:24Z
transaction,757f629d-a527-486d-8600-28408257c582,posted,Movie Ticket Purchase,-904.96,56c4ea53-24e0-4c02-b0f2-170bc0c9d052,7941.4,debit,cash-withdrawal,AU00000,2023-08-05T17:19:57Z
transaction,bf413967-5c5f-4bb8-bd19-86cc6b2dc6de,posted,TFR Acc14000 TO 12389,-4681.11,b01f2fbf-2b9c-449b-9432-ad0728941cc3,3260.29,debit,payment,AU00000,2024-01-30T05:08:08Z
transaction,41faa39e-be58-4af1-a4cc-34410c6ebd3c,posted,Public Transport Fare,-1874.61,4f2c4fa1-eba1-49e8-a52b-a1b5ef7265c8,1385.68,debit,bank-fee,AU00000,2023-10-31T08:20:25Z
transaction,828a7f18-b11d-4f9d-bc5b-a3934cf9fead,posted,Gym Membership Fee,-4036.45,7b161d99-1430-45e0-ae5f-1e349c2cb8ac,-2650.77,debit,cash-withdrawal,AU00000,2023-08-16T02:44:55Z
transaction,065b7152-18fa-40b0-8b63-060af6b75485,posted,Clothing Store Purchase,-2147.34,dcf855b6-0a53-4649-ba8c-594e911d95a2,-4798.11,debit,bank-fee,AU00000,2023-08-02T18:54:30Z
transaction,ad5b757b-9e6a-4b70-948a-a6cf1cec9f7d,posted,Online Gaming Purchase,-3728.7,9971bc6b-fbc2-41f7-8d32-cc9243e9d0f8,-8526.81,debit,bank-fee,AU00000,2023-11-28T09:27:19Z
transaction,af70574d-726e-4049-b3e6-57d699d254a3,posted,Clothing Store Purchase,-580.81,fa0a03af-93d6-4e10-a63f-ffd4910067ab,-9107.62,debit,payment,AU00000,2023-07-06T19:31:12Z
transaction,de811e18-f94a-4969-b2e3-f00c952c53d4,posted,Music Streaming Subscription,-3636.85,f5a2c4fd-f77e-47b1-912d-1cd7d36fd6b4,-12744.47,debit,bank-fee,AU00000,2024-05-09T01:01:13Z
transaction,f99c56e1-826e-45c1-941d-e1cd3f2b2065,posted,Gym Membership Fee,-4400.98,023f604a-8afa-434e-8a08-5773e675db51,3350.44,debit,cash-withdrawal,AU00000,2023-10-16T06:03:09Z
transaction,694e5dbe-adf3-4c19-bf0d-aaa43d8d6981,posted,Car Maintenance Expense,-3622.34,2bd93f0d-ff93-4c11-8881-5fa1164cd4fd,-271.9,debit,payment,AU00000,2024-03-23T04:32:08Z
transaction,3646bd91-1cbe-4ebe-9037-e0adccf9f484,posted,Travel Agency Booking,-4475.12,6ebefeae-ba6a-42f5-8436-cf7c99521b30,-4747.02,debit,bank-fee,AU00000,2024-01-17T19:00:28Z
transaction,957a08d9-8842-447f-bb7d-bf54a388ae99,posted,Non Hooli ATM Withdrawal Fee,-2471.13,734b0cca-8c65-4950-a978-0a7f7829c1a9,-7218.15,debit,payment,AU00000,2023-09-16T22:21:43Z
transaction,aa45fe38-09bf-4323-b2f4-af581ed16f34,posted,Amazon Online Shopping,-3210.96,05e3c7b0-b427-470e-b8d9-93c8573213cf,-10429.11,debit,payment,AU00000,2023-05-30T23:18:27Z
transaction,d9c45d77-ae4e-435b-9886-cfe7cc56cfe7,posted,Clothing Store Purchase,-2515.79,31a89144-0ddf-4185-8e01-96f541bfe821,-12944.9,debit,payment,AU00000,2024-03-31T01:12:16Z
transaction,a92c1d51-3847-4eea-baea-4fcad99b948d,posted,Online Gaming Purchase,-3990.81,c819645e-6791-4da2-b15b-db8aa4177fb7,-16935.71,debit,cash-withdrawal,AU00000,2023-12-06T13:48:15Z
transaction,9a5ceb41-bbf1-4bc0-950f-e2daa222bf5a,posted,Payroll WFRMS 15439393,10545.86,ff628c53-0538-4d8c-848a-8a9f7e45714d,-6389.85,credit,transfer,AU00000,2023-06-18T00:49:35Z
transaction,d1eb5c0c-1452-4e54-a182-9edb3d82223a,posted,Movie Ticket Purchase,-322.05,19a2a3d3-22b7-4f20-b941-7b8ea2f12ee5,-6711.9,debit,bank-fee,AU00000,2024-01-31T23:25:25Z
transaction,cc0108c8-7820-46bd-943b-8079e37451f7,posted,Bookstore Purchase,-3013.39,01ccb130-451e-4d8f-b1a6-7c2bf38b98e3,-9725.29,debit,cash-withdrawal,AU00000,2023-05-25T18:04:58Z
transaction,8ff446fa-bbd0-4047-91d8-17b4c4570581,posted,Coffee Shop Purchase,-2416.75,96d1d436-ecac-4169-9a58-38ba000d18b2,17551.75,debit,bank-fee,AU00000,2023-12-08T20:34:57Z
transaction,7dc47947-bf9a-4458-a69c-32a53a7a5b35,posted,Mobile Phone Bill Payment,-1749.19,3e0cb01c-6a99-407d-9db6-93e2424f7941,15802.56,debit,bank-fee,AU00000,2024-01-10T20:22:24Z
transaction,3f40f9f3-0da1-4da7-8683-276acfdb36ea,posted,Uber Ride,-2367.02,6550ce86-32ad-478e-abf4-4cde9be252d2,13435.54,debit,payment,AU00000,2023-10-12T09:24:09Z
transaction,4d802ccf-f966-447d-a511-1283682640bc,posted,Mobile Phone Bill Payment,-3820.66,840ea80f-f1af-4572-b3d6-4dd44246d4b3,9614.88,debit,cash-withdrawal,AU00000,2023-10-03T17:38:01Z
transaction,b11cc73f-5e33-4372-92df-faf2eb663bf7,posted,Transfer Platnm Homeloan 346454,-2273.96,c76c368c-80c6-4c27-a2a7-8d1f99473327,7340.92,debit,payment,AU00000,2024-04-09T02:37:18Z
transaction,b7786940-a536-4cbf-b6a4-da940a648263,posted,AGL RETAIL ENERGY LTD (GAS),-3169.86,2e520762-9f03-432f-a830-fa6f3a153267,4171.06,debit,bank-fee,AU00000,2024-03-18T01:23:49Z
transaction,65e392a0-beec-443f-a62c-da0faa375b71,posted,Transfer Platnm Homeloan 346454,-1704.68,92c14e97-d926-4015-8946-ffd46c98b95e,2466.38,debit,bank-fee,AU00000,2024-03-05T22:43:23Z
transaction,30eaa50e-58bc-442f-b120-d4abee195d16,posted,Music Streaming Subscription,-1814.12,a8851da1-9b6b-44f6-b9f9-9895ac6e9bd9,652.26,debit,bank-fee,AU00000,2024-02-10T12:23:22Z
transaction,e1707868-d96c-449a-8535-47797b22599d,posted,Coffee Shop Purchase,-4741.1,05dbca70-222b-4210-8428-36eea8126c1e,-4088.84,debit,bank-fee,AU00000,2023-10-16T14:41:40Z
transaction,5e84b456-3ca2-48ff-836b-f2c5ba376429,posted,Home Improvement Store Purchase,-4041.91,28e5929e-9225-4653-bc73-82281872d1de,-8130.75,debit,cash-withdrawal,AU00000,2023-08-31T00:29:40Z
transaction,07fbc02e-1a07-41b8-99de-2c7386794bdf,posted,Pharmacy Purchase,-1326.02,038c5c75-286b-4aa5-ac69-988e9608e8e8,3807.26,debit,cash-withdrawal,AU00000,2024-03-03T15:04:00Z
transaction,50386e8a-8b91-4d84-8ab2-66deebb2b402,posted,Manly Maths Tutor Wages,-4874.81,d22c8446-b621-4ed1-980b-b5017fc08f23,-1067.55,debit,bank-fee,AU00000,2023-12-07T09:23:11Z
transaction,d0e1adac-3e0f-41af-8fa8-97c917cfd317,posted,Uber Ride,-3863.91,b97f4421-9b18-4586-87a0-adc54c9a0693,-4931.46,debit,bank-fee,AU00000,2023-10-29T10:17:52Z
transaction,55be61aa-3511-4bf7-8081-96fdfd25f9b1,posted,Uber Ride,-1857.16,5de4e396-5aeb-4755-aa7a-4e5c47b669fd,-6788.62,debit,payment,AU00000,2024-04-22T17:56:15Z
transaction,ad768b4a-9934-47c5-958c-9226476820f5,posted,Uber Ride,-4333.72,fe16d1dd-a329-4c2b-a3ab-5f8ebc327829,-11122.34,debit,payment,AU00000,2023-10-01T13:37:32Z
transaction,b09a49d6-422d-418c-8152-058bdd82d2b0,posted,Travel Agency Booking,-1653.29,11841e12-6355-41d7-88e0-5a1b6de47ce4,-12775.63,debit,bank-fee,AU00000,2024-03-15T08:43:04Z
transaction,cd444c40-090f-49e0-8e7c-4577fe0d0e43,posted,Hair Salon Appointment,-1040.78,f354fab8-ff76-4923-8435-93ca900a65b3,-13816.41,debit,bank-fee,AU00000,2024-03-13T01:01:03Z
transaction,fc6925c0-69f3-4bf8-bdf3-e0907fffbb34,posted,Amazon Online Shopping,-827.51,082daf61-1626-4c07-b163-9c81c555345e,-14643.92,debit,cash-withdrawal,AU00000,2024-04-12T14:30:01Z
transaction,ec561f97-cebb-47c8-9735-5110d00822d0,posted,Wdl ATM WESTPAC IGA BALGOWLAH BALGOWL AU,-4930.17,f1bc28df-509f-428e-a98a-75a5d968c101,-19574.09,debit,payment,AU00000,2023-12-25T12:08:20Z
transaction,66c42b76-012c-44bf-8921-cfd9ac1032a2,posted,Movie Ticket Purchase,-355.17,be1f8e39-937e-46d2-a92d-386503e73c45,-19929.26,debit,payment,AU00000,2023-09-13T10:20:44Z
transaction,83545c13-da9c-4004-bf40-b79cb78de05c,posted,Netflix Subscription,-3249.73,ddd9eab2-cda7-4468-a3cb-0c9e9e8e8562,15922.39,debit,cash-withdrawal,AU00000,2023-07-22T10:24:28Z
transaction,80948ca7-2d49-4f20-9c81-1a4a5677064e,posted,Car Maintenance Expense,-2393.98,d471f0da-c8c2-41c1-8b2d-86c21e81a938,13528.41,debit,bank-fee,AU00000,2023-10-14T12:16:52Z
transaction,23d549c3-06cc-431a-81b4-53f78774506e,posted,Travel Agency Booking,-3409.86,c1878188-4378-4b74-9fe7-b40ed72670d8,10118.55,debit,bank-fee,AU00000,2023-11-16T14:23:01Z
transaction,1545234e-b914-49d3-86d8-bf5a49035f59,posted,Music Streaming Subscription,-3644.85,a34c27a0-5511-4c44-93f6-ada0412dfc64,6473.7,debit,cash-withdrawal,AU00000,2024-02-07T18:04:15Z
transaction,10d8e669-66d0-41e6-88f1-b8d782ea43f3,posted,Home Improvement Store Purchase,-4476.83,732f5b15-b9f5-456c-8b00-86e7ee44036f,1996.87,debit,cash-withdrawal,AU00000,2024-03-05T21:41:14Z
transaction,0e7ccd86-2673-4923-a44e-674c40e30638,posted,Bookstore Purchase,-1152.84,8be5fc60-cd3e-4804-92e6-406afb990c5d,844.03,debit,bank-fee,AU00000,2024-03-21T16:26:30Z
transaction,f8e80244-7a4c-4e28-b5c1-179ecf9c7760,posted,Transfer Platnm Homeloan 346454,-2701.9,a032726e-625f-4efd-a2e6-5f41342c0c84,-1857.87,debit,payment,AU00000,2024-04-03T00:50:14Z
transaction,f24591c4-7d9a-4587-a4a0-bacda4d07be2,posted,Bookstore Purchase,-4015.67,518eb163-f547-48d3-845c-ea15769c71c9,-5873.54,debit,cash-withdrawal,AU00000,2024-03-31T23:41:05Z
transaction,b98b4bfb-81da-4f4f-8ad2-a5d678259b95,posted,Uber Ride,-2680.97,cc17edb5-6dcd-4f89-8861-0a59696996cb,-8554.51,debit,bank-fee,AU00000,2023-10-20T01:57:57Z
transaction,c179b617-bdc2-47d6-a11d-cf07c61b991a,posted,Pharmacy Purchase,-3232.38,f36372e0-3161-4bd7-858d-2d9821478082,-11786.89,debit,cash-withdrawal,AU00000,2024-01-07T00:11:21Z
transaction,bed34b7c-2582-43fa-8446-2877f73d6c2b,posted,Coffee Shop Purchase,-2436.77,0e18a8fa-4832-4e85-8442-1d50d6d99f14,10008.43,debit,payment,AU00000,2024-05-04T03:55:33Z
transaction,6708e20b-765a-492f-be66-49328482502b,posted,AGL RETAIL ENERGY LTD (GAS),-2044.76,a4ea68e4-298e-4429-9dca-33cd1aab10c9,7963.67,debit,cash-withdrawal,AU00000,2023-08-09T15:12:50Z
transaction,34e16a05-1a83-4e78-89ac-3cf352adf996,posted,Public Transport Fare,-2795.41,8050b277-2354-4e35-b2af-6011e038676f,5168.26,debit,cash-withdrawal,AU00000,2023-10-15T14:05:08Z
transaction,451194b5-ed8a-4cc3-9d86-4fe5cf2253c4,posted,CTRLINK CARERS Ref: 998R6789201610974V,-3272.08,3daf3bf4-20e8-4734-8f6e-47897a5faec4,1896.18,debit,payment,AU00000,2024-01-18T06:17:49Z
transaction,701a0f60-2993-48ea-b1c4-54f06707ee00,posted,Payroll WFRMS 15439393,10888.65,199e45f4-be44-44df-86b0-e5aefc120997,12784.83,credit,transfer,AU00000,2023-06-25T20:05:09Z
transaction,63656ec4-9238-4be3-9814-23b6eb20beb5,posted,AGL RETAIL ENERGY LTD (GAS),-1896.58,95853e15-85a0-43f1-9498-7db211c9ec75,10888.25,debit,cash-withdrawal,AU00000,2023-08-16T08:40:02Z
transaction,cd2475a0-89dd-47cc-a4e2-8af5c10fbb4a,posted,Restaurant Dinner,-65.92,2b890c03-c40e-4d6d-9d4b-bf0883f0883e,10822.33,debit,cash-withdrawal,AU00000,2023-11-11T04:26:33Z
transaction,1903d40e-d97f-4a23-a564-2d2c658feb81,posted,Netflix Subscription,-1390.4,c7b7f79d-1279-487c-944e-e8b27d16073e,9431.93,debit,cash-withdrawal,AU00000,2023-06-25T06:52:12Z
transaction,2fdbb5b6-d0cc-4d2c-9a0b-d75db432af18,posted,Payroll WFRMS 15439393,11573.33,c6235f1f-207d-4496-8ec1-6f303216008d,21005.26,credit,transfer,AU00000,2023-08-28T04:13:21Z
transaction,a75aee2d-b5f8-4630-b4ac-68f7a2b0567e,posted,Online Gaming Purchase,-2600.76,32d52010-3244-4044-ac8b-51b762f92cbf,18404.5,debit,payment,AU00000,2023-11-15T11:31:36Z
transaction,e18dbefe-aa7b-4ae7-8368-7d805bcbe9c4,posted,Home Improvement Store Purchase,-4572.49,c39c2d3a-fd4a-427d-bf0d-82c2774e75ac,5509.67,debit,bank-fee,AU00000,2023-08-28T15:12:20Z
transaction,58e7395c-289f-49a7-b183-a6dc78c1c183,posted,AGL RETAIL ENERGY LTD (GAS),-2443.92,2411ed71-01b2-47fb-9339-f3a52d87625e,3065.75,debit,payment,AU00000,2023-08-09T16:12:51Z
transaction,4be467b9-d40c-4bc2-8c41-2de47eadc481,posted,AGL RETAIL ENERGY LTD (GAS),-3063.07,c5b36921-9f96-4631-af3e-34ddd5455026,2.68,debit,payment,AU00000,2023-10-29T05:24:10Z
transaction,52a559f7-5312-4ca4-8499-a45d62ceed17,posted,Manly Maths Tutor Wages,-2428.97,9aa1b4cc-5639-4238-a0e6-53ed8216c45b,-2426.29,debit,payment,AU00000,2024-01-30T02:35:04Z
transaction,abe186ac-9eed-49ae-89bc-a833ba00e8c8,posted,TFR Acc14000 TO 12389,-2685.6,8ba5b712-6cc1-4ef5-b729-fce751fe12ab,-5111.89,debit,bank-fee,AU00000,2023-10-13T13:01:06Z
transaction,f00c0b41-0436-405e-baca-e220b03646c6,posted,Online Gaming Purchase,-111.78,becfbf91-5a73-4d0a-9868-0096c50562fd,-5223.67,debit,cash-withdrawal,AU00000,2023-10-19T02:43:30Z
transaction,d256c63f-84c2-4d51-8f2c-f461c747ab7c,posted,Gasoline Purchase,-4664.74,d3c164e6-ec17-4377-9973-c5abb50561d6,-9888.41,debit,cash-withdrawal,AU00000,2024-04-22T01:45:23Z
transaction,d9ad5461-6188-4092-a25b-217da0d2b4ae,posted,Manly Maths Tutor Wages,-734.22,0559edcc-32a2-46a1-b0a4-82c5841558c5,-10622.63,debit,bank-fee,AU00000,2023-11-22T16:26:51Z
transaction,be20e3d3-3330-4e09-a5b7-b26dbcd0fd3e,posted,Wdl ATM WESTPAC IGA BALGOWLAH BALGOWL AU,-4996.15,13652734-b73d-4b86-b537-a837d31125ff,-15618.78,debit,bank-fee,AU00000,2023-07-30T09:12:01Z
transaction,d737f2c0-86d0-475b-873c-e191a27c600f,posted,Restaurant Dinner,-4627.04,802bcf52-9690-4561-8913-91618023cd8f,-20245.82,debit,bank-fee,AU00000,2023-11-27T17:10:15Z
transaction,ac27df86-a052-484d-8bce-7c3989740e29,posted,Pharmacy Purchase,-2118.55,a64f90d4-7bbf-4991-958c-a03435491600,9517.38,debit,bank-fee,AU00000,2023-10-07T05:25:27Z
transaction,d6df9548-5c67-4722-a675-aa9549e67a94,posted,Hair Salon Appointment,-4952.96,5e01de80-56e0-4772-9506-82f8116081b2,4564.42,debit,payment,AU00000,2023-05-16T10:00:03Z
transaction,f0db9577-3d00-4f29-82f2-e3196cb78243,posted,Wdl ATM WESTPAC IGA BALGOWLAH BALGOWL AU,-1390.42,0e9c0628-d051-45ae-8232-56b6c42d8d9c,3174.0,debit,payment,AU00000,2024-02-01T22:29:00Z
transaction,f81a4cab-2346-4d93-98b6-349798d2930b,posted,Netflix Subscription,-1905.53,0ffeba0a-680d-4868-bc78-370bb59971af,1268.47,debit,payment,AU00000,2024-03-18T12:21:34Z
transaction,8944b52f-216b-44a3-bbf2-f3a130e31a01,posted,Payroll WFRMS 15439393,11024.75,47fa8402-d5ac-4c40-8186-4f0df70858cb,12293.22,credit,transfer,AU00000,2024-04-05T18:34:38Z
transaction,6993783b-ad91-40e4-aba2-d022e9d4b8b1,posted,Online Gaming Purchase,-2946.34,bb5c144a-a39e-416f-8691-923c53378ec1,9346.88,debit,cash-withdrawal,AU00000,2024-04-15T13:53:02Z
transaction,c379dd60-9353-420a-91eb-acc8510d4e72,posted,Online Gaming Purchase,-1070.83,9fa229e7-0e0a-4aea-b5ad-397f4f93288e,8276.05,debit,payment,AU00000,2024-03-29T17:10:30Z
transaction,e7ff042a-ec2f-41c2-9135-997b133dd8cc,posted,Bookstore Purchase,-550.83,87eafb65-627f-4e0c-bd73-0efa67663d3e,7725.22,debit,payment,AU00000,2023-06-27T19:44:51Z
transaction,fc3167bc-0ff0-4fd0-a995-68e5d54543ea,posted,Hair Salon Appointment,-2637.8,7e4d0c96-bd08-472f-baea-57856c4ec8c3,5087.42,debit,bank-fee,AU00000,2023-08-24T19:43:30Z
transaction,cda4fbdd-45f6-49ff-8db6-2ae001f17b7b,posted,Gym Membership Fee,-4489.63,79675a6e-ba68-465c-b5ef-7eb17955c1c5,597.79,debit,payment,AU00000,2023-08-11T02:54:39Z
transaction,ed8b2203-9900-45a9-89d8-2995227cd3d5,posted,Bookstore Purchase,-2240.07,c95e3320-899d-42fc-be6a-f309d6dc13b3,11577.26,debit,payment,AU00000,2023-06-19T15:15:56Z
transaction,8a5fdaf1-8573-416f-8a1f-cd9eb74ec950,posted,TFR Acc14000 TO 12389,-2601.09,dd8d5978-6397-46f8-b36d-89a722028b40,8976.17,debit,payment,AU00000,2024-04-14T22:16:29Z
transaction,6c59ab0b-cd69-4115-9ff9-df9b12ce6cce,posted,TFR Acc14000 TO 12389,-2762.02,6edad427-f892-4923-a8ec-326355f82461,6214.15,debit,bank-fee,AU00000,2024-03-31T15:55:43Z
transaction,7c86518f-88db-4e2d-b2ed-bf1e2e7d647f,posted,Hair Salon Appointment,-4929.67,6b6d84a7-5993-4a39-bfc8-851830806dce,1284.48,debit,cash-withdrawal,AU00000,2023-10-29T13:44:34Z
transaction,4d4b558f-6267-4e69-a086-224fa6dd9fbc,posted,Wdl ATM WESTPAC IGA BALGOWLAH BALGOWL AU,-199.71,7b1de26b-be24-4c06-9aab-be89333d7a5c,1084.77,debit,payment,AU00000,2024-02-17T21:43:55Z
transaction,0b45d103-03ab-455e-9ab2-07991cb74f5b,posted,Bookstore Purchase,-1778.38,6ba78806-53c1-4352-bc68-1259dd130ac1,-693.61,debit,payment,AU00000,2024-01-25T22:28:57Z
transaction,e1751a81-cfe6-4cf0-8ce2-bed373188f85,posted,Payroll WFRMS 15439393,10883.27,227a166d-f055-484d-a9b9-573dc3154f52,10189.66,credit,transfer,AU00000,2023-10-11T13:25:43Z
transaction,c40474bf-b0c4-43a8-8b65-cf8a61eea64f,posted,Transfer Platnm Homeloan 346454,-1649.68,d1edd854-6665-4fcb-8f50-966ca4b23b36,8539.98,debit,payment,AU00000,2024-01-08T19:43:24Z
transaction,2104a4c4-2e18-4fd9-a5de-c51897061cb7,posted,Wdl ATM WESTPAC IGA BALGOWLAH BALGOWL AU,-3480.2,2e629741-d936-4aaf-8284-a30d615067c6,5059.78,debit,payment,AU00000,2023-08-17T16:36:45Z
transaction,3601cc2a-7963-47b0-a895-6e0934020364,posted,Clothing Store Purchase,-1956.92,af3776eb-c79a-4c70-a57e-439c8021402c,3102.86,debit,cash-withdrawal,AU00000,2023-05-19T12:23:33Z
transaction,384724d9-a28b-4f60-99e1-f5b3a5df08d3,posted,Home Improvement Store Purchase,-4705.07,5c3562c9-a41c-4eee-ac11-c42dbbf244f0,14698.4,debit,bank-fee,AU00000,2023-10-28T23:22:40Z
transaction,f52d2644-7101-417b-84cd-ee33e820a599,posted,Home Improvement Store Purchase,-3006.44,40e930f9-c6e6-4a83-9faa-84613e3d8dec,11691.96,debit,bank-fee,AU00000,2024-04-11T10:17:48Z
transaction,96bcfbb0-3efe-4ad2-93d8-0ce0faac5627,posted,Public Transport Fare,-552.12,04daba84-fac0-42b0-8091-9a66936570cd,11139.84,debit,bank-fee,AU00000,2023-08-10T14:54:20Z
transaction,f11c8fca-4ebf-4f16-9997-2dc00d31058c,posted,Gasoline Purchase,-2344.29,d26bcb8c-fc29-4ece-b4a6-09d50efeecbc,8795.55,debit,payment,AU00000,2024-01-18T11:51:22Z
transaction,ddef3da3-fd20-4257-9100-2ac603061216,posted,Pharmacy Purchase,-4715.03,2ff234a2-bbd3-4266-a7e2-04862a5d5e1c,4080.52,debit,payment,AU00000,2024-01-26T04:13:46Z
transaction,8afe6f40-a49f-4edf-a3b1-d6d17ef06e10,posted,Mobile Phone Bill Payment,-1722.82,ecc2d94e-5d3a-44f1-a788-800add22c2e6,2357.7,debit,cash-withdrawal,AU00000,2023-05-25T03:49:16Z
transaction,7ccb8b75-cac5-4c82-9562-41ff0d21a107,posted,Public Transport Fare,-1696.24,a055947e-7e02-4670-b992-c777cb43b188,661.46,debit,cash-withdrawal,AU00000,2024-03-22T06:02:28Z
transaction,dc0a7ae2-e711-4ed7-90c2-48f52e895d0d,posted,Coffee Shop Purchase,-4627.82,5d35f42b-f2aa-4d42-8bb9-805627edce8f,-3966.36,debit,payment,AU00000,2024-05-01T19:45:36Z
transaction,5a4a1266-a94a-4509-9d20-90f3b1ae4b15,posted,Electricity Bill Payment,-59.19,9c60daa0-3678-445e-abf4-9075f008bff2,-4025.55,debit,bank-fee,AU00000,2023-06-11T21:30:18Z
transaction,3953653d-7ffb-42f5-87d5-41df42dc8e79,posted,TFR Acc14000 TO 12389,-3655.0,c5333454-e5a5-440e-a5b1-25fb8ffee31c,-7680.55,debit,cash-withdrawal,AU00000,2024-03-11T12:27:40Z
transaction,83f6dc4d-2036-45d2-8a5a-1c03948122ce,posted,Travel Agency Booking,-3439.95,64830a63-9542-49d9-b00b-c5005bd986e5,7984.76,debit,payment,AU00000,2023-07-21T16:31:35Z
transaction,b558fc96-c8d3-4af3-8791-d9ee7adbcace,posted,TFR Acc14000 TO 12389,-428.1,7943c62e-3573-47d2-a875-31b95ea31434,7556.66,debit,payment,AU00000,2023-07-13T09:51:15Z
transaction,99fb9c27-5927-4c3a-bbfc-85a5fea723e0,posted,Coffee Shop Purchase,-1277.69,1b4d10d3-083d-4492-ad42-886be2a1810d,6278.97,debit,payment,AU00000,2024-02-14T12:10:54Z
transaction,a977e825-dc0f-4708-ba02-f6842ba16f45,posted,Transfer Platnm Homeloan 346454,-570.95,c0f7d05c-74ce-41f7-93be-c2eaca0120f2,5708.02,debit,cash-withdrawal,AU00000,2023-06-15T06:07:17Z
transaction,dcf620dd-1661-47f9-b8aa-7dbf303c225a,posted,Clothing Store Purchase,-1130.71,8fbcbbdd-5490-4cbf-a52f-8e19513d1f9a,4577.31,debit,payment,AU00000,2024-02-11T16:20:59Z
transaction,d4a9edda-2992-4543-89ca-a762019df3e3,posted,Uber Ride,-3836.17,56a407d3-e06b-430e-b0b0-6924b0f1b75c,741.14,debit,payment,AU00000,2023-09-23T14:12:27Z
transaction,43b680f8-cdff-44cb-b84a-e33e8f9f95df,posted,Clothing Store Purchase,-4705.48,ba4a9ede-e4d8-474d-a7d2-19fcc6d7f283,-3964.34,debit,payment,AU00000,2023-08-08T08:51:06Z
transaction,7a4c6dce-31ef-455a-ab9c-52dcb68ced24,posted,Gym Membership Fee,-4650.68,6f0f840e-d392-4c78-9f84-52537aa15013,-8615.02,debit,payment,AU00000,2024-04-08T03:17:19Z
transaction,1edb528b-4458-4d1e-9777-08f3bb04a1ed,posted,Payroll WFRMS 15439393,10255.33,96dea4ba-0330-4594-8400-0f7b8f2196ae,1640.31,credit,transfer,AU00000,2023-08-06T06:05:05Z
transaction,f73de624-e47d-47bf-bfa6-d88949abd7da,posted,Hair Salon Appointment,-497.52,822f4ad1-ec27-4284-a995-85d0fc379fdf,1142.79,debit,bank-fee,AU00000,2023-05-12T18:12:59Z
transaction,d1422ed2-c944-47ec-a9eb-f0715fc24740,posted,Mobile Phone Bill Payment,-197.41,3a36be1a-7ba6-4990-aa9a-acfef6f159ef,8421.25,debit,cash-withdrawal,AU00000,2023-10-08T13:09:51Z
transaction,00f63d8c-f7c3-4ecd-9613-d766cbf1eaf1,posted,Online Gaming Purchase,-1198.83,5e1f0d63-b06c-49d6-a31c-92f963c15284,7222.42,debit,cash-withdrawal,AU00000,2023-10-20T20:20:02Z
transaction,5d7b017e-f59a-4a41-94ea-e3b44f05969b,posted,Gym Membership Fee,-2143.12,5bf04624-c0b7-460e-b829-92e654797055,5079.3,debit,bank-fee,AU00000,2024-01-26T17:03:49Z
transaction,cba2085a-eeb5-4a38-abcd-eb86132ba9ba,posted,Online Gaming Purchase,-1348.72,a1cf2991-110b-4fc7-969d-ab4c86ff5480,3730.58,debit,payment,AU00000,2024-02-03T09:06:33Z
transaction,a7bfc2d9-db3f-4e9e-a7fa-081a4b14d535,posted,TRANSFER TO JOANNA SMITH CAMPING,-2764.56,279b2571-b9dd-46f7-9a5d-998bac80b3f5,966.02,debit,cash-withdrawal,AU00000,2024-02-25T04:04:10Z
transaction,61bf6c5e-c932-4bcc-ba72-5bfa4628a45e,posted,Netflix Subscription,-937.01,fd23e687-c48e-4617-a9d5-5eef69e229d2,29.01,debit,cash-withdrawal,AU00000,2024-02-27T21:14:50Z
transaction,30325847-6f59-443c-96cc-86c0a5beb2e6,posted,Music Streaming Subscription,-2194.45,b5defe9d-2112-464b-9e01-9e5901f708ea,-2165.44,debit,payment,AU00000,2024-04-10T17:19:00Z
transaction,0362d463-13c6-4d79-967d-61cbaed78fe6,posted,Uber Ride,-2069.08,e5fbcfe4-f1a7-4578-bc91-c22a7753682e,-4234.52,debit,bank-fee,AU00000,2024-04-24T16:11:31Z
transaction,1c42d0ec-507a-4530-ae00-3339c46f9aec,posted,Uber Ride,-3887.99,cc809afd-b4bf-40e3-8856-11238145ed82,-8122.51,debit,payment,AU00000,2023-12-08T06:02:56Z
transaction,add94c49-eaeb-41e7-9a11-aea6f04f8a24,posted,TRANSFER TO JOANNA SMITH CAMPING,-4238.48,0a378505-b532-4b8b-9acd-916f62a47f1b,-12360.99,debit,cash-withdrawal,AU00000,2023-06-16T10:00:28Z
transaction,b1160406-6a40-422a-ac87-2d4716bc76d5,posted,Amazon Online Shopping,-4716.96,636a1867-284c-4179-8160-76340df42920,13534.46,debit,bank-fee,AU00000,2024-01-29T05:05:46Z
transaction,c8b33d0c-0ad6-44db-8263-233ec35c14f8,posted,Restaurant Dinner,-796.68,930a257a-ced1-4fb1-8062-39c862350fd5,12737.78,debit,payment,AU00000,2024-02-22T16:19:28Z
transaction,96466eb0-1567-4bbb-88d1-b159f0c43048,posted,Clothing Store Purchase,-3885.97,22a29964-0a29-46df-b5a2-77ee9d38c261,8851.81,debit,payment,AU00000,2024-04-16T20:38:35Z
transaction,d51c5f40-faec-4cf7-934a-88eadabc4331,posted,Electricity Bill Payment,-3396.82,6769fe9d-c880-42ce-85be-11b086d7fe6a,5454.99,debit,bank-fee,AU00000,2023-11-28T06:04:03Z
transaction,02a3a019-5aa8-4138-b4e9-4b2b3df17d04,posted,Payroll WFRMS 15439393,11245.47,b807d7d0-9f4d-4db9-a723-aa1b56ea9cee,16700.46,credit,transfer,AU00000,2023-05-24T17:17:08Z
transaction,99df88df-9503-4078-8af4-f3892e008606,posted,Clothing Store Purchase,-2360.28,931569a2-9082-4f56-935f-fb37c4b90faa,14340.18,debit,payment,AU00000,2024-03-20T00:34:07Z
transaction,83fcd393-7b23-426e-bb5f-14eb01a9e1b7,posted,Amazon Online Shopping,-4818.59,508ae785-da65-4689-9723-31d036bc2217,9521.59,debit,bank-fee,AU00000,2024-02-04T08:43:53Z
transaction,577b27f3-8bfe-468c-9079-6b9cca5ba3f5,posted,Hair Salon Appointment,-4395.72,77ce774b-6068-4bae-adf2-049a8d011620,5125.87,debit,cash-withdrawal,AU00000,2023-06-25T09:52:36Z
transaction,c90b577a-7f0e-4b05-83ba-d0c08ad40be9,posted,Mobile Phone Bill Payment,-4230.52,46c2df2d-6e73-4d3d-b02e-dc7389d35045,895.35,debit,bank-fee,AU00000,2024-04-16T17:05:56Z
transaction,d061882a-e239-4f48-8bee-44adb78fcc91,posted,Bookstore Purchase,-707.58,f8e5969c-ee4b-4c4f-bd1f-ad5af013120c,187.77,debit,bank-fee,AU00000,2023-08-12T19:38:14Z
transaction,dd6ff959-3223-4763-a759-a1c8d6d3b993,posted,TRANSFER TO JOANNA SMITH CAMPING,-849.19,57280bd6-6930-492a-a5ae-4162d8dca030,17082.91,debit,cash-withdrawal,AU00000,2023-05-16T21:19:24Z
transaction,39db05c3-51c5-45de-90e5-4cd3f74caa7b,posted,Clothing Store Purchase,-1594.46,4b2b8c8a-03f4-4be7-af64-a2866b40cc4e,15488.45,debit,payment,AU00000,2023-09-18T18:58:35Z
transaction,50b79397-6d6c-4273-8375-c4c859c144c6,posted,Wdl ATM WESTPAC IGA BALGOWLAH BALGOWL AU,-4447.35,9b43d75e-f0ee-466a-8b20-ffec73aacfc7,11041.1,debit,bank-fee,AU00000,2024-01-17T08:22:26Z
transaction,48de0b5b-d102-4613-8782-bea680c661fc,posted,Restaurant Dinner,-1482.29,bb8f6508-cb64-467b-a38f-932e06157dfd,9558.81,debit,bank-fee,AU00000,2023-10-29T23:34:01Z
transaction,f03e2ed4-d716-45f8-8f27-b5536c6f94dd,posted,TRANSFER TO JOANNA SMITH CAMPING,-1291.3,87097f45-0c43-495d-bd3e-828d0e70e96f,8267.51,debit,bank-fee,AU00000,2023-12-16T10:12:11Z
transaction,8f2214de-00c8-456c-99a2-0c9abce0a4ea,posted,Public Transport Fare,-4862.05,247a5046-201c-47ba-a21b-16e694083ec6,3405.46,debit,payment,AU00000,2023-11-15T01:29:32Z
transaction,e7ebe35f-ab8d-4a33-8077-22b77f14eec7,posted,Music Streaming Subscription,-1628.11,ecb6a00a-0dfb-43fe-b3e3-68d1019fe2f5,1777.35,debit,payment,AU00000,2024-02-05T15:42:02Z
transaction,d9e1f3d9-2410-4c8e-ba39-4a3afabbc4ef,posted,Bookstore Purchase,-3653.33,8c1cbed0-5eb9-45d9-b4b7-b394474051ea,-1875.98,debit,payment,AU00000,2023-09-04T00:52:46Z
transaction,a2ffb3ba-45cf-493f-a522-3eacc4524466,posted,Netflix Subscription,-4851.92,c5002de9-09f9-428b-a75f-983d6bc1127c,-6727.9,debit,payment,AU00000,2023-07-16T17:43:54Z
transaction,c00abf34-05df-49d6-872b-020c783fd438,posted,Pharmacy Purchase,-3047.81,edb55264-34ec-4f1e-a51b-2547609377b1,-9775.71,debit,bank-fee,AU00000,2023-11-16T22:44:25Z
transaction,d639f859-1159-475a-b7f0-e0a607d3728c,posted,TRANSFER TO JOANNA SMITH CAMPING,-2961.61,12a62dfa-ec49-4bba-99b4-a79e610f69ae,7278.34,debit,cash-withdrawal,AU00000,2023-06-16T02:42:51Z
transaction,4d7c6d11-0af6-45b8-87f5-1aeb95c4fb5f,posted,Car Maintenance Expense,-102.19,a23c321d-b3e2-4dc3-8e54-97d67bae43d6,7176.15,debit,payment,AU00000,2023-11-18T10:19:20Z
transaction,6b658511-471b-45f4-81e1-815a48c6a55f,posted,Online Gaming Purchase,-1245.18,277c5dbd-4448-4e36-b3ae-2a49932a7ac6,5930.97,debit,cash-withdrawal,AU00000,2023-08-10T02:37:19Z
transaction,1e664065-3e03-4a22-b916-2cdfe3a6052c,posted,Amazon Online Shopping,-2783.98,2bf880d5-3f18-4dbf-8d2a-7bc7503e8ef4,3146.99,debit,payment,AU00000,2024-04-23T17:29:36Z
transaction,b08a423b-774f-4361-8106-9d9b3e9f7eb4,posted,AGL RETAIL ENERGY LTD (GAS),-4926.47,17ac886a-30b0-4237-9ed3-9ff02db24a4b,-1779.48,debit,payment,AU00000,2023-11-25T01:25:35Z
transaction,8685d93d-9686-4cc6-95a3-0e980ea573aa,posted,Pharmacy Purchase,-2483.45,eb272519-f09a-414b-be78-26c00a74ad90,-4262.93,debit,bank-fee,AU00000,2024-01-17T04:21:09Z
transaction,06302da3-adb0-442f-924a-f4c158caee22,posted,Hair Salon Appointment,-1934.31,13a85b7c-dfa2-40ac-9774-ab59935d943f,-6197.24,debit,bank-fee,AU00000,2024-01-14T03:54:00Z
transaction,f87714db-3385-4b66-b614-214f6330193e,posted,Pharmacy Purchase,-825.41,9371be6b-2abb-4bfe-9b27-3bc0dde6a172,-7022.65,debit,cash-withdrawal,AU00000,2023-10-17T16:23:20Z
transaction,122633cc-7ae3-40bd-807e-698c41aa5806,posted,Online Gaming Purchase,-4528.67,2bc3b3d6-8e33-479f-9835-6b69c4a8cb80,-11551.32,debit,payment,AU00000,2024-05-10T17:54:38Z
transaction,3e28fe73-7748-4117-ad4e-1e8f536fdc35,posted,Gasoline Purchase,-291.01,e79343a5-e755-4924-b072-9cbd6d6348f9,-11842.33,debit,bank-fee,AU00000,2023-11-28T04:29:13Z
transaction,72b7f3a4-0634-4e88-a0b2-557b02f1fd69,posted,TFR Acc14000 TO 12389,-3452.14,9d2e46ab-7411-4b6a-8cd3-dd1f7012fdb1,6090.03,debit,cash-withdrawal,AU00000,2024-02-04T21:49:50Z
transaction,711fe181-19dd-4535-ac8d-05b16cb3f582,posted,Car Maintenance Expense,-2086.29,fb57ba09-1661-4bb6-873c-5d3f473f1c3a,4003.74,debit,cash-withdrawal,AU00000,2024-04-23T02:51:51Z
transaction,e9fc6923-4abf-48c4-96ba-fff2746f8ca2,posted,Transfer Platnm Homeloan 346454,-2258.4,687c0f9e-358f-4eca-8184-5d907594044d,1745.34,debit,payment,AU00000,2023-10-23T23:56:52Z
transaction,6ef66847-0cc3-47f2-9d81-bbb2866472e6,posted,Travel Agency Booking,-775.25,09f51cab-2990-4b85-9642-e02fc0254658,970.09,debit,bank-fee,AU00000,2023-10-03T07:23:34Z
transaction,d738423d-1965-45ac-b5e8-18c95727af6d,posted,CTRLINK CARERS Ref: 998R6789201610974V,-1046.0,a059976a-1768-482e-a831-a4b70dc3b3c0,-75.91,debit,payment,AU00000,2023-10-19T23:36:13Z
transaction,da314ebf-818a-4ac8-954a-51086a388182,posted,Uber Ride,-505.33,ec02c78a-eeea-47b5-b4e4-5ea08c68f352,-581.24,debit,payment,AU00000,2023-11-09T17:26:27Z
transaction,aca97787-80de-4159-8061-90226ee55599,posted,Netflix Subscription,-1784.26,af1213d2-3b7e-485f-ae4a-623c0feeb4c1,-2365.5,debit,bank-fee,AU00000,2023-09-21T03:52:09Z
transaction,c09863a4-041a-4350-ac67-9a2c9c597214,posted,Gym Membership Fee,-4963.23,504d74a0-19cb-4552-9f1e-6b9609dbfa72,-7328.73,debit,bank-fee,AU00000,2023-07-10T06:26:31Z
transaction,e2674fa3-30c0-4897-b577-d51d617c617f,posted,TRANSFER TO JOANNA SMITH CAMPING,-3556.87,7c40be89-194a-45e8-9887-7c1ec12f6b95,-10885.6,debit,cash-withdrawal,AU00000,2023-08-20T20:56:32Z
transaction,8382d13b-0817-42c8-8add-59439090d45d,posted,Movie Ticket Purchase,-1515.21,9b928307-4b40-46cd-9844-deaf7460b5ef,-12400.81,debit,payment,AU00000,2023-06-15T22:35:59Z
transaction,698abda2-8224-4389-a4ba-b7b36a2718fe,posted,Online Gaming Purchase,-1644.34,5991a7b0-086b-43d6-abbb-9cd961e95199,11973.38,debit,cash-withdrawal,AU00000,2023-06-28T04:32:23Z
transaction,8336fe3b-af2f-4ae4-9137-59c46191370d,posted,Transfer Platnm Homeloan 346454,-3483.47,731c0cbc-ab8d-4b95-be9c-bc88898c4409,8489.91,debit,cash-withdrawal,AU00000,2024-04-17T13:30:11Z
transaction,6d67f1e7-0af3-4cf9-add0-51fccdd9af7b,posted,Online Gaming Purchase,-2229.36,b5762734-d875-46b0-9c3d-800902f217fa,6260.55,debit,payment,AU00000,2023-06-05T02:56:23Z
transaction,f57e865e-9fac-4970-a364-300b7f5ee8fe,posted,Wdl ATM WESTPAC IGA BALGOWLAH BALGOWL AU,-2413.0,f99b33b7-1bac-4e31-ba41-2003fd3d11ef,3847.55,debit,cash-withdrawal,AU00000,2023-09-18T23:22:17Z
transaction,258a67a7-d203-4377-b962-2ba0ea60e404,posted,Manly Maths Tutor Wages,-510.25,8176a70f-4aed-4b9f-a80a-11f0c2cad172,3337.3,debit,cash-withdrawal,AU00000,2023-08-07T09:52:05Z
transaction,85c438ad-fb4e-4db4-95af-0878749b3b88,posted,Transfer Platnm Homeloan 346454,-4024.07,88e226da-ba44-4fca-bee3-86eee52a8bf9,-686.77,debit,cash-withdrawal,AU00000,2024-04-19T19:43:44Z
transaction,850aa61d-7be8-4110-ad15-3052254f3a4d,posted,Bookstore Purchase,-1701.33,d343b588-01cf-4f9e-8a1f-35ed7bb001bc,-2388.1,debit,cash-withdrawal,AU00000,2023-11-29T11:29:39Z
transaction,7e5f9e60-93e7-4d6d-b86f-bfdfc1b6ddbc,posted,Gym Membership Fee,-681.21,723354a9-d967-4573-9c2f-94ff2e4d0c5f,-3069.31,debit,bank-fee,AU00000,2023-09-09T23:47:43Z
transaction,8574da5f-6ca6-490d-8341-c4c690eb1c22,posted,TRANSFER TO JOANNA SMITH CAMPING,-2138.47,2fe10d14-b529-40cd-bc72-c7b3adff04b3,-5207.78,debit,cash-withdrawal,AU00000,2023-05-31T08:23:00Z
transaction,b95cf697-af7f-4659-b609-f2585c359e3c,posted,Payroll WFRMS 15439393,10753.86,057786e3-690f-4825-bec7-29176f40f75f,5546.08,credit,transfer,AU00000,2024-04-11T01:41:45Z
transaction,d1309e1e-3365-4e03-ab70-a74ebe66edf2,posted,Home Improvement Store Purchase,-2965.92,d6100202-9419-467b-a693-ac2fab2bdd2f,10958.39,debit,payment,AU00000,2024-05-03T07:47:17Z
transaction,bcc6ebae-c9b5-4c06-91b5-651b9751f24b,posted,Netflix Subscription,-826.62,4af4b20f-df7f-460b-9af5-7069bdbb8311,10131.77,debit,bank-fee,AU00000,2023-09-05T00:21:12Z
transaction,71c2c0fb-5cc0-49a3-ac9b-1b7ac6728eaf,posted,Transfer Platnm Homeloan 346454,-4455.88,3fc5f768-cc1d-4fd2-a803-2d5438ecbe01,5675.89,debit,payment,AU00000,2024-02-15T00:48:24Z
transaction,d00563fe-f8a1-47d9-8dbc-016296a884ce,posted,AGL RETAIL ENERGY LTD (GAS),-2733.6,051f04f8-6bdd-4884-a86f-379083ca00bc,2942.29,debit,bank-fee,AU00000,2023-11-15T07:55:55Z
transaction,45eede63-00d0-4ed1-84f4-8003f58d1440,posted,Music Streaming Subscription,-3817.67,0c275a50-8458-4b72-99d6-a186b0f890e7,-875.38,debit,payment,AU00000,2023-05-17T11:56:56Z
transaction,54de9e9d-c7ff-44c5-bcbf-fdfcca5e4e4e,posted,Manly Maths Tutor Wages,-3209.04,e05769bb-27a5-4eca-babe-bef3fcddbc32,-4084.42,debit,bank-fee,AU00000,2023-06-26T07:25:07Z
transaction,29d95ddd-af91-4ab2-b9a2-a59f9797a9b6,posted,Restaurant Dinner,-2302.53,f8310256-29b5-437f-9528-bf02970780a4,-6386.95,debit,cash-withdrawal,AU00000,2023-09-27T22:36:37Z
transaction,a4d5d9bf-fa9d-49b5-948a-518d28ae6425,posted,Clothing Store Purchase,-224.56,45179ec8-8f79-4425-a13c-3048b05dcab0,-6611.51,debit,bank-fee,AU00000,2023-09-30T01:09:27Z
transaction,26ee887a-f9ec-4a56-b469-dc3927a8d67b,posted,Wdl ATM WESTPAC IGA BALGOWLAH BALGOWL AU,-4858.17,10732ecf-7b6c-4b46-a703-95e205ca7b42,-11469.68,debit,bank-fee,AU00000,2023-12-08T18:42:40Z
transaction,35139b4b-c18a-4548-8664-986671c95b2d,posted,Uber Ride,-3239.71,be83911d-663d-4670-9351-328379db57dd,-14709.39,debit,cash-withdrawal,AU00000,2024-04-08T18:09:58Z
transaction,f35c60f3-c128-470e-b0ae-3eb4b0afb4aa,posted,Pharmacy Purchase,-2231.72,a8384cc8-cc4c-4791-9e8e-054ee42bc821,6236.94,debit,payment,AU00000,2023-10-26T19:04:27Z
transaction,0f575771-37d1-4df3-a57d-756ce05f4049,posted,AGL RETAIL ENERGY LTD (GAS),-4003.55,37312c72-632a-4609-bdfa-b5e935683ca6,2233.39,debit,payment,AU00000,2024-05-07T08:20:48Z
transaction,f76974ef-c35c-4df6-953a-9a9b7df4d841,posted,Manly Maths Tutor Wages,-2775.54,fa735a50-f92b-45e7-9fb3-71e5c129223d,-542.15,debit,payment,AU00000,2023-11-07T06:03:59Z
transaction,39bed8f5-6408-4c8d-9c40-c686f0bd9f66,posted,Amazon Online Shopping,-3328.24,c0a623db-da3a-4916-b3a5-efa1ec1d1e89,-3870.39,debit,bank-fee,AU00000,2023-07-22T14:29:01Z
transaction,7def1f47-8332-47a9-9852-db1c4e2f8d88,posted,Wdl ATM WESTPAC IGA BALGOWLAH BALGOWL AU,-42.19,133d8caf-7da9-4e50-a7d8-5b1a69c0ee7c,-3912.58,debit,bank-fee,AU00000,2024-02-29T18:33:58Z
transaction,e774448a-bfa7-42e1-970e-8016006a24be,posted,Music Streaming Subscription,-1260.29,3fcf0ebf-a54a-4e81-b1df-0722f21fcda3,-5172.87,debit,bank-fee,AU00000,2024-04-15T05:58:57Z
transaction,2e6b7ac4-bfb8-439d-8c34-2aca21bdde39,posted,Bookstore Purchase,-935.09,34daddfa-93d7-4afc-b3f0-77186df96a60,-6107.96,debit,cash-withdrawal,AU00000,2023-07-08T22:03:27Z
transaction,05045379-0bcb-48e0-825b-a79cd715c5b8,posted,Non Hooli ATM Withdrawal Fee,-406.67,40ccf878-5e04-4b1d-b224-c66d683de5fa,-6514.63,debit,cash-withdrawal,AU00000,2024-02-13T21:40:04Z
transaction,36695558-3e86-4f0f-881e-ea3a3bf6512b,posted,Travel Agency Booking,-2119.49,673452ba-a8fe-4ca0-92c7-7ee927d9433e,-8634.12,debit,cash-withdrawal,AU00000,2023-08-29T04:53:08Z
transaction,62885b5b-ea53-415c-a3bc-916945a599fe,posted,Car Maintenance Expense,-765.42,3aacab18-8865-46ae-96d6-a75f0b6e7efc,-9399.54,debit,bank-fee,AU00000,2024-01-05T17:00:18Z
transaction,9d732279-a648-44f9-883e-aa92f6f66d37,posted,Home Improvement Store Purchase,-284.86,ced117c1-22c1-4851-b731-487632657ad4,13156.96,debit,bank-fee,AU00000,2024-03-18T19:50:28Z
transaction,9ce3c23c-4554-4d8d-a092-66775b55a121,posted,Music Streaming Subscription,-1587.02,9d1aae05-3a11-4392-bff1-4da5ed45eb82,11569.94,debit,cash-withdrawal,AU00000,2024-03-04T10:47:40Z
transaction,0a0de7a8-8e35-45a7-83c6-48d025c1a575,posted,Payroll WFRMS 15439393,11059.32,16c2a5a7-ddac-4319-9b3a-6e909d9fdbf1,22629.26,credit,transfer,AU00000,2024-03-03T14:12:05Z
transaction,042fda5e-8159-40ec-808f-ba8750fded85,posted,Mobile Phone Bill Payment,-191.92,96e4777c-2ee4-492a-80e1-e0310ce7fb74,22437.34,debit,bank-fee,AU00000,2024-01-17T04:26:37Z
transaction,e652bf73-5d6d-469c-b8de-3656c2e2b741,posted,Clothing Store Purchase,-3060.95,49d93ac3-e8c9-407d-977c-51efd30b2e2c,19376.39,debit,payment,AU00000,2023-09-29T22:27:31Z
transaction,0851634f-4ec3-41a9-8ec4-985b8f3e543e,posted,Clothing Store Purchase,-67.2,5d6a4430-1c66-46c8-bad9-f22d4167892e,19309.19,debit,bank-fee,AU00000,2023-08-21T01:09:18Z
transaction,91201385-408e-47fb-a6da-74dec7148406,posted,Clothing Store Purchase,-3784.38,ca203d74-59c6-4e92-b891-d54b70b6426e,15524.81,debit,cash-withdrawal,AU00000,2024-03-14T11:54:08Z
transaction,601bbb68-f3b7-4735-bc13-7b920d988517,posted,Coffee Shop Purchase,-2339.29,9c6f8df3-f926-4916-a8d8-2123f011e52a,13185.52,debit,payment,AU00000,2023-12-22T02:44:06Z
transaction,98886e7b-7de6-4f49-b820-ec3cf32538f3,posted,Uber Ride,-1638.86,f192f594-74fa-4c76-94e7-372304bc2db6,11546.66,debit,payment,AU00000,2024-01-01T02:21:51Z
transaction,57b63010-9523-41f7-8436-3528cc77e6d3,posted,Travel Agency Booking,-3332.01,7c4b3eca-ba43-4983-853b-b0539fc22215,8214.65,debit,bank-fee,AU00000,2023-11-05T12:41:42Z
transaction,59f13bb3-79ec-4607-a812-f7008c2200f3,posted,Uber Ride,-3226.85,1b201aaa-dcb4-4d61-a9d7-ecb9f1a6b7cf,8918.67,debit,cash-withdrawal,AU00000,2023-08-31T19:54:48Z
transaction,ba30b981-83f8-4014-97e3-742d450f400a,posted,Coffee Shop Purchase,-2595.69,bbf54f2a-5251-4ee0-8aa6-8f3b568b1999,6322.98,debit,payment,AU00000,2024-03-17T22:40:20Z
transaction,fa531329-4bfa-4247-b393-cae307af61cf,posted,Gym Membership Fee,-1614.07,5882f73c-36c5-4245-b712-82dc385c2d5f,4708.91,debit,payment,AU00000,2024-02-09T08:43:17Z
transaction,f945c351-dcc0-45af-9be1-3ba927505974,posted,Online Gaming Purchase,-2616.69,5f413e3f-c15f-4fad-a147-5edcf4ad6450,2092.22,debit,cash-withdrawal,AU00000,2023-10-07T07:24:45Z
transaction,d17177d4-38fc-4afd-9da7-f5d97c8e6ae2,posted,Home Improvement Store Purchase,-3712.41,4bb8c071-ab72-4bda-85b6-b573038e5154,-1620.19,debit,payment,AU00000,2023-05-23T12:55:49Z
transaction,934800fc-8ac9-4dc1-a489-3b1f0376f260,posted,Coffee Shop Purchase,-533.39,b1a695c2-5176-4d90-9937-17f5a51fb7b8,-2153.58,debit,payment,AU00000,2023-07-02T02:50:01Z
transaction,ff129be0-23a2-4a93-a8a8-17c36e98506d,posted,Payroll WFRMS 15439393,10556.14,56831c47-8661-4659-8627-73df3f1e61a4,8402.56,credit,transfer,AU00000,2023-06-23T14:48:50Z
transaction,f2b1e82b-0b27-425c-bfe9-c4d4c1b0a9a6,posted,Transfer Platnm Homeloan 346454,-2667.7,00d8996b-3b6c-4a46-b6bd-35579e4922ba,5734.86,debit,cash-withdrawal,AU00000,2024-01-29T13:35:22Z
transaction,79111240-fc5e-4dab-b1b7-1246c63a9cfc,posted,Manly Maths Tutor Wages,-3148.96,bde9e12f-3fb5-43c8-8efd-9bd65acb5e0b,2585.9,debit,bank-fee,AU00000,2024-02-22T07:00:05Z
transaction,c7803eb7-c6f1-44f0-82ac-63e9c4637ece,posted,Pharmacy Purchase,-4868.04,300d2e29-1b9b-4795-bb6f-ed469cb3de46,-2282.14,debit,bank-fee,AU00000,2023-11-16T13:31:04Z
transaction,f8d2f642-bd5c-4965-8645-599dc8b0ddcd,posted,Payroll WFRMS 15439393,10510.62,fd6458d2-1c32-43c3-b425-11097aa4b2ac,26986.18,credit,transfer,AU00000,2023-07-02T22:57:52Z
transaction,d3f9b35d-c6fd-4e65-84a3-2aba9275744a,posted,Gasoline Purchase,-2233.74,8f0813ea-b8b1-4de7-a896-dea3d02bc696,24752.44,debit,payment,AU00000,2024-04-10T04:23:52Z
transaction,d3361852-4b28-4a55-8119-72aabcdf1c3c,posted,TRANSFER TO JOANNA SMITH CAMPING,-1350.57,abaaebe0-d380-4039-9686-f3e67bee3efe,23401.87,debit,payment,AU00000,2023-08-27T21:43:34Z
transaction,e9677a24-49ba-41c2-80fc-b4b4c5290ac9,posted,TRANSFER TO JOANNA SMITH CAMPING,-4813.25,4be9fd21-3d2c-49e3-80e4-28500ccf01e9,18588.62,debit,bank-fee,AU00000,2023-05-19T23:33:46Z
transaction,86b92e66-a421-4917-8a35-1c2114f486f9,posted,TFR Acc14000 TO 12389,-3804.0,b48ed913-e248-4719-ad11-f33fd2a89679,14784.62,debit,cash-withdrawal,AU00000,2023-08-31T01:47:27Z
transaction,e37ba86c-cae4-4e07-9aec-fec70da75832,posted,AGL RETAIL ENERGY LTD (GAS),-3214.42,d4c15356-4a66-459b-a578-48160f458a32,11570.2,debit,bank-fee,AU00000,2024-03-12T07:32:49Z
transaction,33da15b4-7b92-45a6-aa4b-d198f9bb2cfb,posted,Netflix Subscription,-4648.74,36968a74-36e1-4f60-b201-61f666373888,6921.46,debit,cash-withdrawal,AU00000,2023-08-13T08:57:46Z
transaction,3072286a-16f5-4b51-8de7-893fdfe3e373,posted,Gasoline Purchase,-199.61,ce896185-cce3-4827-8c92-f37170ce3660,6721.85,debit,bank-fee,AU00000,2023-09-15T15:49:07Z
transaction,1b492d22-8b83-48a8-aa3c-d69138ae8cc2,posted,Gym Membership Fee,-4291.2,17759ea4-0f5a-4417-81a3-ddfa914878e5,2430.65,debit,bank-fee,AU00000,2024-01-15T22:51:25Z
transaction,a82a71d7-ec1f-42dd-a272-523e10aecb61,posted,Manly Maths Tutor Wages,-4798.22,d5606e0c-7094-4043-a203-c76487eaef1b,-2367.57,debit,payment,AU00000,2023-12-05T13:08:15Z
transaction,aba76adf-7a69-44e2-bf94-662ed974124e,posted,AGL RETAIL ENERGY LTD (GAS),-411.97,6f3f7bde-6792-4049-a144-1f97194e35ce,14357.0,debit,bank-fee,AU00000,2023-05-28T08:47:32Z
transaction,a01bc85f-2b0a-473e-b666-5cb2eba9b395,posted,Payroll WFRMS 15439393,10882.53,64b6a3c7-0d56-44be-9075-5e78a8e40fcd,25239.53,credit,transfer,AU00000,2024-02-27T19:10:17Z
transaction,a55e5983-be8b-4365-aea9-6d7d939501a8,posted,Mobile Phone Bill Payment,-747.09,5f85691e-bfcf-41b9-9dc1-c477cf3927dc,24492.44,debit,cash-withdrawal,AU00000,2023-11-19T17:10:34Z
transaction,10e733b1-fc56-46f6-932e-837b5e008a51,posted,Payroll WFRMS 15439393,11219.2,2b5e2fb4-3987-43c7-acdd-09de9087b403,35711.64,credit,transfer,AU00000,2023-06-25T21:42:29Z
transaction,69cece13-6a2a-4c6d-81c4-40d37c239897,posted,Payroll WFRMS 15439393,10884.25,7da806b3-1f68-407b-a895-47b8185e851f,46595.89,credit,transfer,AU00000,2023-11-22T11:14:29Z
transaction,cda7f06c-3237-4240-8412-177aa010b872,posted,Transfer Platnm Homeloan 346454,-3108.07,618d313f-7138-49bf-8b29-844b11f6335e,43487.82,debit,bank-fee,AU00000,2023-11-05T03:07:28Z
transaction,173feb35-f1bc-423c-a9cd-b830e638b385,posted,TRANSFER TO JOANNA SMITH CAMPING,-1159.95,a79a4c49-58cf-4cb7-87f8-1e1f5498b4ac,42327.87,debit,bank-fee,AU00000,2023-05-21T03:43:03Z
transaction,431d96dd-e4dd-4ab8-a3eb-953a91aa90bf,posted,TRANSFER TO JOANNA SMITH CAMPING,-2228.93,8e5dbfb8-b535-48af-a752-32a648a8264d,40098.94,debit,cash-withdrawal,AU00000,2024-04-10T18:53:38Z
transaction,80e19c34-15a5-4f3b-ad88-0f9fdf6272ae,posted,Mobile Phone Bill Payment,-1541.4,b21f8330-cf12-4f9a-b020-7cc129c951ff,38557.54,debit,payment,AU00000,2024-01-20T23:48:00Z
transaction,d9526d98-7d2c-432a-bd53-c4d8b0bfba23,posted,Restaurant Dinner,-1361.08,fa5eeb61-e5cc-40ff-9862-38ad8e721b89,37196.46,debit,payment,AU00000,2023-07-25T04:14:07Z
transaction,ac81fa2d-e832-4f76-8df3-eb978491fe01,posted,Clothing Store Purchase,-3621.68,8a021feb-ee05-421b-a132-762b98fcba64,2824.85,debit,bank-fee,AU00000,2024-01-31T10:16:25Z
transaction,c793d5b6-4792-43fb-963b-c48b39c7aebc,posted,Gym Membership Fee,-2704.67,7388080d-b404-414b-bf29-f4e7d0da14d6,120.18,debit,cash-withdrawal,AU00000,2023-08-06T19:57:45Z
transaction,dff65ef3-f1a9-44c2-848c-6d7b98b58c0b,posted,Manly Maths Tutor Wages,-4482.05,a1f568b3-d96f-4eef-8e85-2be1091b8e98,-4361.87,debit,bank-fee,AU00000,2023-10-29T17:58:00Z
transaction,1090658c-3ae5-4461-8cb5-6bab0956eb20,posted,Pharmacy Purchase,-3303.88,5c71564c-eda9-4abf-8112-4b0ee628672d,-7665.75,debit,payment,AU00000,2024-01-13T22:04:56Z
transaction,c3d880a0-e7e2-420b-8772-a627551a1086,posted,Coffee Shop Purchase,-1767.38,7db6bdf6-c6d8-4a12-9288-21529abb5b8f,-9433.13,debit,payment,AU00000,2023-10-10T20:32:40Z
transaction,a6b12a46-d170-43fc-8744-b4d131b817fa,posted,Bookstore Purchase,-4493.83,4b151533-4b0e-4c56-961c-f2193349d582,-13926.96,debit,cash-withdrawal,AU00000,2024-01-18T14:36:39Z
transaction,270c793d-f913-4d0e-a1d7-194cf1b6b1d4,posted,Payroll WFRMS 15439393,10908.25,d585e2a6-e4c9-472a-a230-8070134406d3,-3018.71,credit,transfer,AU00000,2024-02-22T01:19:24Z
transaction,b47b7bd2-7317-4081-8a19-da90b81fbb33,posted,Payroll WFRMS 15439393,10691.58,8a83bd5c-e5c9-410f-bff7-b92160fb869c,7672.87,credit,transfer,AU00000,2024-05-07T22:26:02Z
transaction,e1fba7cd-ef21-41ac-8546-be39b5935b1f,posted,Electricity Bill Payment,-1610.63,a5473c2d-e519-409f-9faa-561fdaaa1140,6062.24,debit,bank-fee,AU00000,2024-02-19T09:53:02Z
transaction,39ae60ed-bf1f-4c0a-b3aa-546ba7f33585,posted,Transfer Platnm Homeloan 346454,-3008.25,b334edc5-ee2a-471b-97ac-b84bf172e629,3053.99,debit,cash-withdrawal,AU00000,2023-12-20T18:12:08Z
transaction,08fd999e-0e9a-4652-9fc1-6d64802d912e,posted,Gym Membership Fee,-45.52,9aeeaaf2-ce94-4584-a4e0-6842e51e8bdd,13497.67,debit,payment,AU00000,2024-05-03T11:35:37Z
transaction,81ceecdc-7718-4f4a-b142-3add9a538499,posted,Online Gaming Purchase,-1191.81,84e1d839-7d1b-4c3a-a0d0-fe7ab7076b2a,12305.86,debit,cash-withdrawal,AU00000,2023-09-06T06:58:43Z
transaction,f2ec80b8-20a0-4b0b-b6b3-1c88d77771ee,posted,Gym Membership Fee,-1053.32,7866c43f-78e4-42e7-a51d-e4a88e4ce45f,11252.54,debit,bank-fee,AU00000,2023-05-16T04:59:57Z
transaction,62f02fcc-d816-48ca-ac7f-a6a12ce5e722,posted,Gym Membership Fee,-38.67,88df8495-7161-430a-9cb6-623d31ef9586,11213.87,debit,bank-fee,AU00000,2023-09-21T03:32:11Z
transaction,876c8fae-bae0-4380-8cdf-8dbcac9ccc69,posted,Car Maintenance Expense,-618.94,c5fbbb17-a881-4305-bae3-d97ba0482c48,10594.93,debit,payment,AU00000,2023-06-17T03:32:06Z
transaction,fa743af5-de8a-498c-97d6-3511e23d32ec,posted,Uber Ride,-774.95,1b1add08-0653-4b75-bccb-5f23d28aa157,9819.98,debit,bank-fee,AU00000,2024-04-22T21:35:00Z
transaction,7c77f54f-6a40-49f0-80d9-055ff2f66a6d,posted,Movie Ticket Purchase,-4233.5,6d8dc800-dfaa-4861-9aa8-95849e6aeb07,5586.48,debit,bank-fee,AU00000,2023-06-14T02:40:37Z
transaction,3f5bae7d-7904-40a6-904a-9c69022ea92e,posted,CTRLINK CARERS Ref: 998R6789201610974V,-3207.37,2544b7d9-f631-4e80-af05-6a4dc5328e96,2379.11,debit,payment,AU00000,2024-02-05T10:54:14Z
transaction,09c479c0-1ee3-4d83-a724-7973e29edabb,posted,Wdl ATM WESTPAC IGA BALGOWLAH BALGOWL AU,-1211.25,c6ea2810-7b4f-41f3-9538-e48e83cb1d2e,1167.86,debit,cash-withdrawal,AU00000,2023-11-14T03:35:21Z
transaction,b7ac2066-df2c-41ba-b533-7f0ab6fe9fcc,posted,Clothing Store Purchase,-1874.14,482ef2b8-1d90-4edc-817a-c582d6a35408,-706.28,debit,cash-withdrawal,AU00000,2024-04-12T09:31:20Z
transaction,3c1a2502-69cd-426c-b965-cdc3ace73fb1,posted,Restaurant Dinner,-1148.09,239d3447-77a6-4fae-882f-fd2e6fcb8744,6517.76,debit,bank-fee,AU00000,2023-12-13T06:33:38Z
transaction,8d63a5b2-a6a3-4501-a99e-e0822850c272,posted,CTRLINK CARERS Ref: 998R6789201610974V,-2930.7,27c4e95e-e5d8-4f61-bde0-96d655a7b9e8,3587.06,debit,bank-fee,AU00000,2023-05-16T21:50:33Z
transaction,af32b9b8-3a7e-430a-b223-8158b312e1df,posted,Coffee Shop Purchase,-2037.8,f5a0da37-ab6a-4924-b735-5e776910b866,1549.26,debit,payment,AU00000,2024-01-20T11:17:55Z
transaction,3b2b0f22-e9a8-44a5-93fc-0ef7720cba49,posted,Gasoline Purchase,-200.79,c72e437e-b227-4af4-ba07-9247e6b61f42,1348.47,debit,bank-fee,AU00000,2023-08-13T16:33:34Z
transaction,e6580e2e-152b-41fb-bb12-b2bd93d0058f,posted,Netflix Subscription,-4779.9,a676e958-5b8a-47fe-84a9-9034249bca32,-3431.43,debit,bank-fee,AU00000,2023-11-24T22:56:32Z
transaction,587471b7-ee3d-48b8-9f45-5ab7f5d1f58e,posted,Pharmacy Purchase,-232.35,97b2dbb9-8f3c-4ba5-aa31-1dae9088226b,-3663.78,debit,cash-withdrawal,AU00000,2024-04-07T04:45:52Z
transaction,60e76f73-01ad-4bb4-9265-a0d9026a6b52,posted,Non Hooli ATM Withdrawal Fee,-3455.06,28d3438d-600e-40a0-b41f-b94272a02c54,-7118.84,debit,bank-fee,AU00000,2024-02-23T13:58:42Z
transaction,58a7abb9-d6ec-4619-a7d8-af86f95e492b,posted,Bookstore Purchase,-1362.94,f61daf4c-25d9-4a71-8cee-6df582931d03,-8481.78,debit,bank-fee,AU00000,2024-01-09T08:25:05Z
transaction,31492c57-ac3e-4b94-a85b-68ef9678469f,posted,Movie Ticket Purchase,-3370.72,cf4006ce-281c-4edc-b53f-d69a3b53eda8,-11852.5,debit,cash-withdrawal,AU00000,2024-01-24T20:04:35Z
transaction,8074bd86-8abf-4446-b395-4a87813d2bfc,posted,Manly Maths Tutor Wages,-4330.85,d1dc815c-fac8-456a-8bdd-a3c4e22f9edc,-16183.35,debit,bank-fee,AU00000,2024-04-27T05:00:25Z
transaction,a2e7ea4a-494a-4c37-b29f-06c006684ddd,posted,Pharmacy Purchase,-665.56,fb88bb96-ca84-4b39-ac9e-8c91cf18cb96,8246.01,debit,cash-withdrawal,AU00000,2024-02-14T14:53:22Z
transaction,4d2fe955-6956-450d-8616-9740cf0f27c7,posted,Coffee Shop Purchase,-3048.68,2d1e8c9d-dcab-4908-b086-b31a866326ac,5197.33,debit,cash-withdrawal,AU00000,2024-01-31T14:47:00Z
transaction,7d91f954-751a-4b2a-9bd8-3930a26491c0,posted,Bookstore Purchase,-684.24,ff324689-6642-4306-bed5-d792ab2906c5,4513.09,debit,cash-withdrawal,AU00000,2024-03-23T20:44:00Z
transaction,5690394e-6546-434a-8f87-3fcc9cd9833b,posted,Gasoline Purchase,-1199.58,74edcf30-2eda-463a-a5cd-08846a04c9a8,3313.51,debit,bank-fee,AU00000,2023-06-19T08:53:36Z
transaction,eae9bc22-d080-47f0-853d-b6d123874975,posted,Hair Salon Appointment,-3003.31,91e10a2f-5ace-415a-8bde-f306d38f90d7,310.2,debit,bank-fee,AU00000,2023-08-10T19:21:12Z
transaction,c3b9b55f-26e9-4f5c-a408-71ded0374645,posted,Music Streaming Subscription,-34.45,987ddc17-bccd-45a7-9053-2641a044090c,275.75,debit,cash-withdrawal,AU00000,2023-08-05T09:04:33Z
transaction,a342ce8c-b752-414f-8b53-343d4a09a9ca,posted,Amazon Online Shopping,-3358.08,1490b680-110b-4083-847a-9aed8a59dca2,-3082.33,debit,bank-fee,AU00000,2023-09-30T18:46:33Z
transaction,878d7cd9-9a88-4544-b517-ea3d71b2d6b2,posted,Electricity Bill Payment,-2785.12,c857f34c-28e1-4bb0-be9a-dba8a4765e28,-5867.45,debit,payment,AU00000,2023-05-12T13:34:06Z
transaction,7050bf58-2171-4fea-a09e-1e58fd61a36f,posted,Music Streaming Subscription,-531.74,5197a250-d3e1-4b8d-b3ab-3396547baccf,-6399.19,debit,cash-withdrawal,AU00000,2024-01-07T03:26:11Z
transaction,c507bbc9-6363-467f-b1f8-ab7fcf4d1c82,posted,Movie Ticket Purchase,-1628.85,d5ff99a1-0aa0-43de-9639-b1ea9a3dd930,-8028.04,debit,cash-withdrawal,AU00000,2024-01-11T18:56:48Z
transaction,5cdeb740-472f-409c-9fcc-b5c42f25e7aa,posted,CTRLINK CARERS Ref: 998R6789201610974V,-2088.89,bee419fb-22eb-45bf-9c61-ccd2056f5ee8,7483.17,debit,payment,AU00000,2023-07-24T03:59:10Z
transaction,c66be310-8d02-4b8b-a4e9-89cce0a91934,posted,Uber Ride,-2853.43,ca06c42f-0044-44c6-abb2-bfd00332eea1,4629.74,debit,cash-withdrawal,AU00000,2023-10-24T21:18:57Z
transaction,b94a2a78-5fb7-4daf-9ff6-5da8c7510ddf,posted,Restaurant Dinner,-1135.68,555d0992-bd48-41be-8203-3423c3d431d2,3494.06,debit,bank-fee,AU00000,2024-02-09T13:46:17Z
transaction,84c21f80-86ad-4901-97c3-21cc06ab221e,posted,Home Improvement Store Purchase,-2356.05,b0f7a3a1-6d18-4dc2-a6b8-2e4075a12989,1138.01,debit,payment,AU00000,2023-08-04T09:25:28Z
transaction,800d9cf1-132c-4875-8886-74e5d0a5edb9,posted,Restaurant Dinner,-2423.73,d638e7ed-9bbe-4b7d-89f1-03845fee0a22,-1285.72,debit,cash-withdrawal,AU00000,2023-05-18T23:12:57Z
transaction,c9e9f594-afa3-4c7a-b47a-3f79e2b55d9f,posted,TFR Acc14000 TO 12389,-985.85,424b2c0e-2fe8-42e0-852a-4fd0edac6c82,-2271.57,debit,cash-withdrawal,AU00000,2024-02-03T09:55:35Z
transaction,7bf5320d-4da1-4894-aabb-41f619d1dc8c,posted,Clothing Store Purchase,-2464.09,6fb2c228-5d84-4f50-b6dd-36909ad8be3e,-4735.66,debit,cash-withdrawal,AU00000,2024-03-14T06:35:43Z
transaction,31ec5fda-8a17-453c-af4b-e16085f698d6,posted,Movie Ticket Purchase,-1849.22,147a5e2e-67a8-4913-9fb7-dffffd98c640,-6584.88,debit,payment,AU00000,2023-09-03T12:29:49Z
transaction,201c3bc1-8fbe-4a40-bf48-4de804ff5704,posted,Netflix Subscription,-343.73,c75984c6-db31-4060-9702-c2392fb53d50,-6928.61,debit,bank-fee,AU00000,2023-11-13T15:13:37Z
transaction,8027beff-965e-4075-b4b1-33a0917373bc,posted,Home Improvement Store Purchase,-3651.05,a8ff1dfb-601b-498a-80f4-199d001c218b,-10579.66,debit,payment,AU00000,2024-02-15T18:12:47Z
transaction,538b3c89-993a-4f6b-8b7c-321202440129,posted,TRANSFER TO JOANNA SMITH CAMPING,-4648.76,18a244b0-a45c-459b-865b-ca2712026d31,11541.79,debit,cash-withdrawal,AU00000,2024-03-04T06:15:06Z
transaction,f5961a83-b5a1-4e5a-88fc-a1b325907028,posted,Wdl ATM WESTPAC IGA BALGOWLAH BALGOWL AU,-872.86,45d62116-9272-4591-942a-55baae83ddfd,10668.93,debit,payment,AU00000,2023-11-16T13:07:02Z
transaction,7824e440-2e35-4156-a651-7cd18d07e7e8,posted,Non Hooli ATM Withdrawal Fee,-1079.85,1e3292b7-d202-4be0-a999-c482d844ded5,9589.08,debit,bank-fee,AU00000,2023-11-29T11:05:44Z
transaction,3802ab82-5a94-4cb5-954a-062a1261e93c,posted,Home Improvement Store Purchase,-4151.49,04ef9311-6f30-46d4-a3d0-28f8e655f1f8,5437.59,debit,payment,AU00000,2024-02-07T12:31:14Z
transaction,5ee79aae-285b-4f91-a066-5df7e86aa906,posted,Travel Agency Booking,-4509.44,94a356fb-d2f8-4f83-bb0a-d8b2ffdb4744,928.15,debit,cash-withdrawal,AU00000,2023-07-30T00:29:57Z
transaction,d4d9e252-2fbd-471d-9881-cdd9b725b3e8,posted,Electricity Bill Payment,-2781.74,d37a165b-6b18-4097-b1d6-4d1a770e5764,-1853.59,debit,cash-withdrawal,AU00000,2024-02-13T11:18:06Z
transaction,53b6008a-8474-4fb3-9d39-2023a61e487b,posted,Public Transport Fare,-933.06,e8c87ac1-8c2c-4d84-9970-7dfcaddd4329,-2786.65,debit,cash-withdrawal,AU00000,2023-12-27T13:19:57Z
transaction,604dca42-033f-4b5a-8237-5ded34bad41e,posted,AGL RETAIL ENERGY LTD (GAS),-1532.75,3069e8cf-be21-4ba4-a32e-73b073c32af7,-4319.4,debit,cash-withdrawal,AU00000,2023-11-20T16:42:53Z
transaction,963e8bb5-627f-46a1-b885-4e10b067134a,posted,TFR Acc14000 TO 12389,-3918.05,75b5404e-4445-41ce-8c12-ec06f0bff088,-8237.45,debit,bank-fee,AU00000,2024-04-12T02:09:52Z
transaction,9e2f6ddd-0d33-4382-adfe-f683694b784d,posted,AGL RETAIL ENERGY LTD (GAS),-3196.29,5c41d425-0f98-4789-b797-36854d1ad348,-11433.74,debit,bank-fee,AU00000,2023-11-14T09:44:46Z
transaction,ee9e72a8-1c7a-4900-8067-f8e585036b97,posted,Travel Agency Booking,-570.51,1405631a-71aa-4fd4-9dd9-997ef7d83e9f,13042.2,debit,payment,AU00000,2023-08-14T08:27:15Z
transaction,28e0f6c7-6359-4938-b473-8cf986bc7237,posted,Public Transport Fare,-2622.73,899cdf0c-709f-4d21-9436-ff4d453908f9,10419.47,debit,bank-fee,AU00000,2023-12-29T05:53:30Z
transaction,d325bb11-0937-4f7d-a532-470aa44f34be,posted,Mobile Phone Bill Payment,-3761.01,6054705d-426a-4149-86d7-d4ad9b5565c0,6658.46,debit,payment,AU00000,2023-09-25T06:04:56Z
transaction,22a15165-cdc9-4af1-a6c7-34e0b06cd589,posted,Mobile Phone Bill Payment,-875.55,40999edd-29d0-4748-b1f0-c7e4b951f486,5782.91,debit,bank-fee,AU00000,2023-07-13T04:18:32Z
transaction,b9cde90a-865e-4499-9488-1cd81601df03,posted,CTRLINK CARERS Ref: 998R6789201610974V,-2092.09,90411935-c457-4917-a319-18e4f088f355,3690.82,debit,bank-fee,AU00000,2023-10-17T05:20:33Z
transaction,452fe08d-5f1e-41c6-840b-f4996a01b3b8,posted,Public Transport Fare,-49.94,192923c0-6a88-481a-870a-4fa1fc345778,3640.88,debit,bank-fee,AU00000,2023-07-05T15:17:13Z
transaction,bfd68cb8-8020-4555-98b5-efc8eb19c207,posted,Travel Agency Booking,-664.0,0f528d09-41f8-4b89-ba4c-3a4d949ef871,2976.88,debit,cash-withdrawal,AU00000,2023-12-02T16:23:46Z
transaction,3f861c09-82fb-4ff6-b5e2-8567cd6bda1f,posted,CTRLINK CARERS Ref: 998R6789201610974V,-900.24,a2467ef1-2db7-4a21-88ae-01e333b3fcdf,2076.64,debit,bank-fee,AU00000,2023-09-16T11:35:27Z
transaction,2467eb34-1f53-4057-92dc-4d641ada562a,posted,Gasoline Purchase,-2732.82,236a6b70-2edf-4190-be08-f811b6b9c99c,-656.18,debit,payment,AU00000,2024-03-24T16:23:35Z
transaction,7c646af5-5cf1-424d-9e1a-2a82c72776ce,posted,Hair Salon Appointment,-2488.2,c42c3f97-baed-4c04-b701-6228708a7d2a,-3144.38,debit,payment,AU00000,2023-08-09T13:21:13Z
transaction,60b49b8b-bb2b-4770-b653-329984ba40bb,posted,Online Gaming Purchase,-2442.75,c4b1495a-0bf2-4057-a6e2-25767539fa6a,9570.65,debit,bank-fee,AU00000,2023-08-04T21:08:31Z
transaction,6f41f479-5189-4e36-bae7-cb8208b0658a,posted,Manly Maths Tutor Wages,-4365.13,a746f704-168f-4e72-9732-6a5c5a444996,5205.52,debit,payment,AU00000,2023-12-10T10:46:49Z
transaction,0fe2261a-f66c-46ad-90e2-74d34adef7f2,posted,Payroll WFRMS 15439393,10994.56,4629a4d3-c430-41f8-ae63-d4f3b75d64a6,16200.08,credit,transfer,AU00000,2023-07-02T05:06:06Z
transaction,cb9e5f4b-18fa-40a9-8820-3b16222c5a15,posted,Coffee Shop Purchase,-3227.97,e47ceeae-c076-4a5d-bf45-b2da7ed6ca37,12972.11,debit,bank-fee,AU00000,2023-08-31T06:13:31Z
transaction,cb1d49f0-c343-4e65-a140-4360518d9ee0,posted,AGL RETAIL ENERGY LTD (GAS),-4147.01,98e76a5c-ebcd-47b3-b2b5-9d2032be5860,8825.1,debit,cash-withdrawal,AU00000,2023-06-21T17:55:19Z
transaction,d1772e9f-daa6-417e-8c91-8f841ef71e73,posted,Home Improvement Store Purchase,-3819.11,86750b91-3365-4207-bfb8-0d58131a7c85,5005.99,debit,cash-withdrawal,AU00000,2023-07-24T23:53:38Z
transaction,b9e660b1-2561-4da0-a5a8-e8f7868b99b8,posted,Payroll WFRMS 15439393,10263.34,ee53326e-a652-41d5-8f27-08e932439d53,15269.33,credit,transfer,AU00000,2023-12-23T16:13:22Z
transaction,df10eb7f-b0c8-4e9a-aaa7-46962944d571,posted,Car Maintenance Expense,-3996.49,4a5ab5ad-d0dd-4051-9662-32ad0da7eff7,11272.84,debit,payment,AU00000,2023-08-30T21:10:19Z
transaction,978d87b1-bc46-4db6-873e-c18234adcfe7,posted,Amazon Online Shopping,-241.77,efd04d44-8d9c-4598-ba07-9be55e0cca71,11031.07,debit,payment,AU00000,2023-11-19T14:28:10Z
transaction,369f57c3-6fed-487d-800c-2b3c2a36811b,posted,Gym Membership Fee,-833.83,8f899948-2722-4467-9b27-7eea47725abd,10197.24,debit,bank-fee,AU00000,2023-08-10T00:20:29Z
transaction,a79f99e1-0a1c-48e9-8f14-75d93542c5dc,posted,Pharmacy Purchase,-4979.56,ca44b6d2-41ef-4e51-9d7a-22c71cdd9b47,4340.24,debit,cash-withdrawal,AU00000,2023-10-30T04:58:54Z
transaction,c877bef1-bb47-4764-aa4f-ab8b83f9594c,posted,Restaurant Dinner,-2897.63,9612f4fd-de88-4e75-9cb3-8f24f27b422a,1442.61,debit,bank-fee,AU00000,2024-04-21T21:55:42Z
transaction,a8d0e875-0a32-4aa4-a251-b4a10e6ef9a7,posted,Pharmacy Purchase,-4337.0,9aa7d636-5847-49ee-9883-1a8ee6e63fc2,-2894.39,debit,bank-fee,AU00000,2023-07-12T19:22:15Z
transaction,927c491c-7342-44b0-9adc-97eaadfc0702,posted,Coffee Shop Purchase,-1610.74,82c76fef-18d3-46bc-bccb-3fa96c5c72e3,-4505.13,debit,cash-withdrawal,AU00000,2023-08-17T13:13:29Z
transaction,f2d6d39a-0db7-4d84-bd2a-0ca3c3453ec9,posted,Transfer Platnm Homeloan 346454,-3435.89,d4123200-e9cc-4119-917c-f861c1e60f97,-7941.02,debit,payment,AU00000,2024-02-16T20:41:08Z
transaction,b13f7a0d-0e6c-476a-8de6-f93ef5147826,posted,Gym Membership Fee,-2508.59,e29c6088-3cfa-41ba-910d-947dda7555e1,-10449.61,debit,payment,AU00000,2024-01-15T18:54:34Z
transaction,9c51dba6-e62f-428a-a749-f851d4b12c72,posted,Car Maintenance Expense,-3845.24,fecf5086-c35f-4c39-a597-04a00ed4ef94,-14294.85,debit,bank-fee,AU00000,2023-12-30T22:55:56Z
transaction,5cbd95ed-e62f-4e2c-9ad7-1667e9d376c2,posted,Clothing Store Purchase,-2394.86,9af27eb3-2f98-4822-ab31-3c5e93c18468,-16689.71,debit,payment,AU00000,2023-10-19T19:29:46Z
transaction,6e45111a-47d8-4740-892e-3f85af40b455,posted,Online Gaming Purchase,-4202.36,13f2408a-844d-4e2b-8a01-adfc8a59f131,-20892.07,debit,cash-withdrawal,AU00000,2023-11-28T13:52:28Z
transaction,5004dd23-1a7f-47e0-ade1-1c0f939051fb,posted,TRANSFER TO JOANNA SMITH CAMPING,-4081.62,fe609a27-4d53-4220-b297-8a6cbc90ee83,-24973.69,debit,payment,AU00000,2023-07-30T03:24:57Z
transaction,ce63c076-70e1-4280-a088-2a1e6622cd24,posted,Payroll WFRMS 15439393,11506.63,c9d55d49-989d-4692-ba50-53e056ace1bd,26859.83,credit,transfer,AU00000,2024-02-07T23:05:17Z
transaction,b4df8bfc-202b-4025-a0c3-7b49298daad2,posted,TFR Acc14000 TO 12389,-80.88,29afb21c-1bb7-483f-8a23-9c2262294864,26778.95,debit,payment,AU00000,2023-10-03T09:20:07Z
transaction,80f3dae7-4909-4771-8088-eaa1731092fd,posted,AGL RETAIL ENERGY LTD (GAS),-4761.65,07fb9bf4-74b4-49fe-9941-56f1bf635271,22017.3,debit,payment,AU00000,2024-01-25T04:43:50Z
transaction,8a468df9-0160-422d-91ac-e8bcea004ebf,posted,Hair Salon Appointment,-917.28,d3e6ba4d-e742-44d1-8c6c-b471fc614e37,21100.02,debit,payment,AU00000,2023-10-06T08:15:16Z
transaction,8100bf94-2822-456d-8d43-d0f901f5a66d,posted,Uber Ride,-133.4,67ce0a76-5f0a-4e71-af1c-26a5c904f7d1,20966.62,debit,bank-fee,AU00000,2023-05-21T09:31:29Z
transaction,6e24598b-59c3-41b6-aee1-4d85ce9a5a06,posted,Gym Membership Fee,-4083.34,5deb96d4-5db5-4aae-8766-d1bd90d07a51,16883.28,debit,cash-withdrawal,AU00000,2023-06-15T00:35:00Z
transaction,86c6ef23-c1fa-466e-9eca-81dbc5c2018c,posted,Payroll WFRMS 15439393,10054.32,0b5c328f-9bae-4e77-a9ff-39952a1cd2f2,26937.6,credit,transfer,AU00000,2024-02-02T06:53:54Z
transaction,3fcd7cc5-ab66-4520-9097-0120dbd08223,posted,Wdl ATM WESTPAC IGA BALGOWLAH BALGOWL AU,-3934.4,75330d3c-85f7-440b-af31-bfb9440d65c1,23003.2,debit,bank-fee,AU00000,2023-07-10T08:28:03Z
transaction,d192940d-a0c0-4227-abec-0ad11b516fdf,posted,Hair Salon Appointment,-227.18,ec948c8d-9368-4232-aa11-288a0df44dca,22776.02,debit,bank-fee,AU00000,2024-02-05T18:23:30Z
transaction,2b1f0d32-e787-47bc-b616-b0d52e024d7c,posted,Pharmacy Purchase,-232.15,7f706fbd-ceda-40bc-8bdb-8f62a5f8200f,22543.87,debit,bank-fee,AU00000,2023-08-21T00:22:12Z
transaction,6654fa38-7684-4f99-af2a-46b362edde92,posted,CTRLINK CARERS Ref: 998R6789201610974V,-3165.89,c9abc3ee-ba62-4d08-b048-cb2060ad2af2,8376.58,debit,payment,AU00000,2024-01-16T14:22:46Z
transaction,96b5db7e-4451-4abd-b6bb-6dd4c7bd81dd,posted,Manly Maths Tutor Wages,-1028.91,5153d7d4-1a06-4016-94ec-e5dd1c04ea8b,7347.67,debit,bank-fee,AU00000,2023-11-15T16:26:53Z
transaction,42271647-f116-462a-9d1a-b211a4ce4bc6,posted,Music Streaming Subscription,-4418.1,6aa72485-9a99-4bac-b9eb-78ca90992cdd,2929.57,debit,bank-fee,AU00000,2023-09-28T14:46:13Z
transaction,f79eda93-e824-44b4-8241-4636c0d41b87,posted,Payroll WFRMS 15439393,11873.74,79208f84-a753-44b9-8cca-e7c8f61f64e4,14803.31,credit,transfer,AU00000,2023-10-28T20:41:05Z
transaction,60c54530-93be-4a75-819b-eb974ad62034,posted,Netflix Subscription,-2722.47,5aa40bfb-25c3-4cc5-a02e-22f04df1071b,12080.84,debit,cash-withdrawal,AU00000,2024-03-29T04:12:47Z
transaction,7f9f096c-165d-4279-8722-435629a6582b,posted,Manly Maths Tutor Wages,-2775.5,1a3df8ae-ee92-48cd-b9fc-d18a6c75255d,9305.34,debit,payment,AU00000,2024-04-21T02:24:39Z
transaction,9efed8a1-8a02-4c7a-a0bb-72e2ab9d5b99,posted,Car Maintenance Expense,-342.87,06444ce4-e65c-44fc-a53d-526fdd7a5dde,8962.47,debit,bank-fee,AU00000,2024-04-27T10:44:08Z
transaction,19c49aa9-1009-4e05-9eb1-7c27dccf794d,posted,Public Transport Fare,-1896.22,b9e26fb0-67e0-49d8-8142-9688e9a0004b,7066.25,debit,payment,AU00000,2023-06-05T02:20:23Z
transaction,a28df91a-938e-4544-a427-9dfbbb5b8b4a,posted,Hair Salon Appointment,-730.62,2252e9f2-7884-41ac-bb86-33e2fdf7b7e6,6335.63,debit,payment,AU00000,2023-09-09T05:04:26Z
transaction,4d1dca35-6a70-4800-a916-6cba59492902,posted,Car Maintenance Expense,-3989.17,91174aab-13e2-4a81-a172-48d623df8bab,2346.46,debit,payment,AU00000,2024-03-16T09:24:20Z
transaction,956733bf-ceca-45be-8e1d-5f07cec4cce7,posted,TRANSFER TO JOANNA SMITH CAMPING,-1484.65,b4893f79-553f-4e47-8627-d6ddb3cd6fb5,6895.75,debit,cash-withdrawal,AU00000,2023-06-29T13:01:17Z
transaction,309f2332-b154-4c95-bc93-c26c38eba7bf,posted,Movie Ticket Purchase,-195.24,1f569f66-e846-4103-a0c1-011c265b7060,6700.51,debit,bank-fee,AU00000,2024-02-26T01:19:18Z
transaction,f7ae5057-1ae5-4dd0-a60f-51a9f560f817,posted,Pharmacy Purchase,-1401.98,57980299-7379-43d3-a09c-c8ed9356c297,5298.53,debit,cash-withdrawal,AU00000,2023-12-31T21:32:44Z
transaction,0531c6a0-0ef1-47c6-8abc-5e10d68bf985,posted,Home Improvement Store Purchase,-4415.4,f80c9697-8bdb-4e7c-b3c5-3f608741913d,883.13,debit,cash-withdrawal,AU00000,2024-02-22T05:28:34Z
transaction,18b22589-7555-4df9-9d66-fb3f964db531,posted,Pharmacy Purchase,-1628.47,47c44524-6fb0-4ebd-a44a-b3075243f5c6,-745.34,debit,payment,AU00000,2024-03-19T19:17:47Z
transaction,423b02b2-dbd4-4970-99e8-10aaaaf9561c,posted,Transfer Platnm Homeloan 346454,-4145.43,075a3446-a7da-41ba-abd9-bd88977d0b00,-4890.77,debit,payment,AU00000,2023-07-04T15:37:49Z
transaction,9a7e93d1-894f-45ab-a5e2-f617dd766600,posted,Music Streaming Subscription,-420.57,f9216e79-b63c-44b5-8a40-c05ffa6298e8,-5311.34,debit,bank-fee,AU00000,2023-08-21T07:37:34Z
transaction,376232f7-6a95-4844-9392-de93369043a7,posted,Electricity Bill Payment,-1383.83,7c57f03b-ab80-4c3e-bdc5-0664eeca4613,-6695.17,debit,payment,AU00000,2023-06-17T08:19:23Z
transaction,a9538f91-b4e4-4841-92c9-96acfe2e4e50,posted,Uber Ride,-4925.43,48f25fd0-8fb9-4fc8-a4b4-9cdcb5db73ff,-11620.6,debit,cash-withdrawal,AU00000,2023-10-10T19:16:51Z
transaction,b5c50083-37b7-4de4-b058-46a68122a9a0,posted,TRANSFER TO JOANNA SMITH CAMPING,-4403.67,8937be0e-dcfa-4387-b29d-42fc9a372652,-16024.27,debit,cash-withdrawal,AU00000,2023-09-08T11:47:00Z
transaction,22a4499b-5173-438b-9257-47f9db5b6dee,posted,Non Hooli ATM Withdrawal Fee,-3774.7,838ef138-66c8-421c-8982-4abfa14df936,10531.9,debit,bank-fee,AU00000,2023-10-10T21:26:26Z
transaction,355474a6-e0f3-45d9-b767-3d699a235450,posted,Manly Maths Tutor Wages,-4118.05,58df0555-5ed8-49b4-a88c-7e6ee232420b,6413.85,debit,bank-fee,AU00000,2023-11-05T21:42:25Z
transaction,a09380fa-f8fc-41d5-acdb-d5517854656b,posted,TFR Acc14000 TO 12389,-4587.41,1f5393f2-60ee-458a-a67a-0a1fa38a7606,1826.44,debit,cash-withdrawal,AU00000,2023-12-18T17:11:26Z
transaction,a603fc63-7275-49f2-806f-094b4e5f9951,posted,Gasoline Purchase,-2116.12,3ffaf157-f495-4b4e-b521-c773b81a4e89,-289.68,debit,payment,AU00000,2024-02-17T18:21:09Z
transaction,fa14ed09-73cf-46ff-b7f7-f4e2955d66a7,posted,Restaurant Dinner,-569.07,e1b962d3-2a82-4196-8bfe-8d3245b07af7,-858.75,debit,payment,AU00000,2023-12-02T02:07:39Z
transaction,c7665ef8-d2b5-49ec-91c9-1e77afb0697e,posted,TRANSFER TO JOANNA SMITH CAMPING,-3183.87,fc1e82a8-d302-4478-a225-dce2277e37f3,-4042.62,debit,payment,AU00000,2023-08-03T06:39:57Z
transaction,c747a0b3-d842-4bce-9171-ecf5cca82fe7,posted,Gym Membership Fee,-596.69,fa3a5d6e-1671-4846-8c19-1e56f388619a,-4639.31,debit,payment,AU00000,2023-06-23T21:58:34Z
transaction,cd1df950-2d3b-490d-8cdb-ae8d03801e3f,posted,Travel Agency Booking,-1450.42,3822e680-85ca-4f94-ad5b-136f32d86146,-6089.73,debit,payment,AU00000,2023-08-08T23:02:09Z
transaction,65dd54d8-2563-4c9f-b522-67909d3c81a4,posted,Gasoline Purchase,-210.28,3e299595-a889-4e47-8b3b-fdfe36de3371,-6300.01,debit,cash-withdrawal,AU00000,2024-01-25T10:48:56Z
transaction,d8e75bde-de96-4374-9a90-eeda15e864be,posted,Public Transport Fare,-4675.01,a3433e72-b349-4eea-8a53-424100e7bce8,-10975.02,debit,cash-withdrawal,AU00000,2024-04-03T05:32:25Z
transaction,e183953e-a678-475e-aa4b-f19586ffe54a,posted,Gym Membership Fee,-2915.72,cba83285-18fc-4aac-b7ea-86b57ccac88b,5730.13,debit,bank-fee,AU00000,2024-05-01T11:04:25Z
transaction,55ad3b3e-ee1f-42b2-b2b2-d1425078ba1b,posted,Transfer Platnm Homeloan 346454,-4178.44,c5e8a022-e136-4e5e-bf39-9896ecb70482,1551.69,debit,bank-fee,AU00000,2024-04-28T19:25:46Z
transaction,4a2c1e9d-6ca1-4b4f-a688-9c2f4b536f1b,posted,Amazon Online Shopping,-1387.55,cacafc0b-240b-4213-a44e-a62fc32da143,164.14,debit,bank-fee,AU00000,2024-03-21T01:45:30Z
transaction,ea5a0a8e-baea-4a4a-bc99-675f7b9cbdba,posted,Wdl ATM WESTPAC IGA BALGOWLAH BALGOWL AU,-1878.46,9360dbd8-daa5-4fde-b8c4-03710acbaf07,-1714.32,debit,payment,AU00000,2023-05-30T23:43:43Z
transaction,c3b12a4b-abbf-438e-ac86-e77e1579f199,posted,Music Streaming Subscription,-2426.89,3d91edec-2e5f-4c9c-a8d7-0d419eb3034a,-4141.21,debit,cash-withdrawal,AU00000,2023-06-11T13:37:49Z
transaction,22014e81-49a6-4c65-9f77-8f77ec49f776,posted,Clothing Store Purchase,-4890.58,ccacc56b-e7a4-422a-ab86-d0e3d921f657,-9031.79,debit,bank-fee,AU00000,2024-02-19T09:56:19Z
transaction,bdba9edf-2d63-4ead-ab61-20ec2575223a,posted,Hair Salon Appointment,-514.56,e4d5ae78-36b4-4220-aa47-3baea16220e9,-9546.35,debit,bank-fee,AU00000,2024-03-06T06:32:28Z
transaction,c0fdf4f0-c081-4ff0-a508-aa39cb4a9f24,posted,Wdl ATM WESTPAC IGA BALGOWLAH BALGOWL AU,-1863.07,6d59300e-026c-4d2a-a0f7-b09cebbe5829,-11409.42,debit,payment,AU00000,2023-05-12T17:22:45Z
transaction,73fb759c-05e7-40c4-8321-e298a90a651b,posted,Clothing Store Purchase,-3867.83,0fa5c977-a7ca-4e6f-a92f-d3250042d52b,-15277.25,debit,cash-withdrawal,AU00000,2024-03-15T00:57:19Z
transaction,968cfceb-ef00-42cb-923e-2cecacd0e58c,posted,Clothing Store Purchase,-1691.8,c72368bb-5681-496c-b9b3-01bdceed6c85,-16969.05,debit,payment,AU00000,2024-02-09T14:15:43Z
transaction,0d46af0a-fda2-46a2-8b8f-5dae05c0e4f5,posted,Manly Maths Tutor Wages,-4273.6,7aa7eb94-5d59-48c5-b483-5e2aff678211,5637.76,debit,payment,AU00000,2023-05-20T20:14:54Z
transaction,e6a70304-4596-476e-803e-319db343bd17,posted,Mobile Phone Bill Payment,-1090.25,ccf81aa9-cee1-487c-9351-581b9749ca37,4547.51,debit,cash-withdrawal,AU00000,2023-10-30T09:47:57Z
transaction,4d980a40-e238-4e0f-b84b-8ccb5cd30feb,posted,Electricity Bill Payment,-4461.34,fe8248f4-2f3e-43b0-91a2-016bcad31a77,86.17,debit,bank-fee,AU00000,2023-09-05T07:28:40Z
transaction,6e1f4054-62f3-466d-a8a5-6481b38c006d,posted,Gasoline Purchase,-387.31,627852dc-6eba-4f9a-afa7-488e9cc42aa0,-301.14,debit,bank-fee,AU00000,2023-12-04T10:09:29Z
transaction,36785081-253c-4365-9768-05de78d1ca0b,posted,CTRLINK CARERS Ref: 998R6789201610974V,-1503.66,17077099-f079-461d-a527-7281f333474d,-1804.8,debit,cash-withdrawal,AU00000,2023-08-16T07:55:36Z
transaction,7fa7f967-4576-4121-bcb0-159660a54bae,posted,Wdl ATM WESTPAC IGA BALGOWLAH BALGOWL AU,-516.43,2d425ec4-37cc-452f-ac46-035bab22987d,-2321.23,debit,cash-withdrawal,AU00000,2023-11-09T03:01:47Z
transaction,34551081-850b-4a1f-b483-9a548f9dbd85,posted,Online Gaming Purchase,-782.39,3ee55fad-bd2d-489b-843d-add5767abe2c,-3103.62,debit,bank-fee,AU00000,2024-01-18T08:29:08Z
transaction,033f62fe-711d-48d2-bf96-173ebc669be4,posted,CTRLINK CARERS Ref: 998R6789201610974V,-1231.52,f107f61a-711a-4849-8678-24a565da0d5c,-4335.14,debit,cash-withdrawal,AU00000,2024-04-11T14:43:05Z
transaction,eeefd099-b583-45d9-b8de-fa25c262ae60,posted,Restaurant Dinner,-1970.44,cb204647-52f7-454d-86b2-c5a46d49ac48,-6305.58,debit,payment,AU00000,2023-06-02T17:25:35Z
transaction,56439615-5b9c-4f91-b161-cec0ddf5ba71,posted,Hair Salon Appointment,-589.97,0c9d022a-843f-4a1d-929b-78c5b7d17202,-6895.55,debit,bank-fee,AU00000,2024-03-24T11:18:16Z
transaction,72cf5fd0-0cba-43ae-96a4-f9059556cf76,posted,Movie Ticket Purchase,-1406.1,2bd36f98-3dcd-4186-8948-35d2ae58d5eb,6628.57,debit,bank-fee,AU00000,2023-05-16T19:20:01Z
transaction,50fdde38-97e7-40b5-bd0f-b31b09115eda,posted,Car Maintenance Expense,-881.55,d5ac7307-39d1-4126-bc34-c91d308817d1,5747.02,debit,cash-withdrawal,AU00000,2024-02-17T04:15:59Z
transaction,896bc8fa-e7d2-428c-83e0-6de667f7d04b,posted,Music Streaming Subscription,-4652.12,3fbbc43c-d114-4fcc-ad18-c7bad6d1ef68,1094.9,debit,bank-fee,AU00000,2023-06-14T05:54:56Z
transaction,7b8f02c1-fe60-4cf3-b559-08457fab7c74,posted,Restaurant Dinner,-1372.3,5b7ade88-eae8-4a1f-9bfc-a22d5051c741,-277.4,debit,cash-withdrawal,AU00000,2023-12-30T11:05:35Z
transaction,cdd29580-757d-4618-b34f-9f3cc01325ac,posted,Manly Maths Tutor Wages,-2540.36,4ae95570-d3e6-4915-af7d-aa6c61e554f8,-2817.76,debit,bank-fee,AU00000,2023-08-12T08:34:58Z
transaction,6a519885-2456-4b3a-8734-b55b6ba203fd,posted,Public Transport Fare,-2430.96,0ca5edbd-4c68-4af5-8922-83b27dbcc5d1,-5248.72,debit,bank-fee,AU00000,2023-06-10T02:13:38Z
transaction,3b6edc67-0cf1-468d-98ca-88c3ef6f5ba7,posted,Online Gaming Purchase,-763.01,f3ca0af3-9e80-403f-aa57-585db9c5106e,-6011.73,debit,bank-fee,AU00000,2024-02-23T21:14:48Z
transaction,79d53a24-7603-4890-a20a-838386e0d199,posted,Music Streaming Subscription,-1576.27,9bddf367-b5ed-4e66-9b00-84bbc639d674,-7588.0,debit,bank-fee,AU00000,2024-02-17T05:09:14Z
transaction,75ca0e2c-5491-49be-9eb7-712d46a46e2a,posted,Home Improvement Store Purchase,-3527.1,cc82d900-f92e-4010-ad2e-ddabdd5789dc,-11115.1,debit,bank-fee,AU00000,2024-02-21T13:00:38Z
transaction,21d41f76-4f71-4261-8e57-7aa97ca48536,posted,Transfer Platnm Homeloan 346454,-1910.18,e42ded0b-3f63-43e3-b470-f4e5d4dd762c,-13025.28,debit,cash-withdrawal,AU00000,2023-07-25T01:20:43Z
transaction,840d0d86-491e-40de-ba1f-09f3436f0e0c,posted,Uber Ride,-2235.0,06ee3a1b-36ce-4610-8dcb-7e4f4222a56e,4003.46,debit,payment,AU00000,2024-05-10T17:35:30Z
transaction,207b9d76-de59-47d1-bf9b-452b938d3372,posted,TRANSFER TO JOANNA SMITH CAMPING,-2507.77,847d94ba-115a-48db-8f0b-2a9ae0842542,1495.69,debit,cash-withdrawal,AU00000,2024-02-09T12:55:30Z
transaction,ce3c37b2-9f8d-422c-9c48-1baa16cf2453,posted,Wdl ATM WESTPAC IGA BALGOWLAH BALGOWL AU,-3685.62,32a0c064-d327-496b-b83f-10d741b8e0f1,-2189.93,debit,bank-fee,AU00000,2023-08-12T05:25:35Z
transaction,e8493652-e813-45a9-9333-3732d8f45c0c,posted,Electricity Bill Payment,-3043.95,9ebc5ae3-0679-49ad-b4d3-13a6e3041cd0,-5233.88,debit,cash-withdrawal,AU00000,2023-12-11T01:10:46Z
transaction,3ca21f54-fd32-4214-861c-79a0c93c7c81,posted,TFR Acc14000 TO 12389,-2853.32,7913ddc4-58a9-4761-8303-d24f5cc32000,-8087.2,debit,payment,AU00000,2023-07-24T05:54:22Z
transaction,5a5a8512-4794-46bf-a329-2fe745932af6,posted,Electricity Bill Payment,-2192.69,47342e3f-98e0-467e-b38f-6cc06f3248b6,-10279.89,debit,cash-withdrawal,AU00000,2023-08-14T04:04:45Z
transaction,0fe6726c-4491-4fa1-bab7-b0aef262db6a,posted,Gasoline Purchase,-1957.27,12534cda-5b7f-4e64-8b0e-63620f90b5dd,-12237.16,debit,bank-fee,AU00000,2023-11-17T21:45:46Z
transaction,14c1c101-cdbd-4929-8a29-1f290653cc6e,posted,Gasoline Purchase,-4015.97,a94cd793-95dc-4c82-afe5-a849d4ace7c6,-16253.13,debit,cash-withdrawal,AU00000,2023-10-24T07:00:08Z
transaction,5222a2e2-567b-46a2-a901-35f6e776f4c9,posted,Pharmacy Purchase,-3318.87,b73a338e-204b-46fc-af7e-5c15e769c76a,-19572.0,debit,cash-withdrawal,AU00000,2024-04-24T23:12:02Z
transaction,6cd91fa6-cd00-4832-960d-0d354f23e864,posted,TFR Acc14000 TO 12389,-67.35,826528a8-1f90-459f-84f8-964a752b8cb8,-19639.35,debit,bank-fee,AU00000,2023-09-14T09:41:36Z
transaction,b1a79347-40a6-49ab-b27f-c17885566168,posted,Public Transport Fare,-2877.46,17677492-1a04-4b7c-89e1-bd4e3cf3022f,4938.96,debit,payment,AU00000,2023-12-07T22:36:41Z
transaction,ef28c14e-9e59-4f43-958e-b85f6a43e5d0,posted,Hair Salon Appointment,-3290.96,396309d0-f770-4e77-874d-44b4a63d251b,1648.0,debit,payment,AU00000,2023-07-12T15:00:13Z
transaction,d104fba4-a306-4c98-85f0-b63daddb8fbb,posted,Manly Maths Tutor Wages,-4247.11,62ede3d2-2ed3-4e4d-92f6-b19c1db14f66,-2599.11,debit,payment,AU00000,2024-01-17T05:31:11Z
transaction,d38d808a-b0a1-448f-8f64-9a50650d721a,posted,Uber Ride,-1857.86,f0d00668-6729-4396-8187-00625ef1d265,-4456.97,debit,payment,AU00000,2023-08-26T13:58:55Z
transaction,b77331db-ce68-495b-8606-d5049f9c5892,posted,Non Hooli ATM Withdrawal Fee,-53.97,c3eb81e1-471b-4c5d-8385-09715116e0c9,-4510.94,debit,bank-fee,AU00000,2023-09-11T23:10:50Z
transaction,4dade0e9-a788-46b8-b6cb-7b920b22fd57,posted,Coffee Shop Purchase,-1895.94,1da73b7b-cd2b-4828-a8be-77900020b002,-6406.88,debit,payment,AU00000,2024-02-03T10:04:43Z
transaction,25e5fc0b-a17e-4879-936c-bf16d947a350,posted,Movie Ticket Purchase,-1581.27,eae143fd-5af4-484f-8f2f-8e8b81deced9,-7988.15,debit,payment,AU00000,2024-04-01T10:57:50Z
transaction,1fe9a49d-d76a-4064-ada9-8cfb1e0b6fb2,posted,Manly Maths Tutor Wages,-688.58,1d791343-f63f-4daa-a0e3-580871528134,-8676.73,debit,cash-withdrawal,AU00000,2024-01-31T15:52:58Z
transaction,5bb7c40b-e6ff-4304-bfe1-9c8d2add23fb,posted,Travel Agency Booking,-1547.75,ba80b804-6795-4dd4-bc36-48be5d646297,-10224.48,debit,payment,AU00000,2023-05-18T22:31:12Z
transaction,84e2f55b-7fbe-4e5d-9f2f-af2c9d4ede8d,posted,TRANSFER TO JOANNA SMITH CAMPING,-977.66,42719038-bf0e-4444-b22d-5cfba59d9864,-11202.14,debit,payment,AU00000,2023-09-20T02:36:04Z
transaction,893dc337-2bd0-4b34-96ff-90eae5229949,posted,TFR Acc14000 TO 12389,-55.19,b57cf753-9dac-49f0-b028-b00b69f3ec20,15474.18,debit,bank-fee,AU00000,2024-03-13T05:34:28Z
transaction,f5bdd528-0639-4a24-85d5-9757628d28d2,posted,AGL RETAIL ENERGY LTD (GAS),-826.94,947e7a59-aa7e-47de-9a9c-487fa57f27ac,14647.24,debit,payment,AU00000,2023-11-30T03:21:13Z
transaction,f93a81a5-b844-4316-935c-b3fe1ee92842,posted,Coffee Shop Purchase,-2701.42,3722e083-00e6-41ac-8c47-49a350efe326,11945.82,debit,payment,AU00000,2023-10-29T07:21:02Z
transaction,87b6a0ec-5b8b-4c88-9b5f-bbead7b54afe,posted,Music Streaming Subscription,-4268.33,a5bb4cc7-025b-4b1a-937d-15aabce9b1c2,7677.49,debit,bank-fee,AU00000,2024-01-04T05:11:38Z
transaction,f99ff020-06df-49d7-9770-4d760e776cdf,posted,Wdl ATM WESTPAC IGA BALGOWLAH BALGOWL AU,-321.45,db11d8d5-f93a-4f15-92e3-0b92982e1407,7356.04,debit,payment,AU00000,2024-01-20T08:53:20Z
transaction,1f7a0f2e-09f6-4083-8475-957deeb6a344,posted,Car Maintenance Expense,-371.57,597973b1-1c14-411a-8788-505e1499abcd,6984.47,debit,payment,AU00000,2023-10-30T02:22:11Z
transaction,afccbde7-e03f-4657-8607-68055d0e1f82,posted,Restaurant Dinner,-1266.74,e3f072b6-2718-4131-8e74-49007e4cb073,5717.73,debit,bank-fee,AU00000,2024-04-24T15:56:55Z
transaction,5973a46f-aadc-4c94-a272-dae726e8a813,posted,Restaurant Dinner,-396.81,63d78f51-a218-4cd1-bf6b-0e9eb6d4585e,5320.92,debit,cash-withdrawal,AU00000,2023-10-06T03:30:45Z
transaction,5987584c-f062-4368-913d-8be4961c5d7f,posted,Bookstore Purchase,-1679.03,584e5a1a-ff63-44b6-80c1-b5e81933a39d,3641.89,debit,cash-withdrawal,AU00000,2024-05-10T19:22:17Z
transaction,01d90123-fca6-42a4-a8d6-6b8bc33ec456,posted,Non Hooli ATM Withdrawal Fee,-1990.43,059c1fde-5216-405d-94af-01a94d72c925,1651.46,debit,payment,AU00000,2023-09-26T14:21:34Z
transaction,4c427cf3-826f-463b-85aa-6d308d461cc0,posted,TFR Acc14000 TO 12389,-2851.61,8f85f74a-b6ef-4017-b779-290161044692,8843.1,debit,bank-fee,AU00000,2023-11-16T14:20:11Z
transaction,9e0272be-9017-47c9-8236-d08564d3191f,posted,Coffee Shop Purchase,-1460.5,da8a31f0-dbe6-417f-bc88-0c7f4df325ac,7382.6,debit,bank-fee,AU00000,2023-06-07T13:38:20Z
transaction,f705f1d6-24bb-418e-a692-559cc4d3708a,posted,Car Maintenance Expense,-1806.34,5c97bf2b-17b0-4df4-ab10-5ad50a02a155,5576.26,debit,bank-fee,AU00000,2023-10-10T19:23:57Z
transaction,f77040ae-e1d1-4c72-91a8-ad2809a01977,posted,TFR Acc14000 TO 12389,-4678.25,614f9cbc-8122-4e51-be5f-f0b6abc788b0,898.01,debit,payment,AU00000,2023-05-23T13:52:09Z
transaction,8823e243-cc31-4b7c-a70d-fe439bea93e1,posted,Pharmacy Purchase,-3721.62,792cb7ed-0f6d-4478-8c23-98065b41de1f,-2823.61,debit,cash-withdrawal,AU00000,2023-10-13T06:17:22Z
transaction,173d679e-2312-43f4-8ee0-51a9d5e382c8,posted,Travel Agency Booking,-2958.33,1f1a8eab-ccfc-4d80-8887-597f9a6b7d33,-5781.94,debit,cash-withdrawal,AU00000,2023-06-15T12:59:57Z
transaction,a8e510af-dacd-4446-95dd-8f32de65105d,posted,Pharmacy Purchase,-3815.43,c5f8e0f4-625e-41a4-8d4d-d63c72077a94,-9597.37,debit,payment,AU00000,2023-05-13T18:59:43Z
transaction,53d8c39f-590d-4814-b780-9cf7a1a949ad,posted,CTRLINK CARERS Ref: 998R6789201610974V,-1333.01,c71d665c-4732-4d6b-81b8-7a31729aa73f,-10930.38,debit,bank-fee,AU00000,2024-03-22T20:22:45Z
transaction,2d5747b1-d356-45af-84d0-a8f2c5744a63,posted,Manly Maths Tutor Wages,-1820.9,39a35f9d-a37d-49a8-b672-fe4efdd49719,-12751.28,debit,cash-withdrawal,AU00000,2024-04-21T13:07:07Z
transaction,7b7c6f49-f50a-40a1-989f-51e787dbfb61,posted,Hair Salon Appointment,-2485.19,1cd640a8-5d65-408d-b65c-fe5c8dbb9576,-15236.47,debit,payment,AU00000,2023-07-03T01:07:26Z
transaction,2bcd4159-e58f-43b0-9f7d-33da51218c50,posted,TFR Acc14000 TO 12389,-1975.27,22e4b07f-2bf9-4bba-b04a-9889ab9e76da,17571.42,debit,bank-fee,AU00000,2023-08-09T22:50:21Z
transaction,e7d2f878-af62-4143-b1fd-c20a7f976096,posted,Mobile Phone Bill Payment,-785.21,a45648ee-3ccb-4932-89d5-8e0409043ec8,16786.21,debit,bank-fee,AU00000,2024-03-03T19:16:56Z
transaction,4ea5901e-615b-48ef-ab5b-978da4e5656d,posted,Hair Salon Appointment,-453.67,b7b8d3ae-bbad-43ad-a6d4-42f316d74076,16332.54,debit,payment,AU00000,2023-05-28T08:48:43Z
transaction,4d955889-a402-4a73-aa0b-00c664cbee10,posted,Music Streaming Subscription,-2959.44,d612cf60-6911-416f-8edb-0718a7052148,13373.1,debit,payment,AU00000,2023-08-10T03:31:09Z
transaction,37c90e3b-bd09-495d-8080-40e515d5ee8d,posted,Wdl ATM WESTPAC IGA BALGOWLAH BALGOWL AU,-2053.99,02fd8940-f8f1-4147-8426-d915c5720f17,11319.11,debit,cash-withdrawal,AU00000,2023-06-26T00:00:02Z
transaction,b5da0fc2-6eec-49a7-a95f-6d995da79b3c,posted,Restaurant Dinner,-2434.17,5b5ee9c2-0d2c-4d74-91c2-9f0296ca0ee4,8884.94,debit,bank-fee,AU00000,2023-11-18T09:00:49Z
transaction,d5984bf2-a16d-4596-a9d4-dcaa4c818c2a,posted,Gasoline Purchase,-535.22,a650a727-6140-4059-920a-f40c7b27b7cf,8349.72,debit,bank-fee,AU00000,2024-04-14T16:57:59Z
transaction,e432193a-9596-452b-a651-e53ae4f27a7f,posted,Manly Maths Tutor Wages,-2844.26,b088a254-96ff-4cb7-a1ac-9b03245560a7,5505.46,debit,payment,AU00000,2023-08-02T10:04:01Z
transaction,8cdd01bf-25dd-4517-8470-44c347583d14,posted,Movie Ticket Purchase,-2133.61,a19d1b7f-73b4-4e8c-8577-556172bc6814,3371.85,debit,cash-withdrawal,AU00000,2023-06-01T05:51:39Z
transaction,f0a11e23-c395-4b97-94a0-14ab5c8b8714,posted,Electricity Bill Payment,-3200.89,1d917990-2c74-4a98-9d09-dd2754d88583,170.96,debit,bank-fee,AU00000,2023-12-21T22:57:51Z
transaction,980bbe10-400a-4a00-a38d-fa2e1f5690b9,posted,Car Maintenance Expense,-1875.47,e2a32664-fc33-46d3-9192-70edba76d56d,14045.52,debit,cash-withdrawal,AU00000,2024-04-07T14:56:25Z
transaction,c7115b06-fcf9-4680-a2f5-eb62b16264f2,posted,Clothing Store Purchase,-2335.64,fe2dac81-3e8c-4f0d-93a3-a18327f51581,11709.88,debit,bank-fee,AU00000,2023-07-27T06:13:29Z
transaction,7c8d21ea-0bcb-4adb-aa23-a8eabfbe807e,posted,Restaurant Dinner,-1925.26,0e3c1efc-6edb-480b-84f6-12f062cebf8f,9784.62,debit,bank-fee,AU00000,2024-04-02T16:38:11Z
transaction,bd10dcd3-51bb-41f6-ae47-29727692de0d,posted,Car Maintenance Expense,-4149.2,d4950333-5881-4870-8d8c-a5246a02fd80,5635.42,debit,cash-withdrawal,AU00000,2024-05-08T15:18:23Z
transaction,3b44bf75-93bd-4b32-a299-8cded5174ad3,posted,CTRLINK CARERS Ref: 998R6789201610974V,-592.04,00336e33-ce65-40c4-a20c-c5ccb4ce9970,5043.38,debit,bank-fee,AU00000,2023-06-27T02:52:50Z
transaction,9b6a6475-bab1-4b03-a1db-32a789c3174e,posted,Transfer Platnm Homeloan 346454,-1025.41,019dada6-fc93-4da5-9161-134d054f0016,4017.97,debit,payment,AU00000,2023-05-25T20:57:17Z
transaction,cbf91f33-8a28-4efa-8815-fbbe58074dd6,posted,Music Streaming Subscription,-3534.51,3a7bd362-86ed-4c2c-a033-3a11bc4b88eb,483.46,debit,cash-withdrawal,AU00000,2023-09-06T16:01:12Z
transaction,77c070a2-0660-4851-b9ad-917fa6e0722c,posted,Public Transport Fare,-3709.34,696078ec-f2d2-4ca6-85c0-dc9a9643a914,-3225.88,debit,cash-withdrawal,AU00000,2023-12-27T15:26:04Z
transaction,00d8666b-deac-41e1-9ff6-3ad4a57b0f43,posted,Netflix Subscription,-2785.31,6960ddf2-d2e4-494b-8c38-02ba79632162,-6011.19,debit,cash-withdrawal,AU00000,2024-04-06T20:14:05Z
transaction,28084a22-95a2-4973-a87c-69cad6b9ba28,posted,Music Streaming Subscription,-4294.6,885107d6-d50b-4211-bba7-4f68326e6621,-10305.79,debit,cash-withdrawal,AU00000,2023-08-14T13:57:37Z
transaction,bc535def-4539-4a80-921d-514533cf0245,posted,Car Maintenance Expense,-608.48,75fe2344-aefa-4268-ad32-f22aacab2698,18238.09,debit,bank-fee,AU00000,2024-02-04T18:43:10Z
transaction,aac04c2c-1add-4bbe-9cb7-150c42930d31,posted,Music Streaming Subscription,-1569.79,0c66d154-a828-485a-8aa8-34a05e5e2e27,16668.3,debit,payment,AU00000,2023-11-05T01:51:50Z
transaction,2bc997d4-c7e1-4a87-bffd-5dd1bd7a2765,posted,Hair Salon Appointment,-4763.63,fb20ad64-8706-4e4e-9a58-aa5b9dc67254,11904.67,debit,cash-withdrawal,AU00000,2023-10-08T08:52:17Z
transaction,945daf04-bb04-435f-9eb9-1f86b0b2f78f,posted,Music Streaming Subscription,-4449.69,76fcd388-294d-4852-b764-63e91fc49461,7454.98,debit,bank-fee,AU00000,2023-09-29T20:36:38Z
transaction,ad8103de-a7a4-4204-aaf1-0a538598ee5e,posted,Pharmacy Purchase,-462.66,31385ccb-69f6-4348-b23a-d9ef5dde7d01,6992.32,debit,payment,AU00000,2024-01-23T23:14:01Z
transaction,77ea5d64-17ae-4894-9bd9-73c583697037,posted,Mobile Phone Bill Payment,-2140.27,5da57d54-28c7-47a0-a717-08373ae5093c,4852.05,debit,cash-withdrawal,AU00000,2023-11-17T20:27:54Z
transaction,7b5dd7f3-8c36-409f-a33a-789a635893a9,posted,Pharmacy Purchase,-2435.08,998557b4-2432-46fa-b8d6-4fa2635de9b0,2416.97,debit,payment,AU00000,2023-10-10T19:15:55Z
transaction,24f3b957-11fb-449c-b464-09a027bb0157,posted,Manly Maths Tutor Wages,-2334.45,e2a7a159-75d3-411d-bb56-8612d3987705,82.52,debit,bank-fee,AU00000,2023-05-23T00:56:00Z
transaction,c2196b02-6e06-49c6-95f4-22d37b6fabed,posted,Electricity Bill Payment,-1096.46,f9d5c747-358f-47c9-b06c-4cf933579159,-1013.94,debit,bank-fee,AU00000,2023-11-01T19:44:19Z
transaction,40ac9bf7-02cb-49b9-8ce2-0e121ad3e000,posted,Travel Agency Booking,-1927.1,133c4d4e-1e3c-465c-9178-14fb418797c1,-2941.04,debit,cash-withdrawal,AU00000,2024-03-22T18:41:13Z
transaction,74f9a22b-8c59-4ce5-a761-9d783b17d15e,posted,Hair Salon Appointment,-304.82,5663c0cc-d4e2-4e08-9316-504ebf559292,7468.19,debit,bank-fee,AU00000,2023-07-09T10:32:48Z
transaction,8c45baa9-2beb-4e21-aacf-383eab6b8605,posted,Transfer Platnm Homeloan 346454,-919.69,039bf4d4-9501-405b-8583-bef8a5613776,6548.5,debit,cash-withdrawal,AU00000,2023-05-31T12:54:16Z
transaction,b1b56ec4-71d7-422c-af01-8476d1e9cc82,posted,Payroll WFRMS 15439393,11682.03,c3560bf5-bd8b-4304-8593-a18aad211635,18230.53,credit,transfer,AU00000,2024-03-14T18:41:59Z
transaction,67fb109d-29db-41fb-90de-160e02afd002,posted,Transfer Platnm Homeloan 346454,-72.6,ff1ab22b-cfe2-4672-8b96-23353e74d531,18157.93,debit,bank-fee,AU00000,2024-04-04T07:20:12Z
transaction,d28afc25-a798-4aac-9a27-49f3fcb30445,posted,TFR Acc14000 TO 12389,-2245.42,b8a035ec-f8c4-4705-a578-3475880122b3,15912.51,debit,bank-fee,AU00000,2023-10-08T00:10:36Z
transaction,10005930-f83c-44cb-afed-057a9c6dbac1,posted,AGL RETAIL ENERGY LTD (GAS),-1407.04,a25d2247-5f77-4beb-8099-e2474998b351,14505.47,debit,payment,AU00000,2024-03-01T11:08:50Z
transaction,e4885ccc-16d4-45fd-8225-677d638649e6,posted,Bookstore Purchase,-332.59,b5c5782b-aa69-438c-b85e-2e9f582fb969,14172.88,debit,bank-fee,AU00000,2024-01-30T15:10:20Z
transaction,e9439fe9-8411-4b74-af71-ab912ed82b7c,posted,Uber Ride,-2635.58,bbe92240-b591-422d-81b0-cf28900e0d39,11537.3,debit,payment,AU00000,2024-04-11T10:17:05Z
transaction,d33aa30e-2f2c-44be-8164-b25c385ca4cc,posted,Payroll WFRMS 15439393,10281.01,d53f5016-eee5-4c8e-8960-a56f22bc3918,21818.31,credit,transfer,AU00000,2023-06-24T13:17:34Z
transaction,b70b9ac0-6053-43fc-901d-9c6d18f1a69a,posted,Mobile Phone Bill Payment,-1715.65,353ad469-a563-4aaa-b4bb-2e94cd0ebffb,20102.66,debit,payment,AU00000,2024-01-19T12:21:52Z
transaction,8be77a79-668a-43dd-8589-f0d302c9ee22,posted,Electricity Bill Payment,-1008.12,0b296dc5-1919-4b76-8709-b1b9c897dbda,4277.62,debit,cash-withdrawal,AU00000,2023-12-18T05:27:21Z
transaction,1e2b4804-6331-4f14-b078-189773b152ad,posted,Home Improvement Store Purchase,-2514.71,cdbefbd6-a6ff-472f-b6fc-44d980a6fcc1,1762.91,debit,payment,AU00000,2023-12-09T21:28:35Z
transaction,9805ccf7-fcd9-4e8e-a116-89c8133868be,posted,Movie Ticket Purchase,-4455.38,30edbcf0-c843-42fe-b489-c883814d5a16,-2692.47,debit,cash-withdrawal,AU00000,2024-01-27T15:19:12Z
transaction,bb6f2819-6f59-4794-b488-fc1d4fa910b4,posted,Non Hooli ATM Withdrawal Fee,-2938.07,d5d9ca8b-51b5-4dd5-a7e9-2db62fff620e,-5630.54,debit,payment,AU00000,2023-08-07T01:40:55Z
transaction,20cc76c1-df4e-4894-81ad-ac1caed57721,posted,Coffee Shop Purchase,-2163.67,79ad97a3-a357-447a-9709-ee31fbdf9fcc,-7794.21,debit,cash-withdrawal,AU00000,2023-06-15T11:56:25Z
transaction,b174a89e-0616-4f9d-b420-be9e7d9ea896,posted,Non Hooli ATM Withdrawal Fee,-2893.09,4e8b6957-aadd-41fb-a914-de66aaba82dd,-10687.3,debit,payment,AU00000,2024-03-05T23:32:37Z
transaction,e3257947-d5f8-472a-a5c6-f66cf04bcf69,posted,Movie Ticket Purchase,-3711.61,395e39d9-8cd2-4822-8785-ae69375e5c4c,-14398.91,debit,bank-fee,AU00000,2023-12-03T02:30:35Z
transaction,703222f0-31df-4158-9e0c-e155c706351c,posted,AGL RETAIL ENERGY LTD (GAS),-740.14,318d05ad-c801-40be-bb9b-5330a6ce6970,-15139.05,debit,bank-fee,AU00000,2023-09-12T03:15:41Z
transaction,9a330a58-a281-4e30-8166-c8d6a09192c7,posted,Movie Ticket Purchase,-2046.36,ab55921d-f841-4da7-8ec5-e13651dc3259,-17185.41,debit,cash-withdrawal,AU00000,2024-01-28T05:47:49Z
transaction,b886faf6-fbe3-46bb-af8e-06025c72219d,posted,Payroll WFRMS 15439393,10326.97,098c9802-4762-4d4f-9f54-0252ce4a0e7c,-6858.44,credit,transfer,AU00000,2024-05-10T16:23:24Z
transaction,f6b6de8e-c20e-4872-aa6f-4276001b4181,posted,Bookstore Purchase,-4082.33,bfbdd02d-ff5d-43f8-9ae6-584120a0c14f,7914.17,debit,bank-fee,AU00000,2024-01-01T03:11:22Z
transaction,480c7190-b920-41cb-9fdb-ae7a00ae93e9,posted,Non Hooli ATM Withdrawal Fee,-591.44,0735daf8-edeb-4c4f-acc1-c66eef53a5bc,7322.73,debit,payment,AU00000,2023-05-18T22:55:42Z
transaction,4651a589-2394-4b34-82b0-1978e4e99091,posted,Clothing Store Purchase,-357.92,9acceb53-d131-40a6-b195-b353b53a40fa,6964.81,debit,payment,AU00000,2023-06-01T16:11:36Z
transaction,1add5beb-1942-4258-afc4-585746e662dc,posted,Amazon Online Shopping,-2642.12,807f7050-1265-4e49-bff5-08585428f483,4322.69,debit,cash-withdrawal,AU00000,2023-11-15T03:58:18Z
transaction,fcf27fd6-ce82-410f-9aa6-a6e40e5f0a37,posted,Electricity Bill Payment,-111.26,5a75311a-1f70-49ae-8eb6-3fa7d5a7b90b,4211.43,debit,bank-fee,AU00000,2023-11-16T10:34:53Z
transaction,9a477743-f7b1-4559-98fa-7039cd659001,posted,Car Maintenance Expense,-3864.43,22e20077-433b-4385-9efc-340acbe6cba2,347.0,debit,bank-fee,AU00000,2023-08-14T00:44:58Z
transaction,ad08020a-ae1e-44ce-911f-75713eba9333,posted,Car Maintenance Expense,-867.7,f9a37966-aa8b-45c0-89c6-d5d64f100bdd,-520.7,debit,cash-withdrawal,AU00000,2023-06-14T19:47:11Z
transaction,f92e9ba7-b429-49a7-9349-01563d67d36a,posted,TRANSFER TO JOANNA SMITH CAMPING,-2064.28,e41147f0-e0f6-4c90-b2a9-b518a21c8f7f,-2584.98,debit,cash-withdrawal,AU00000,2024-05-06T05:53:08Z
transaction,c3486874-ff77-44c0-8f2c-e989e8498bf5,posted,Manly Maths Tutor Wages,-2388.58,a6446a69-7f53-429d-8c86-35b354ea29d0,-4973.56,debit,payment,AU00000,2023-09-08T07:19:45Z
transaction,5b343f7f-f723-4fd1-8f85-0a46aa74d898,posted,Electricity Bill Payment,-1735.37,3cbe64f0-7cb8-47b7-8bd4-153fde8ff4af,-6708.93,debit,cash-withdrawal,AU00000,2023-08-31T19:01:06Z
transaction,f826371f-3c9f-4835-bfea-e801f1558c20,posted,Car Maintenance Expense,-2233.33,fcdfa445-ed22-4472-be68-5c71b60d58d1,11155.07,debit,cash-withdrawal,AU00000,2023-08-29T09:18:17Z
transaction,6fb7128b-2d0f-4fb1-89f7-a9125b760539,posted,Mobile Phone Bill Payment,-1961.13,ff4ae425-538b-4483-867c-fc43e656b2d7,9193.94,debit,cash-withdrawal,AU00000,2023-07-26T04:14:32Z
transaction,77f962f9-e9e4-4652-96f6-720aa22cd07a,posted,Online Gaming Purchase,-1297.79,0a6b01d9-d5a0-4188-8b34-0456f47e6601,7896.15,debit,cash-withdrawal,AU00000,2024-01-05T15:57:02Z
transaction,32733ee9-c5db-419e-a823-6fe9f4f7e124,posted,Payroll WFRMS 15439393,10072.57,77a60b37-399a-4b14-aa8b-6509c47586eb,17968.72,credit,transfer,AU00000,2024-02-25T22:15:07Z
transaction,b3da9034-f656-4f28-8216-9dfb07a53354,posted,Amazon Online Shopping,-4094.4,f5158e48-2120-47b0-a2aa-e8a4b83d1a4c,13874.32,debit,bank-fee,AU00000,2024-03-23T06:03:01Z
transaction,85367d17-dc11-46d7-87f4-9d6ac7862e3a,posted,Electricity Bill Payment,-945.42,f5296e99-669e-4f3a-901d-92d3394fa314,12928.9,debit,payment,AU00000,2023-08-20T19:42:16Z
transaction,e31f2e48-230c-429e-9a75-354a85975c3f,posted,TFR Acc14000 TO 12389,-4223.02,8fec8258-b5f3-4238-8e71-e437643317b2,8705.88,debit,bank-fee,AU00000,2023-09-27T12:27:18Z
transaction,c0d1ded2-81f8-46c4-a16f-6bf394407364,posted,Music Streaming Subscription,-1753.57,a5a5ac5c-1db6-471b-b720-d1d94ace4962,6952.31,debit,cash-withdrawal,AU00000,2023-10-28T10:44:15Z
transaction,829b7ec4-b9e6-4a81-b33f-24a65a39e490,posted,TFR Acc14000 TO 12389,-317.73,816b52d6-6b8c-41bf-8083-5ca0dcf44279,6634.58,debit,cash-withdrawal,AU00000,2024-01-27T12:13:16Z
transaction,929a3e10-934c-4c8d-99ec-ea4efae0cfde,posted,Mobile Phone Bill Payment,-3886.48,d3e5964a-facb-4662-bef8-69d0bdbd8254,2748.1,debit,cash-withdrawal,AU00000,2024-05-01T06:37:18Z
transaction,86cbafc6-6f83-471a-a0e5-a931aacaaf19,posted,Movie Ticket Purchase,-2688.6,63dce2d6-9262-45ea-8720-b11cfcbbb4b1,6308.22,debit,bank-fee,AU00000,2024-04-02T06:01:26Z
transaction,858e30d5-9eec-43ed-96ca-d72fec75dca5,posted,Public Transport Fare,-4243.68,3b730186-dc1e-45b2-9e50-c8b71117084f,2064.54,debit,bank-fee,AU00000,2023-10-18T17:41:53Z
transaction,16edb091-acd5-48f5-a4fb-39b1c85be337,posted,Payroll WFRMS 15439393,10277.79,5848ff46-5bde-4df6-a3c2-084dcddf8263,12342.33,credit,transfer,AU00000,2024-03-30T18:33:41Z
transaction,1ed0b9cc-3c49-411a-89c6-119dc69d19de,posted,Public Transport Fare,-2714.14,d137d17e-95fc-48a3-8588-4745ebbac736,9628.19,debit,bank-fee,AU00000,2023-08-26T08:54:42Z
transaction,b82fdadc-2adc-46ef-9a30-9459b0f43c8c,posted,Home Improvement Store Purchase,-1338.18,dba64a48-7a68-45ce-ab77-7b1b1a9d16b9,8290.01,debit,cash-withdrawal,AU00000,2024-04-28T23:16:26Z
transaction,e639366c-6244-4859-8952-ab606417e49f,posted,TRANSFER TO JOANNA SMITH CAMPING,-2662.87,79867c66-a135-4a27-a75c-7c746267faab,5627.14,debit,cash-withdrawal,AU00000,2023-12-06T07:17:36Z
transaction,cc60b83f-b4a9-49f2-b5e8-83baa89310a3,posted,Amazon Online Shopping,-4080.92,cc732190-8c16-40ff-99d3-360d8b5b7d55,1546.22,debit,cash-withdrawal,AU00000,2023-08-22T16:16:18Z
transaction,0c41cd01-696a-4f0f-8817-97bbe7e334d9,posted,AGL RETAIL ENERGY LTD (GAS),-1110.11,bc3cba75-4dcb-4219-ac99-cac72cc0a696,436.11,debit,cash-withdrawal,AU00000,2023-05-30T04:41:29Z
transaction,8d8f0493-3149-4a6a-adaf-c98fbf7e6124,posted,Wdl ATM WESTPAC IGA BALGOWLAH BALGOWL AU,-991.84,18d78b3a-5d5c-4a0d-a845-9739d68e8925,-555.73,debit,cash-withdrawal,AU00000,2023-10-15T06:18:40Z
transaction,aa849a61-e0cc-4332-ac21-c32b4801d381,posted,Netflix Subscription,-2715.87,33882250-eb28-4808-9020-9cf08ed2120f,-3271.6,debit,bank-fee,AU00000,2023-08-08T02:48:52Z
transaction,3b98bcff-6832-403d-a64d-0049e5fa8817,posted,Online Gaming Purchase,-3956.11,9523ac36-8499-42c8-92e1-5e898e466163,14929.2,debit,cash-withdrawal,AU00000,2024-03-26T18:27:54Z
transaction,50bdf0a5-a0fd-43c0-8538-b017d442bd14,posted,Gym Membership Fee,-1229.06,7a1061bf-878d-4688-bfe8-409e778f0dc9,13700.14,debit,cash-withdrawal,AU00000,2023-09-08T21:22:16Z
transaction,f1849226-a459-4f2b-9eba-74be1fd58556,posted,Restaurant Dinner,-227.22,a2caa161-83b0-40a7-9a79-a97ab3b85d03,13472.92,debit,payment,AU00000,2023-12-19T17:05:45Z
transaction,99de639e-2102-4b0e-9ec4-c655699ddb14,posted,Coffee Shop Purchase,-1562.53,9496424b-022b-44b8-8f92-af43c323e2cb,11910.39,debit,cash-withdrawal,AU00000,2023-11-07T09:07:55Z
transaction,8742f217-6b22-456e-ba4a-22d620331f02,posted,TRANSFER TO JOANNA SMITH CAMPING,-1394.43,f489d6b5-5f27-4373-8b5a-5c937262b02b,10515.96,debit,bank-fee,AU00000,2023-09-25T22:51:35Z
transaction,3be40104-ab94-496c-8264-8f6a29ebeff6,posted,Home Improvement Store Purchase,-1912.26,9f2fba74-ba4f-4463-ba5c-c6065f0ab950,8603.7,debit,cash-withdrawal,AU00000,2024-02-19T14:03:52Z
transaction,b06f455f-fac9-47db-91be-6f709ee57ab3,posted,Car Maintenance Expense,-4445.2,196674a9-b2f7-47ce-9e99-ae410dec04e2,4158.5,debit,cash-withdrawal,AU00000,2023-11-02T14:47:16Z
transaction,48feade1-68e2-49f2-a9c1-7061566ac26a,posted,Amazon Online Shopping,-282.49,23270da5-bcb8-41dc-97d7-06d64b07d161,3876.01,debit,payment,AU00000,2024-01-10T22:24:13Z
transaction,ca455963-500d-4692-a30c-c660c4d82c12,posted,Travel Agency Booking,-2243.55,4f55b3e9-3ea6-43d1-866c-b2b6fb3e45fc,1632.46,debit,payment,AU00000,2023-12-20T20:20:05Z
transaction,1b4369ca-e3b5-4130-9b86-5c79ec7bbd45,posted,Public Transport Fare,-1034.22,bfb24fef-8c9e-4f6b-8674-10f1ecc3522e,598.24,debit,bank-fee,AU00000,2023-09-23T23:41:25Z
transaction,2e0b6cb8-d1c9-4daf-a09b-77199f8949a9,posted,Public Transport Fare,-4453.7,6914ed56-0ecf-49b2-844e-a5f397b5cc76,1659.78,debit,cash-withdrawal,AU00000,2024-01-27T08:39:53Z
transaction,827d26d4-40cb-4663-a4cd-1bd12b24d4e1,posted,Public Transport Fare,-433.19,6efedf63-dc0a-4385-84a9-cc81eb54ed95,1226.59,debit,bank-fee,AU00000,2024-05-04T10:49:08Z
transaction,1ebfd7e7-f523-4910-a48d-9cc75dd6d266,posted,TRANSFER TO JOANNA SMITH CAMPING,-2951.79,cabef2b7-dbc8-430f-b54a-a99de4701d0f,-1725.2,debit,cash-withdrawal,AU00000,2024-01-03T08:35:13Z
transaction,377a0441-4a22-44f4-8656-fcffe86654bd,posted,Gym Membership Fee,-3060.09,d2782721-c9bc-42f4-8bf6-eeaed16d33dd,-4785.29,debit,bank-fee,AU00000,2023-11-04T23:39:39Z
transaction,78a49409-27c6-4098-8774-f045e0839504,posted,AGL RETAIL ENERGY LTD (GAS),-2690.87,1c408077-46e4-4d05-acc8-cdfc387166a7,-7476.16,debit,payment,AU00000,2024-02-22T03:28:40Z
transaction,050117ba-d433-4682-bad8-5ea4d34d6d3a,posted,Online Gaming Purchase,-2803.44,a5114e24-897d-46aa-9ed2-65bbea32981a,-10279.6,debit,cash-withdrawal,AU00000,2024-02-20T06:24:31Z
transaction,f36c0ed2-b835-437f-bc7c-47c109fab869,posted,Mobile Phone Bill Payment,-1105.58,fff00c0e-78c5-4afc-819c-796183fc0c0a,-11385.18,debit,bank-fee,AU00000,2023-12-05T09:23:50Z
transaction,9dc3f43b-eae4-44d8-8e30-d141c95265d9,posted,Car Maintenance Expense,-2632.29,3a464499-d29e-4921-9025-f8e658e7db41,-14017.47,debit,cash-withdrawal,AU00000,2023-12-22T18:32:30Z
transaction,924bca7d-4901-4fa7-9e03-b90c32176e9c,posted,TFR Acc14000 TO 12389,-2137.58,a2447cb9-3c3e-4f5c-b72b-dd00bb5ac6b7,-16155.05,debit,payment,AU00000,2023-08-16T23:46:59Z
transaction,7cc462f0-a92e-459d-bdff-6fe990fef1e3,posted,Music Streaming Subscription,-4034.43,ad8229eb-b923-49f8-abe9-6a052ee59543,-20189.48,debit,bank-fee,AU00000,2024-02-04T09:58:30Z
transaction,122f8534-6fec-4a9d-ab13-01b1f8154d7a,posted,Amazon Online Shopping,-834.79,1117ef30-9e4d-4547-8a84-4fc6dd13d1ac,6086.89,debit,cash-withdrawal,AU00000,2023-08-14T14:08:48Z
transaction,e2738fe4-eada-4ebe-aa61-b43384ac61c0,posted,Mobile Phone Bill Payment,-747.27,4d5e4b29-969c-4b90-b2ac-fd83535e5152,5339.62,debit,cash-withdrawal,AU00000,2023-10-20T13:39:36Z
transaction,c44ffd72-fe3a-454b-b71c-60a7d98f406d,posted,Travel Agency Booking,-741.84,402bd98f-7661-4fa8-9a60-23f93fcdaa74,4597.78,debit,bank-fee,AU00000,2023-11-06T12:05:28Z
transaction,4a99a5d2-47fc-4bab-9d17-7f593d994eaf,posted,Gasoline Purchase,-3866.7,4f07cf77-3790-4eb2-8d27-2213ff4c0111,731.08,debit,payment,AU00000,2023-10-05T09:43:50Z
transaction,41382b5b-c119-46ac-8985-06fecd36cce3,posted,Wdl ATM WESTPAC IGA BALGOWLAH BALGOWL AU,-2291.88,2298cab8-29c5-49c5-a939-76b7fdf22cc8,-1560.8,debit,payment,AU00000,2024-03-03T02:50:42Z
transaction,7721d545-3b99-4d9c-8e66-171ea987afec,posted,Transfer Platnm Homeloan 346454,-2885.93,b284cdf5-23a2-456d-8fba-aa37dde5fd20,-4446.73,debit,payment,AU00000,2024-03-31T10:12:15Z
transaction,0bb50f20-76fa-481e-a5f4-29399ec409a3,posted,Restaurant Dinner,-1485.77,a5072440-e2bd-4658-9c29-5babf6c355da,-5932.5,debit,bank-fee,AU00000,2023-10-08T22:35:27Z
transaction,ba24e76a-3dcd-45c2-bb5b-49b8c572f20d,posted,Music Streaming Subscription,-107.64,a0a3f93c-5934-4ee9-a31c-24bdccab99c9,-6040.14,debit,cash-withdrawal,AU00000,2023-09-24T06:27:06Z
transaction,c6430638-aeda-406a-b48a-e49b3a396439,posted,Travel Agency Booking,-3252.44,7b60410f-8c94-4dda-b2d8-9ff10bee3d09,-9292.58,debit,cash-withdrawal,AU00000,2024-03-17T10:55:13Z
transaction,00bfa02b-3296-4388-bc10-c098138c51d6,posted,Netflix Subscription,-1767.96,d9aec576-3aff-4fa9-b8f8-6d8988fa6f8c,-11060.54,debit,payment,AU00000,2023-09-25T12:20:52Z
transaction,87647193-fa7f-4fe2-a8cc-faa79e554fb5,posted,Non Hooli ATM Withdrawal Fee,-3687.91,8ac18b13-2a9f-4dd2-b823-273f2e71acd5,6134.59,debit,payment,AU00000,2023-07-02T07:53:41Z
transaction,32416f00-a8d1-452a-9085-e4a2b6152c10,posted,Public Transport Fare,-720.94,bed5c075-3474-4e59-88fd-00eeff0a5150,5413.65,debit,cash-withdrawal,AU00000,2023-05-15T11:19:05Z
transaction,71927ea9-6e1c-43fe-8b76-b8b489de8e6c,posted,Non Hooli ATM Withdrawal Fee,-4748.31,59d15a83-f5ab-4975-b2dd-1a4b83042e71,665.34,debit,payment,AU00000,2024-02-22T17:17:15Z
transaction,9ca914e5-f0b6-4dfb-883b-3326ebfbc0ea,posted,Uber Ride,-728.4,9a5215d8-fa18-49a4-8e8a-bc84f144c531,-63.06,debit,cash-withdrawal,AU00000,2023-09-28T10:08:28Z
transaction,4248dfd8-e7ca-4b8d-a2c6-c458a616cf29,posted,Home Improvement Store Purchase,-668.42,090594ae-aa14-4b4b-92cf-1dfcd50a45c5,-731.48,debit,cash-withdrawal,AU00000,2024-02-16T21:14:44Z
transaction,55e0cb7c-60ec-4086-8262-9905103ffd3c,posted,Public Transport Fare,-1145.09,c5985b2a-3d71-48cb-b53d-e7117505760e,-1876.57,debit,payment,AU00000,2023-12-21T23:39:43Z
transaction,ff5f814b-2b2e-4eaf-9f31-f0a7c96e677a,posted,Payroll WFRMS 15439393,11032.55,8209b093-97fc-4a8e-8bb6-b0419ae11883,9155.98,credit,transfer,AU00000,2023-10-23T03:53:30Z
transaction,76221d4b-981a-4cf1-8ac4-89ad69517b29,posted,CTRLINK CARERS Ref: 998R6789201610974V,-1391.63,91cbd721-460b-4cd1-bd3a-4cec9b0f4a0d,7764.35,debit,bank-fee,AU00000,2024-04-11T02:29:59Z
transaction,701b25ca-c1f5-4f5b-84b9-656650338f14,posted,Bookstore Purchase,-1278.01,e1f3d8a8-d6e1-42da-8349-5ff49e2a7521,6486.34,debit,cash-withdrawal,AU00000,2024-02-05T12:48:02Z
transaction,c7475f23-4345-47a4-b75c-8e941d3a9b7f,posted,Mobile Phone Bill Payment,-4400.73,f1ac862e-c2e4-44da-9a93-726804e23b32,2085.61,debit,cash-withdrawal,AU00000,2023-07-13T03:38:11Z
transaction,eedbe188-2267-4875-bb2d-a1348df7baab,posted,Wdl ATM WESTPAC IGA BALGOWLAH BALGOWL AU,-2738.78,8977c914-19ac-400d-b7ed-f6d27d22870b,13680.07,debit,payment,AU00000,2023-07-06T09:02:15Z
transaction,17b4e37b-c85c-41b0-924c-a75a8d9b7c19,posted,Clothing Store Purchase,-1430.24,1906f7e6-dac0-47ca-9aef-ac5e52341042,12249.83,debit,cash-withdrawal,AU00000,2024-04-26T01:34:55Z
transaction,9183a49e-45e3-4ac7-8842-25ef03723ac0,posted,Electricity Bill Payment,-4250.4,27d32e94-9877-4117-a354-d995b9c2275b,7999.43,debit,bank-fee,AU00000,2024-02-22T23:53:17Z
transaction,83984b89-5bce-493a-af91-a19a4d70e06a,posted,Home Improvement Store Purchase,-3394.22,08969ca8-2dc0-4548-9e24-3253636add5b,4605.21,debit,cash-withdrawal,AU00000,2023-06-08T21:29:57Z
transaction,1dc6c6bb-0506-40ff-8c6a-30187604f234,posted,Netflix Subscription,-4466.01,08e308fd-7af6-48ca-9cd0-db50074d5f8d,139.2,debit,cash-withdrawal,AU00000,2024-02-09T02:25:59Z
transaction,1e5cabaa-57bd-4de8-9e7a-fc0d5a8315d9,posted,Electricity Bill Payment,-156.42,ce0e2cbb-4e37-417b-ab76-c2c04954d2f0,-17.22,debit,payment,AU00000,2023-06-08T04:53:01Z
transaction,f143bebe-71f0-4d72-a26a-f1756519c40e,posted,Wdl ATM WESTPAC IGA BALGOWLAH BALGOWL AU,-4256.53,9a417a63-1828-4286-b106-b2d191b7b999,-4273.75,debit,payment,AU00000,2024-04-03T03:41:57Z
transaction,063792ac-8448-4b2b-aeef-dc8bc3bcf68f,posted,Electricity Bill Payment,-1731.0,d5bdbb6c-c63f-4235-ac09-91a5425e9ba8,-6004.75,debit,cash-withdrawal,AU00000,2024-03-08T19:36:30Z
transaction,0866c222-7e98-4bcd-8c52-bc6c53f12ed9,posted,Music Streaming Subscription,-2253.96,5d44cd35-93f7-4034-bf69-7211bc18faff,-8258.71,debit,bank-fee,AU00000,2024-02-19T14:52:39Z
transaction,aa9e0051-b467-4b19-9922-f10402b783b8,posted,TRANSFER TO JOANNA SMITH CAMPING,-4185.65,3ccda6c2-b91f-48a6-aec2-78bc8d581407,-12444.36,debit,bank-fee,AU00000,2024-03-04T04:07:33Z
transaction,8e15ce23-ac1f-4324-92d4-653c2bbb4deb,posted,Coffee Shop Purchase,-4270.05,4978fa3c-298c-4554-85d3-117b3bc81965,15171.61,debit,cash-withdrawal,AU00000,2024-02-11T08:39:56Z
transaction,f636e69d-c42c-44b3-8311-248cd9bbb9b3,posted,Music Streaming Subscription,-4426.98,ccc3d266-cbce-4c30-8146-c59338cf2b13,10744.63,debit,payment,AU00000,2023-05-14T23:43:55Z
transaction,03c8b65e-1b6c-4847-81bb-bdb960ab977e,posted,Wdl ATM WESTPAC IGA BALGOWLAH BALGOWL AU,-3814.72,d7db7c05-93d6-4951-9335-47956dacd74e,6929.91,debit,cash-withdrawal,AU00000,2023-10-26T16:50:11Z
transaction,1d605481-a7b9-465a-b111-bbf9dae36088,posted,Bookstore Purchase,-2222.73,4d83f97f-6722-4562-81fd-6852d8370e3e,4707.18,debit,cash-withdrawal,AU00000,2023-06-17T13:47:34Z
transaction,b47e5d56-c0e3-4118-90e4-abdecbdf727b,posted,Transfer Platnm Homeloan 346454,-4204.01,2a3a6908-b0cc-4b7a-9e0c-4e6fed0895aa,503.17,debit,bank-fee,AU00000,2023-05-16T02:12:29Z
transaction,5e8a6bcc-a13e-416d-883e-98aade592ddb,posted,Home Improvement Store Purchase,-2678.17,2f18ae63-51da-4c9c-a8e7-14e3006175b0,-2175.0,debit,cash-withdrawal,AU00000,2023-07-11T08:37:50Z
transaction,75d5d877-a323-4c87-a497-8e8b1b7525e4,posted,Gasoline Purchase,-3350.68,efa6f1d2-5ad6-4bfb-9666-86dc32b1b248,-5525.68,debit,cash-withdrawal,AU00000,2024-04-24T07:53:07Z
transaction,32339970-278c-464f-8839-a5dab9d0e695,posted,Wdl ATM WESTPAC IGA BALGOWLAH BALGOWL AU,-1930.75,562b7f95-ebc2-4cf3-bc82-e1c360f50c06,-7456.43,debit,bank-fee,AU00000,2023-07-31T12:12:55Z
transaction,ad3cfc5e-5aa3-4835-89a0-a7887c0a3860,posted,Uber Ride,-3789.36,c5906093-94df-4b91-bdcc-39d93597434a,-11245.79,debit,payment,AU00000,2023-06-27T19:53:42Z
transaction,3f0aea33-2023-40b8-adf6-88a9c8d296ee,posted,Restaurant Dinner,-2332.45,13e9aabb-e403-407f-b000-9ae42e3674e0,-13578.24,debit,cash-withdrawal,AU00000,2023-05-19T19:52:44Z
transaction,ef8d0d20-f8fc-4f74-8bdd-e562f3f9e3ea,posted,Hair Salon Appointment,-356.78,5da316e4-f226-40fa-b635-0e84ac937319,12005.97,debit,cash-withdrawal,AU00000,2023-09-03T12:47:55Z
transaction,9b015c91-b2f5-4a31-b17c-8355db9412f0,posted,Restaurant Dinner,-994.09,9c940dfb-7168-45ba-a2b2-282641f7fa64,11011.88,debit,payment,AU00000,2024-03-29T04:03:01Z
transaction,56641ca1-80f0-4dbc-b87f-a546b87fdcd3,posted,Car Maintenance Expense,-858.75,27db2d2f-5c6a-4c99-ba29-ddef43b22897,10153.13,debit,bank-fee,AU00000,2023-10-11T12:04:07Z
transaction,6c752fbe-4b55-4245-bfea-7084d93ad870,posted,Public Transport Fare,-986.33,a4c31c9b-505c-4146-852b-653c953002d5,9166.8,debit,cash-withdrawal,AU00000,2024-04-06T19:06:43Z
transaction,be680c5a-dc85-47ce-8b5f-4e5e65d58ace,posted,Music Streaming Subscription,-811.19,17393757-5903-40b6-b307-799df2e51769,8355.61,debit,payment,AU00000,2024-04-03T06:17:21Z
transaction,f080c8a7-7ed2-4fc7-960f-07ff0769845f,posted,Electricity Bill Payment,-3413.59,58d53bef-faa5-4682-a277-356004252444,4942.02,debit,cash-withdrawal,AU00000,2023-08-02T02:48:14Z
transaction,f45c76c1-8dd3-4f90-bf87-32dd6e2db445,posted,Bookstore Purchase,-525.25,ddf56270-1120-4960-835b-1c546efbf0c5,4416.77,debit,bank-fee,AU00000,2024-04-26T04:35:07Z
transaction,0aa21fb2-c128-455b-8a4c-146afd427129,posted,Music Streaming Subscription,-195.37,65661ee7-30a6-4cf9-b106-519c66a85766,4221.4,debit,cash-withdrawal,AU00000,2024-02-02T08:57:00Z
transaction,9ef60b70-7a85-405c-ab2f-886e5a090c5b,posted,Gasoline Purchase,-1512.4,bcf44dfd-2763-445e-88ed-eb8e804cc0bb,2709.0,debit,cash-withdrawal,AU00000,2023-06-19T06:20:12Z
transaction,b6da30c2-b7ae-4094-87dd-c29920e20f52,posted,TRANSFER TO JOANNA SMITH CAMPING,-4842.45,aa447e58-815e-45a2-903b-c9bf13656053,-2133.45,debit,bank-fee,AU00000,2023-08-24T15:20:39Z
transaction,554e8b06-bf65-4456-9c69-0efd26769993,posted,Restaurant Dinner,-1103.02,a48db88f-77ad-4a58-9d5c-acd328cc45f7,10742.12,debit,bank-fee,AU00000,2024-03-15T11:45:46Z
transaction,1302d249-5341-4e4a-99fb-be8ce46de127,posted,Gasoline Purchase,-260.06,9088a3f5-5bd4-4853-8783-31e1e37feeba,10482.06,debit,payment,AU00000,2024-02-01T09:03:26Z
transaction,c183ffd0-fd91-4a2e-b32b-473d13ea7b69,posted,Payroll WFRMS 15439393,10503.34,506c367a-cc30-4ebd-afc1-05417632b0c7,20985.4,credit,transfer,AU00000,2023-09-04T09:46:57Z
transaction,6e6ab7d5-7b8b-4767-be89-7983176cb11f,posted,Netflix Subscription,-2710.59,c5ffe912-79b0-46be-bd9e-396a8118f0c6,18274.81,debit,payment,AU00000,2023-09-13T17:32:41Z
transaction,b883c4b2-8a7a-4d7b-831e-d33c3e0659ac,posted,Electricity Bill Payment,-1357.01,7be3a36b-f420-4e85-b6b2-6b02875c080d,16917.8,debit,cash-withdrawal,AU00000,2024-02-11T17:01:43Z
transaction,9cdb3397-e8b4-48d5-a5bf-97b5797c0ca6,posted,Movie Ticket Purchase,-158.72,51c636cb-7811-4d15-a60d-1be02d48c90d,16759.08,debit,bank-fee,AU00000,2024-01-30T19:09:37Z
transaction,baadb478-aacf-4ab0-9466-49dd4d9318e7,posted,TRANSFER TO JOANNA SMITH CAMPING,-1357.1,db3affc5-5e2d-424c-b365-031e905b7b7b,15401.98,debit,bank-fee,AU00000,2023-12-27T11:31:21Z
transaction,f65493b9-ae7d-4211-a175-24d88e7d1364,posted,Electricity Bill Payment,-2621.97,08ae383c-0453-4021-bf88-b0800f81de3a,12780.01,debit,payment,AU00000,2023-08-30T18:01:11Z
transaction,d575aef0-a63b-4d15-9449-cbf6ffc915c0,posted,Travel Agency Booking,-2609.31,87feb827-50b0-49ca-a7ad-ee55a80e53fa,10170.7,debit,payment,AU00000,2023-12-24T07:23:34Z
transaction,5c64adec-8be0-4266-981f-32441992a8dc,posted,Music Streaming Subscription,-907.16,3a4aeb82-ae9e-43b8-bb31-c1e59ea79d6d,9263.54,debit,bank-fee,AU00000,2024-05-06T20:15:52Z
transaction,b59541c5-1d2e-45c6-b003-683c68b12597,posted,Coffee Shop Purchase,-4737.15,85b83b99-1b21-458d-99be-23c6c995cde2,4217.58,debit,payment,AU00000,2023-11-23T06:30:20Z
transaction,cc671ee9-7047-4be2-b4db-c37b04ae1ad6,posted,Bookstore Purchase,-4538.27,8dbf8c8b-64f5-4983-8f42-9c635b8fced5,-320.69,debit,cash-withdrawal,AU00000,2023-12-04T04:32:03Z
transaction,9f206989-bdfa-444d-be38-e01fd5386bcf,posted,Transfer Platnm Homeloan 346454,-4052.8,d1aba11d-c023-4be1-8a17-7765c046b2e6,-4373.49,debit,bank-fee,AU00000,2024-01-09T13:22:44Z
transaction,56f05ff4-6257-470e-bc65-cc5af71f1c4a,posted,Amazon Online Shopping,-1458.99,cbac4579-b68c-46e9-bdae-12b37fb190f6,-5832.48,debit,cash-withdrawal,AU00000,2024-01-22T22:24:53Z
transaction,f7ead38a-f5b3-45ad-bcdb-7e01475a3b9a,posted,Pharmacy Purchase,-75.32,66fd4cc7-c073-4aae-91de-d54876c8fe6e,-5907.8,debit,cash-withdrawal,AU00000,2023-06-04T16:36:57Z
transaction,c1ac8da1-a8d5-473a-95f1-351ecfa943cc,posted,Payroll WFRMS 15439393,11590.65,27037cbe-e52a-4811-bc0c-4f5464d0ce78,5682.85,credit,transfer,AU00000,2024-04-13T04:28:27Z
transaction,c20a1f05-3cc2-4296-992b-f73ca59ef296,posted,Pharmacy Purchase,-2999.7,c9a91607-2b5d-47bd-940d-128d61f51e11,2683.15,debit,cash-withdrawal,AU00000,2023-07-08T19:50:35Z
transaction,05b6e4c1-de9a-4079-ab35-f3a5ef4d769e,posted,Home Improvement Store Purchase,-831.19,46197cf0-4678-412a-b030-6d65d97836b3,1851.96,debit,bank-fee,AU00000,2024-02-02T13:23:41Z
transaction,3ac41e09-bc97-4b58-aea2-dedf4fd339aa,posted,Restaurant Dinner,-1916.83,3afc8491-fd77-495d-b199-76deef9ab918,-64.87,debit,bank-fee,AU00000,2023-11-02T09:50:54Z
transaction,0aee0940-e525-4b44-89c8-b964d207f05d,posted,Car Maintenance Expense,-1596.87,a7a8dda9-32d5-4509-991a-c610e9c5b73c,-1661.74,debit,payment,AU00000,2023-07-02T03:47:22Z
transaction,f31d8e1e-716a-40e7-9954-314d41e0176d,posted,Public Transport Fare,-3356.03,6b00d9b4-9c2d-4d29-b053-0816802e90b5,3353.45,debit,payment,AU00000,2023-12-17T18:56:21Z
transaction,38d247e9-09c3-48c2-9e06-64bc7d87e1ef,posted,Uber Ride,-152.49,d8d6367b-5348-4416-b437-de7ecbee0b1a,3200.96,debit,bank-fee,AU00000,2024-03-31T21:07:05Z
transaction,202d1a77-d6ef-4c75-99c3-3118f2338e5d,posted,Payroll WFRMS 15439393,10537.33,9bacee85-4b26-4b0b-a476-f30089726816,13738.29,credit,transfer,AU00000,2023-08-01T22:59:10Z
transaction,aee5710a-7e19-4147-8374-44b73d94c10c,posted,CTRLINK CARERS Ref: 998R6789201610974V,-4308.12,fde1a38b-000a-426f-bf8b-9b233c3178ad,9430.17,debit,payment,AU00000,2023-08-12T14:54:19Z
transaction,45169121-9d22-4766-b482-288b996d8a3b,posted,CTRLINK CARERS Ref: 998R6789201610974V,-2355.24,9ad9c24c-d9d5-404c-b418-8faeef4671d2,7074.93,debit,bank-fee,AU00000,2023-06-15T03:25:20Z
transaction,d9b8f71f-70c5-4dc1-8582-f4beeae84d61,posted,Netflix Subscription,-590.86,506d3aca-98fa-44c1-b2a1-720d1e01f803,6484.07,debit,bank-fee,AU00000,2023-11-15T15:36:11Z
transaction,48f15747-c4b9-4ce6-b16b-e26d7a6b7ebe,posted,Restaurant Dinner,-982.09,7e1c49d7-ccb7-4ba4-9649-8d802049f3d6,5501.98,debit,payment,AU00000,2023-05-21T02:08:59Z
transaction,44db2311-7121-42d0-8632-eabe3d77970a,posted,Transfer Platnm Homeloan 346454,-1061.21,19ae7c38-ad81-4f38-92ec-0a4dbd8241af,4440.77,debit,payment,AU00000,2023-10-09T18:00:30Z
transaction,23cda145-3da8-4767-aae5-fd97afa9b028,posted,Manly Maths Tutor Wages,-4294.58,d8be85de-c907-4c9d-8d97-e6d84351bb35,146.19,debit,payment,AU00000,2023-10-04T00:15:08Z
transaction,2c689cb5-a9eb-4b05-a24e-bcacbf754f7d,posted,Uber Ride,-4181.68,85134c35-2a94-4c67-b42b-4be8b54c2bb6,-4035.49,debit,cash-withdrawal,AU00000,2023-07-31T19:09:21Z
transaction,bee2d3d4-7dd6-4377-bd39-83155d9b59c3,posted,Restaurant Dinner,-1836.62,922d19d9-fd17-459c-adb8-6b6d328a83ff,3669.45,debit,payment,AU00000,2024-02-08T23:38:58Z
transaction,c83a32c0-332e-4c66-8cdd-8d907688b8f8,posted,Restaurant Dinner,-3104.16,bf418528-76ad-4c3f-8995-5c56b9655d51,565.29,debit,cash-withdrawal,AU00000,2023-08-07T21:49:21Z
transaction,bd68ed5f-df53-4c16-bb24-4449f303b2cc,posted,Public Transport Fare,-2969.16,ad17137e-5293-4bad-a77b-dee70deb9001,-2403.87,debit,bank-fee,AU00000,2023-05-22T15:14:06Z
transaction,a11c7f37-f68b-4f69-a9dc-a6bfc1403c3b,posted,CTRLINK CARERS Ref: 998R6789201610974V,-3831.37,54674bd0-9ea7-4d9e-ab37-18ab26977055,-6235.24,debit,bank-fee,AU00000,2023-06-07T17:14:37Z
transaction,b1b96891-43e8-45e5-b339-f8ca7cca27bd,posted,Payroll WFRMS 15439393,10497.05,83a61874-cc78-479b-8503-f85413689dee,4261.81,credit,transfer,AU00000,2023-05-23T10:23:06Z
transaction,946eb370-f542-40ac-a246-04d2a9cae211,posted,Music Streaming Subscription,-793.03,9b7e78ec-ed17-4a80-9177-0e6689c7164a,3468.78,debit,payment,AU00000,2023-10-02T06:57:52Z
transaction,51fe0f5a-598f-402c-8dbd-8c4bf80762e9,posted,CTRLINK CARERS Ref: 998R6789201610974V,-3198.44,2546baac-2f2f-4567-b172-b8e9b7eeaa3b,270.34,debit,bank-fee,AU00000,2023-10-30T02:14:36Z
transaction,380381ca-a7a3-4908-9ffd-893ca7b9d69f,posted,Pharmacy Purchase,-2963.63,ffae6f37-4f1b-425a-bec9-fd0c1974b3d4,-2693.29,debit,payment,AU00000,2023-12-31T19:27:13Z
transaction,c40d8b09-5b76-46e5-9fcd-29cad65a08a1,posted,Manly Maths Tutor Wages,-162.35,4a0b4e07-9c0a-4f01-9c6b-453f5c43a3fd,-2855.64,debit,payment,AU00000,2023-06-06T09:45:58Z
transaction,be863b1a-9da2-4e03-b624-bb9dfafeb882,posted,Uber Ride,-2252.89,6be619e3-c10a-4e0d-a9a7-fe145b973096,-5108.53,debit,bank-fee,AU00000,2023-06-21T02:59:42Z
transaction,2f1814b6-5de6-4861-a889-dd1918960ac3,posted,Payroll WFRMS 15439393,11040.55,2cf00e1b-71c0-44ff-b278-9621ab22ee7f,28485.92,credit,transfer,AU00000,2024-04-09T11:02:45Z
transaction,165a8a37-eee7-4387-961a-b058e9e25a22,posted,Wdl ATM WESTPAC IGA BALGOWLAH BALGOWL AU,-1376.42,c3882c01-5adf-431e-8e1e-79be01971299,27109.5,debit,cash-withdrawal,AU00000,2023-05-29T17:33:09Z
transaction,ef9e47d7-7efb-4162-a52a-1a19fa2775e2,posted,Coffee Shop Purchase,-2796.42,1beb5df6-ec47-49f1-a646-e413d4a6e60e,24313.08,debit,cash-withdrawal,AU00000,2023-12-08T11:23:12Z
transaction,450a6754-161e-4bb0-8393-5217990cf2f1,posted,Restaurant Dinner,-26.89,59131594-ec27-424f-89fb-5aa184b8ea74,24286.19,debit,bank-fee,AU00000,2023-12-06T08:18:36Z
transaction,c5fc52fc-cd2e-403b-882c-a3f8d547ed56,posted,Electricity Bill Payment,-729.56,5cdf6b30-c65b-44b6-a816-b2a136244252,23556.63,debit,bank-fee,AU00000,2023-10-16T01:29:15Z
transaction,b780a1f6-bd1b-46bb-adda-428caacd2e72,posted,Payroll WFRMS 15439393,10313.6,de81e99d-e301-47d6-840a-4ddfdf51a9f3,33870.23,credit,transfer,AU00000,2024-03-14T01:07:32Z
transaction,a040fb22-42de-467e-bff3-5986b0a1dcb0,posted,Restaurant Dinner,-2933.75,efaf2cfb-12d4-4b6a-82d1-e633224917ff,30936.48,debit,cash-withdrawal,AU00000,2023-07-28T12:01:39Z
transaction,f3ad961c-e444-496a-9440-7be372290195,posted,Music Streaming Subscription,-3777.59,d853228c-ee15-40d1-b544-f5e807f8cc7a,27158.89,debit,payment,AU00000,2023-10-03T10:00:01Z
transaction,e2d39ff8-de45-4e9c-b4de-0ad30c42d891,posted,Movie Ticket Purchase,-3908.6,a0f64c47-db57-4da3-9294-9f7dfe43f6e4,23250.29,debit,cash-withdrawal,AU00000,2023-10-05T12:09:26Z
transaction,15259e53-d1d5-46c3-8a06-add059e6b815,posted,Coffee Shop Purchase,-3586.7,ad103641-51cb-4608-b279-44c4bf551241,19663.59,debit,cash-withdrawal,AU00000,2023-08-08T05:05:25Z
transaction,e01986ba-a35f-4fae-97ca-aca6398c8016,posted,Electricity Bill Payment,-320.41,6ec3de60-f1cc-4c0c-9faf-97a509924d29,13316.51,debit,payment,AU00000,2024-03-24T01:17:45Z
transaction,4d10acdd-a24b-4adb-8a7d-9432f897e2ad,posted,Amazon Online Shopping,-74.2,bd23911d-171c-46f9-8746-06a66a023e50,13242.31,debit,payment,AU00000,2024-01-12T17:35:30Z
transaction,f6d4ef06-63e2-45c6-8526-7b40b9679a74,posted,Restaurant Dinner,-602.6,453c3995-ac38-4efa-83a6-dcec40a8c5b2,12639.71,debit,cash-withdrawal,AU00000,2023-08-12T17:55:20Z
transaction,5a836e0e-5a84-481f-87f2-203a6ae598f9,posted,Public Transport Fare,-3626.08,94f6ccdb-152d-4225-baa4-f163da978269,9013.63,debit,cash-withdrawal,AU00000,2023-06-25T22:38:58Z
transaction,57c18fe0-11e3-4446-bd9b-bd60ad64d351,posted,Movie Ticket Purchase,-3521.83,396db097-4deb-4049-b9b0-30f960e00cec,5491.8,debit,bank-fee,AU00000,2023-06-15T15:52:02Z
transaction,81e878fe-06cf-442f-97ab-719f6bd274e4,posted,TFR Acc14000 TO 12389,-1293.94,376d8549-80a3-4168-bcfe-6c337335d251,4197.86,debit,cash-withdrawal,AU00000,2023-12-19T09:45:45Z
transaction,aaf5d79f-8f68-44e2-994b-6f851b5c8438,posted,Netflix Subscription,-1133.46,5201d8b0-800d-432e-a19c-ddf237700f3a,3064.4,debit,cash-withdrawal,AU00000,2023-11-04T11:34:01Z
transaction,139d1db8-bf37-49cd-91f5-f97efc15fe96,posted,CTRLINK CARERS Ref: 998R6789201610974V,-1693.95,6e91925e-d2cc-4cd1-a189-89c12af55783,1370.45,debit,payment,AU00000,2024-03-20T12:49:10Z
transaction,b1c117d0-3508-482e-bb3b-5497e11378ae,posted,Transfer Platnm Homeloan 346454,-2568.1,3f507902-f30a-49f5-a893-8fd9e8ab187b,-1197.65,debit,cash-withdrawal,AU00000,2023-05-23T02:06:35Z
transaction,22ec796e-4d44-466d-8c7a-e2a6c54986cf,posted,TRANSFER TO JOANNA SMITH CAMPING,-1196.62,b2d590b2-1918-42a9-bfd1-4e9b7d6e0f76,-2394.27,debit,bank-fee,AU00000,2023-08-26T06:14:13Z
transaction,cd7970b2-60c8-407b-81f2-69f26fb8800b,posted,Manly Maths Tutor Wages,-2457.54,127d40a5-88d3-4857-abf8-48813a6279c0,7149.05,debit,cash-withdrawal,AU00000,2023-06-27T16:29:53Z
transaction,9c863e18-a155-4977-898d-ff703287579f,posted,CTRLINK CARERS Ref: 998R6789201610974V,-4708.03,e171d8a2-3cac-4e7a-8c06-a6744f51b502,2441.02,debit,cash-withdrawal,AU00000,2023-10-07T04:19:08Z
transaction,981ea989-efbf-4715-aa1e-9a39a75fc5e1,posted,Manly Maths Tutor Wages,-1568.27,8a9e4753-ae74-4de0-9ba1-eec0b0bbfaff,872.75,debit,bank-fee,AU00000,2023-10-22T07:25:51Z
transaction,997b6bd5-0a0f-450d-8ccf-c8bbda1d1f70,posted,Electricity Bill Payment,-1104.18,6531fe23-dada-4b53-8fe8-e2f67c91f891,-231.43,debit,bank-fee,AU00000,2023-06-19T04:11:51Z
transaction,f6539d76-354c-4047-8edc-e0845f6f79c1,posted,Gym Membership Fee,-1520.43,67c42775-bb73-4f07-a103-4da34d519cab,-1751.86,debit,cash-withdrawal,AU00000,2023-11-14T08:28:36Z
transaction,cb5c83e3-967d-4a90-a9f7-7ab4d04ad751,posted,Uber Ride,-2925.31,df197704-ad8a-4916-b013-767d4836656d,-4677.17,debit,bank-fee,AU00000,2023-09-23T04:01:03Z
transaction,c20ffba6-a10f-49d0-b6cc-9d8243707d25,posted,Music Streaming Subscription,-2212.79,6f889385-a9a3-4f47-ac51-bd8041e74ef6,-6889.96,debit,payment,AU00000,2023-12-22T22:17:06Z
transaction,0343324e-5631-48ac-a4b6-66057e29855e,posted,Wdl ATM WESTPAC IGA BALGOWLAH BALGOWL AU,-3816.75,289a6b63-7be8-48c3-8f08-2fd37d74f9c5,-10706.71,debit,bank-fee,AU00000,2024-04-27T04:27:17Z
transaction,632fdab7-b56a-427b-afcb-fbfa7cb839d6,posted,Wdl ATM WESTPAC IGA BALGOWLAH BALGOWL AU,-1143.33,912290e1-9f58-41ad-a188-7f58f8b7e976,-11850.04,debit,bank-fee,AU00000,2023-08-31T23:50:50Z
transaction,636bbd80-965f-49f0-9a50-c79a17848861,posted,CTRLINK CARERS Ref: 998R6789201610974V,-2663.12,d5969905-b32f-4731-b647-0bc5d34fd75f,-14513.16,debit,bank-fee,AU00000,2024-04-23T13:32:37Z
transaction,98944aec-a213-44f6-81c1-b6422d3931bd,posted,Coffee Shop Purchase,-4216.08,05241435-0404-477f-a118-9e32b7b0f4b0,3060.33,debit,payment,AU00000,2023-10-13T20:29:14Z
transaction,2c9000e9-dc32-478d-8d2b-c1f167fa00a9,posted,Restaurant Dinner,-3467.9,709d9681-c169-4bc9-b2be-c163276b2cdb,-407.57,debit,payment,AU00000,2023-09-30T04:55:41Z
transaction,30edf125-5b65-4b60-ac48-9a1e9a8ba7d2,posted,Wdl ATM WESTPAC IGA BALGOWLAH BALGOWL AU,-4891.93,8fd2d7c3-d641-4279-8a9f-81c4e5be01d4,-5299.5,debit,cash-withdrawal,AU00000,2023-08-30T06:39:29Z
transaction,1e77bb67-edb8-4bc0-be27-1ecb804493cc,posted,AGL RETAIL ENERGY LTD (GAS),-3767.73,0a66ad82-5cae-4b02-856a-18ad2bd3c4ae,-9067.23,debit,bank-fee,AU00000,2023-06-06T09:34:21Z
transaction,2c12cd0c-02e0-4f43-ba2f-dd1d2fab94ff,posted,Pharmacy Purchase,-3619.25,f49bacc9-1ff0-407a-b043-7e974d46e4d9,-12686.48,debit,bank-fee,AU00000,2024-03-27T10:26:39Z
transaction,745349e0-337f-4976-9cb6-5cce8fb664b1,posted,Amazon Online Shopping,-186.43,0bc903d7-439e-44d0-ae8c-b3f990c28d33,-12872.91,debit,cash-withdrawal,AU00000,2024-03-07T16:18:29Z
transaction,0a85b507-74df-4000-bb6b-c9678d4b9bc4,posted,Coffee Shop Purchase,-1572.11,9668cf63-b3ef-4f28-b931-cfdb7af7306e,-14445.02,debit,cash-withdrawal,AU00000,2023-05-29T11:45:31Z
transaction,1a0ea0f0-d8cd-49bc-ab28-a9f224ec760e,posted,Wdl ATM WESTPAC IGA BALGOWLAH BALGOWL AU,-4714.74,52c74d31-be93-4113-b631-4e57ffe33b34,-19159.76,debit,cash-withdrawal,AU00000,2023-10-23T01:14:52Z
transaction,00a502d2-50df-470a-bf2e-d6f291ff984c,posted,AGL RETAIL ENERGY LTD (GAS),-3118.19,7ede507a-7334-4930-8f45-a21cc2fedb2c,-22277.95,debit,cash-withdrawal,AU00000,2023-10-05T12:37:14Z
transaction,039988fb-bf0a-4b57-8ebb-2a6beb41c7c2,posted,Payroll WFRMS 15439393,10669.11,958b7783-61da-433d-9e3a-86da7e607c94,-11608.84,credit,transfer,AU00000,2023-06-08T21:42:07Z
transaction,633173bd-bed4-495b-a189-edf4dc55c6a7,posted,Electricity Bill Payment,-4937.57,8f1c47c0-4754-4471-8759-16fbb978ced9,3463.87,debit,bank-fee,AU00000,2023-10-27T05:17:50Z
transaction,26ab5409-ee26-49e2-8ca3-e75e615e9a35,posted,TRANSFER TO JOANNA SMITH CAMPING,-611.11,7a8a08b2-aaac-4c6c-b85d-5a013cdc4841,2852.76,debit,cash-withdrawal,AU00000,2023-08-18T19:29:59Z
transaction,eb2f6e0e-134d-4419-a473-ea74d655cf9d,posted,Amazon Online Shopping,-4596.29,30ccb71a-3d83-4335-8202-6cddd2513c4b,-1743.53,debit,cash-withdrawal,AU00000,2023-12-02T13:41:13Z
transaction,e499f94b-9c0b-4bba-a293-3497c735dffc,posted,Music Streaming Subscription,-2098.22,719c6f4b-e191-4683-8900-58f031bbd6ab,-3841.75,debit,cash-withdrawal,AU00000,2024-04-04T13:39:04Z
transaction,96dd72b7-f42a-4b90-87be-483091a35d43,posted,Home Improvement Store Purchase,-275.83,b5b5b82e-f452-4c12-a484-4c7fab9ccd63,-4117.58,debit,cash-withdrawal,AU00000,2023-09-23T01:20:31Z
transaction,65d2a063-3b44-4a38-a443-b1723e91e196,posted,Gym Membership Fee,-843.51,f25a8950-10a8-4839-99c0-7886fd2f4e77,-4961.09,debit,bank-fee,AU00000,2023-08-26T17:56:30Z
transaction,7fa71ca6-9bc9-4855-9c91-18c74d3506a9,posted,Manly Maths Tutor Wages,-2307.04,ae58c843-425e-425f-8ec3-fff9954d32bf,-7268.13,debit,bank-fee,AU00000,2023-09-02T20:03:38Z
transaction,506cda8a-b3e8-4be8-b8fc-1c4cf119158b,posted,Bookstore Purchase,-4990.65,4e52ee23-71eb-4180-b1f6-aa6b0db4b24f,-12258.78,debit,bank-fee,AU00000,2023-06-02T05:34:06Z
transaction,14effe2c-db27-45d9-bcb2-4d1461df9e2c,posted,Movie Ticket Purchase,-4751.9,3da82d92-045d-4ad2-985f-6c64cae7d06c,-17010.68,debit,payment,AU00000,2024-02-25T05:10:53Z
transaction,6542fc24-fee4-4be0-bfcb-f309b4c1ac40,posted,Transfer Platnm Homeloan 346454,-3881.79,6128fc99-bcc6-41fd-93e6-cfa87babd771,-20892.47,debit,bank-fee,AU00000,2023-06-28T10:47:08Z
transaction,afdee2af-dc15-4b35-b0b8-4ae15c71f204,posted,Travel Agency Booking,-581.67,3da1b0d7-cd67-4470-9cce-36f6ef514d7b,5490.03,debit,payment,AU00000,2023-06-01T14:31:26Z
transaction,09a59a5e-2d51-4040-8905-15c7aa93d844,posted,Hair Salon Appointment,-541.03,e630c04e-5e2b-4ff1-acdd-2af25f997ca8,4949.0,debit,bank-fee,AU00000,2023-07-03T21:49:26Z
transaction,a64471ee-34d8-49d0-b419-81301c72fef5,posted,Travel Agency Booking,-4278.19,39b80afd-8823-47fc-a51b-83e488d05370,670.81,debit,cash-withdrawal,AU00000,2024-01-14T12:38:56Z
transaction,76936a8c-b8e1-4650-8a96-0586a85338b8,posted,Movie Ticket Purchase,-4583.48,8f39f165-9579-42f3-ac9a-df9f7d27a0fb,-3912.67,debit,payment,AU00000,2024-01-19T01:04:36Z
transaction,267f2a66-d74a-4894-8cfc-7d5d51db8f88,posted,Amazon Online Shopping,-824.63,ebd316c6-82f7-4c34-bda7-057062392fc3,-4737.3,debit,bank-fee,AU00000,2024-03-31T21:47:23Z
transaction,e2107dad-4995-4ab2-a2af-36b1dace7802,posted,TFR Acc14000 TO 12389,-4340.19,9524d6a9-29f2-427b-84c4-8d4a4f98457c,-9077.49,debit,bank-fee,AU00000,2023-11-28T08:29:52Z
transaction,0f8e59bc-79da-4157-b34d-014eb2c8511e,posted,TFR Acc14000 TO 12389,-146.07,683fe9ff-67ab-4b74-8590-6d19bb88c0d3,-9223.56,debit,payment,AU00000,2024-03-16T16:05:22Z
transaction,98415495-b4e1-4960-94c4-856e419a022c,posted,Music Streaming Subscription,-701.93,57fe4901-7860-4584-9fd2-d75e4abd0fe2,-9925.49,debit,cash-withdrawal,AU00000,2023-10-26T13:36:26Z
transaction,252efb63-e9e0-4407-a537-0687085bfca3,posted,Car Maintenance Expense,-3997.11,5611d53c-a999-4b27-b15f-eca54d17c3d5,-13922.6,debit,cash-withdrawal,AU00000,2024-03-18T23:56:52Z
transaction,404871ca-8764-44db-9b64-7abf5fe825df,posted,Restaurant Dinner,-1537.17,1834b34b-9d4f-489f-b855-dbb7e10d27b9,-15459.77,debit,bank-fee,AU00000,2024-01-15T06:25:46Z
transaction,a26ca777-9f06-49e8-8083-8eb0daa80252,posted,Uber Ride,-3116.68,58f7aa54-095e-48da-ba98-fdc5140042e7,7520.96,debit,cash-withdrawal,AU00000,2023-07-20T00:45:01Z
transaction,4c218b8d-e4f8-454f-a2b9-df88f595d19e,posted,Gym Membership Fee,-715.6,921e3dad-c945-4171-a45f-63f1ab9dc387,6805.36,debit,bank-fee,AU00000,2023-07-27T14:38:03Z
transaction,6c645911-30fb-4679-8f5f-4f554b7aca8b,posted,Transfer Platnm Homeloan 346454,-4290.1,6c35b30a-39e7-4b10-80b5-3cda3c615e43,2515.26,debit,cash-withdrawal,AU00000,2023-09-20T12:09:24Z
transaction,46969876-de25-4bed-8f5c-5e6e04d5ba0f,posted,Manly Maths Tutor Wages,-3197.72,c4e0825d-78c9-4328-a551-60105118a874,-682.46,debit,payment,AU00000,2023-09-05T01:12:02Z
transaction,83ed30e3-7993-4394-9c0d-ae5460f20b73,posted,Online Gaming Purchase,-2054.98,d39e1998-c2b0-4ba9-922b-f25b62fb1186,-2737.44,debit,bank-fee,AU00000,2024-01-11T17:46:45Z
transaction,9ecb44c2-285d-4d96-b1f5-aebb3f56f4af,posted,Non Hooli ATM Withdrawal Fee,-265.01,de04aac2-3a5e-4189-a0f7-dbb7d4c0209f,-3002.45,debit,cash-withdrawal,AU00000,2023-09-29T12:11:49Z
transaction,55fbfa53-ea30-4f5a-a33c-3a9fe3fbe06a,posted,Mobile Phone Bill Payment,-3431.77,80e17bd8-7034-4866-bd2d-45348a9f0d82,-6434.22,debit,payment,AU00000,2024-03-01T14:39:35Z
transaction,ccbb27f0-5c42-4b81-bc3b-5c2917d5af79,posted,Transfer Platnm Homeloan 346454,-1475.33,283bf462-cb1a-43ae-884b-e031e216f0be,-7909.55,debit,payment,AU00000,2024-04-22T10:19:39Z
transaction,fe192b0f-a7e6-45b0-8d3c-74514392dbf9,posted,Netflix Subscription,-1472.5,da3b3622-f619-4946-92f5-ca286fb07fe6,-9382.05,debit,bank-fee,AU00000,2024-01-14T08:20:06Z
transaction,5953a18e-9eaf-458e-89bc-aba2b6c85c0c,posted,Movie Ticket Purchase,-1081.64,0d555d0d-2999-4f74-859b-3f6f4faef619,-10463.69,debit,cash-withdrawal,AU00000,2023-09-24T04:25:11Z
transaction,6fa2727d-5720-4dd4-9413-f2afcd2ab2a5,posted,CTRLINK CARERS Ref: 998R6789201610974V,-1177.19,97573842-ad86-4293-9c52-c23a36a27114,10852.05,debit,bank-fee,AU00000,2023-06-05T23:56:25Z
transaction,6e8e24a0-a6cb-42b1-9abb-a564339ac10a,posted,Restaurant Dinner,-4078.57,0c9f0984-bbb7-4f22-b99e-05f4a0e83a75,6773.48,debit,bank-fee,AU00000,2024-03-17T07:11:27Z
transaction,3074479e-dbcb-42dc-a748-c5d6dde197f3,posted,CTRLINK CARERS Ref: 998R6789201610974V,-1066.04,e103c89f-77b8-4464-900d-4c49c270c2bd,5707.44,debit,cash-withdrawal,AU00000,2024-04-15T17:19:16Z
transaction,0d272f6d-e4ac-4361-9612-5d1af30c752c,posted,Transfer Platnm Homeloan 346454,-3081.03,b1fb5b52-650c-4110-91da-b8c3f7fa5ce9,2626.41,debit,cash-withdrawal,AU00000,2023-07-22T21:42:22Z
transaction,824eabf8-0bda-404c-82fe-f342106699d6,posted,Movie Ticket Purchase,-1323.82,b3e7d8c4-e432-4759-8584-e5a98c216798,1302.59,debit,payment,AU00000,2023-07-08T02:09:12Z
transaction,113bec74-7703-4b2c-9891-2c63604bdb50,posted,Clothing Store Purchase,-3920.82,126f49a0-70bc-461d-95d1-a6b162e4b06f,-2618.23,debit,bank-fee,AU00000,2024-02-09T09:24:52Z
transaction,6d65c0f0-9745-4147-b02a-0402960d9b99,posted,Electricity Bill Payment,-1069.56,919483f9-2063-4495-9f8a-70fabca08135,-3687.79,debit,cash-withdrawal,AU00000,2024-04-13T00:03:27Z
transaction,33436ed7-fc43-487c-964e-6a5fa6a20cd3,posted,Online Gaming Purchase,-2556.67,3a31cb69-cc9a-4ac1-a20f-db69b87457a7,-6244.46,debit,payment,AU00000,2023-06-26T09:25:12Z
transaction,7e626b06-ede6-4051-ba48-c1cb62ae7f3d,posted,Music Streaming Subscription,-2698.14,aef41785-5ee8-430f-8ca4-2078bbd41f04,-8942.6,debit,bank-fee,AU00000,2024-01-10T22:08:54Z
transaction,923dc767-735f-4c86-911b-328e22929257,posted,Manly Maths Tutor Wages,-3457.73,f18ab725-37a4-400e-9491-f42ae935281c,-12400.33,debit,payment,AU00000,2023-07-06T20:08:36Z
transaction,8888d8bd-9f32-416f-9943-c13c3292fef3,posted,Bookstore Purchase,-2994.27,dd552e10-724a-4120-854c-2acca244d8f3,4571.32,debit,bank-fee,AU00000,2024-01-30T13:23:04Z
transaction,a0a15a48-2aea-4444-ab18-220cafbe9796,posted,AGL RETAIL ENERGY LTD (GAS),-3313.72,58b1e2fd-e6ff-4240-aca3-4437efe8bc1f,1257.6,debit,bank-fee,AU00000,2024-01-07T13:58:02Z
transaction,3f81df1e-3cf4-4815-85c7-469c00bb0e0a,posted,Uber Ride,-3223.33,12111a8d-4a2b-4a8c-842b-f970e29bfeaa,-1965.73,debit,cash-withdrawal,AU00000,2023-12-13T04:26:25Z
transaction,bcae54bb-e6a9-4f59-8325-ecbb05735acf,posted,Netflix Subscription,-2247.3,504062f6-e8de-4422-b879-c7dca8607d36,-4213.03,debit,payment,AU00000,2023-08-25T12:49:16Z
transaction,27052318-314a-4a16-a8d1-62c3c7fd7081,posted,Gasoline Purchase,-204.94,aefd8dc1-6c32-442c-bd0a-d2cc0bb276e4,-4417.97,debit,bank-fee,AU00000,2024-03-10T13:45:11Z
transaction,22a4e50d-d8e7-4e33-a1ad-5c52f68fe622,posted,Pharmacy Purchase,-153.16,bcaa0274-558f-4ab2-b942-c28f701754b3,-4571.13,debit,bank-fee,AU00000,2023-07-12T10:53:19Z
transaction,343b5ddc-a245-4735-a878-d4190a510bd4,posted,Clothing Store Purchase,-288.84,b6dc0e64-0922-446b-9e72-b1e78170ceff,-4859.97,debit,bank-fee,AU00000,2024-02-26T07:07:28Z
transaction,47ad9a4b-f623-4dd7-9759-b70487be8814,posted,TRANSFER TO JOANNA SMITH CAMPING,-230.71,8cc89ee5-1f6e-4404-90da-e69e0b6608c6,-5090.68,debit,cash-withdrawal,AU00000,2023-09-28T19:10:21Z
transaction,2f5aae81-6db3-438a-a05d-0c5bcf2ea0d7,posted,TRANSFER TO JOANNA SMITH CAMPING,-1127.1,435b6ae9-d8c4-4726-bb28-9aed66a48987,-6217.78,debit,payment,AU00000,2024-04-16T22:57:10Z
transaction,5ee5904c-0f83-4353-ba7e-48c8d7c37e03,posted,Car Maintenance Expense,-306.08,ba090c27-9e25-4be6-86e2-876e66bbf59a,-6523.86,debit,payment,AU00000,2023-08-22T03:28:41Z
transaction,09d7c7c6-1b42-4d65-aa54-4f888e59639c,posted,Payroll WFRMS 15439393,11486.45,c1926302-f299-48ef-97f0-9d3c76d73a27,24404.83,credit,transfer,AU00000,2023-11-08T20:39:15Z
transaction,db975c32-2f81-444f-b9c6-5e379e130218,posted,Travel Agency Booking,-4519.03,c2491362-fda6-4d65-8a6b-cf131a9d22bc,19885.8,debit,cash-withdrawal,AU00000,2023-07-08T07:33:29Z
transaction,492a99c4-7806-41ea-9904-5d30a2d045c6,posted,Public Transport Fare,-1500.69,963c4cda-b3c7-4bb0-989b-d6963924248d,18385.11,debit,cash-withdrawal,AU00000,2023-05-13T22:02:50Z
transaction,3c9ef42c-a20b-468e-b1d8-3dc99712a910,posted,Gym Membership Fee,-4764.76,41eec087-14ca-4676-9720-62f8a21a0136,13620.35,debit,cash-withdrawal,AU00000,2024-02-06T08:07:09Z
transaction,880ca0b2-d1b0-455f-82f2-1c782ceca04c,posted,Payroll WFRMS 15439393,10122.29,e3a97e67-71df-4318-b541-5c1a67cb96dd,23742.64,credit,transfer,AU00000,2023-09-08T14:22:40Z
transaction,e8b77751-d0c5-4519-91f6-1e953bd566a4,posted,Gasoline Purchase,-3513.94,59c56497-4945-4f15-b2d3-1d9f44a2e5e5,20228.7,debit,bank-fee,AU00000,2023-12-31T00:59:49Z
transaction,dfbc5df7-c6d1-410e-b2f8-cefe46cb7fa9,posted,TRANSFER TO JOANNA SMITH CAMPING,-1602.76,2fd8a8bb-1b07-432e-bbb5-dcd3c7108832,18625.94,debit,cash-withdrawal,AU00000,2024-03-21T09:50:46Z
transaction,a3129b20-07b7-4096-9423-7dfe438a349e,posted,Clothing Store Purchase,-4767.24,4bc63261-9889-4270-8634-ed97f138cff8,13858.7,debit,payment,AU00000,2023-06-17T03:07:49Z
transaction,859a0930-b13f-4c49-88c1-c288daf7c982,posted,Pharmacy Purchase,-31.93,3a2d8f17-4da3-4170-965c-18f0f940033b,13826.77,debit,payment,AU00000,2024-02-16T12:30:28Z
transaction,59529fd2-4157-4baf-b14b-0668f2ce371c,posted,Music Streaming Subscription,-3760.55,df2bbc8c-8778-4d84-b3d5-623652a6bfb4,10066.22,debit,bank-fee,AU00000,2023-12-13T15:14:52Z
